"SubjID","Order","TrialNo","Dim","Dist","Bounces","Velocity","RunUp","Caught","TargetXPos","TargetYPos","PaddleYPos","Diff","AbsDiff","Prebounce"
"C01NH",1,288,"1200x900",800,0,600,400,"True",180,547,503,-44,44,1
"C01NH",2,247,"1200x900",800,0,600,400,"True",160,424,373,-51,51,1
"C01NH",3,182,"1200x900",600,2,600,400,"False",933,389,511,122,122,0
"C01NH",4,137,"1200x900",600,1,600,400,"False",789,577,492,-85,85,0
"C01NH",5,300,"1200x900",800,1,600,400,"False",620,693,511,-182,182,0
"C01NH",6,437,"1200x900",1000,0,600,400,"False",74,667,568,-99,99,1
"C01NH",7,139,"1200x900",600,1,600,400,"False",192,695,475,-220,220,0
"C01NH",8,157,"1200x900",600,2,600,400,"False",1016,323,468,145,145,0
"C01NH",10,588,"1200x900",1000,2,600,400,"True",585,350,388,38,38,0
"C01NH",11,96,"1200x900",600,1,600,400,"True",433,458,461,3,3,0
"C01NH",12,130,"1200x900",600,1,600,400,"True",741,428,464,36,36,0
"C01NH",13,466,"1200x900",1000,0,600,400,"False",82,205,436,231,231,1
"C01NH",14,198,"1200x900",600,2,600,400,"True",976,500,487,-13,13,0
"C01NH",15,533,"1200x900",1000,1,600,400,"True",355,483,460,-23,23,0
"C01NH",16,590,"1200x900",1000,2,600,400,"False",636,278,468,190,190,0
"C01NH",18,334,"1200x900",800,1,600,400,"False",481,665,405,-260,260,0
"C01NH",19,469,"1200x900",1000,0,600,400,"False",73,227,327,100,100,1
"C01NH",20,204,"1200x900",600,2,600,400,"True",1053,432,475,43,43,0
"C01NH",21,625,"1200x900",1000,2,600,400,"False",279,228,530,302,302,0
"C01NH",22,225,"1200x900",800,0,600,400,"True",178,423,406,-17,17,1
"C01NH",23,207,"1200x900",600,2,600,400,"False",838,235,427,192,192,0
"C01NH",24,524,"1200x900",1000,1,600,400,"True",534,470,488,18,18,0
"C01NH",25,18,"1200x900",600,0,600,400,"True",400,318,344,26,26,1
"C01NH",26,193,"1200x900",600,2,600,400,"False",874,588,472,-116,116,0
"C01NH",27,509,"1200x900",1000,1,600,400,"True",509,434,407,-27,27,0
"C01NH",28,314,"1200x900",800,1,600,400,"False",277,616,435,-181,181,1
"C01NH",29,152,"1200x900",600,2,600,400,"True",971,399,493,94,94,0
"C01NH",30,85,"1200x900",600,1,600,400,"False",434,347,514,167,167,0
"C01NH",31,427,"1200x900",800,2,600,400,"False",812,380,492,112,112,0
"C01NH",32,601,"1200x900",1000,2,600,400,"False",735,697,478,-219,219,0
"C01NH",33,420,"1200x900",800,2,600,400,"False",519,223,579,356,356,0
"C01NH",34,523,"1200x900",1000,1,600,400,"False",339,318,435,117,117,0
"C01NH",35,432,"1200x900",800,2,600,400,"True",792,380,468,88,88,0
"C01NH",36,24,"1200x900",600,0,600,400,"True",430,538,533,-5,5,1
"C01NH",37,301,"1200x900",800,1,600,400,"False",162,574,431,-143,143,0
"C01NH",38,425,"1200x900",800,2,600,400,"True",621,438,413,-25,25,0
"C01NH",39,212,"1200x900",600,2,600,400,"False",841,206,451,245,245,0
"C01NH",40,410,"1200x900",800,2,600,400,"True",916,477,467,-10,10,0
"C01NH",41,623,"1200x900",1000,2,600,400,"False",636,527,259,-268,268,0
"C01NH",42,196,"1200x900",600,2,600,400,"True",1030,397,340,-57,57,0
"C01NH",43,106,"1200x900",600,1,600,400,"False",803,659,469,-190,190,1
"C01NH",44,178,"1200x900",600,2,600,400,"False",1041,510,368,-142,142,0
"C01NH",45,508,"1200x900",1000,1,600,400,"False",596,485,360,-125,125,0
"C01NH",47,227,"1200x900",800,0,600,400,"False",196,551,471,-80,80,1
"C01NH",48,164,"1200x900",600,2,600,400,"False",1051,268,416,148,148,0
"C01NH",49,585,"1200x900",1000,2,600,400,"False",698,688,319,-369,369,1
"C01NH",50,565,"1200x900",1000,1,600,400,"False",451,562,380,-182,182,0
"C01NH",51,33,"1200x900",600,0,600,400,"True",198,533,552,19,19,1
"C01NH",52,320,"1200x900",800,1,600,400,"False",644,376,593,217,217,0
"C01NH",53,197,"1200x900",600,2,600,400,"False",903,212,589,377,377,0
"C01NH",54,80,"1200x900",600,1,600,400,"False",616,423,678,255,255,1
"C01NH",55,303,"1200x900",800,1,600,400,"False",241,431,648,217,217,0
"C01NH",56,628,"1200x900",1000,2,600,400,"False",768,410,523,113,113,0
"C01NH",57,92,"1200x900",600,1,600,400,"True",624,605,526,-79,79,0
"C01NH",58,350,"1200x900",800,1,600,400,"True",182,566,537,-29,29,0
"C01NH",59,248,"1200x900",800,0,600,400,"True",94,240,215,-25,25,1
"C01NH",60,78,"1200x900",600,1,600,400,"False",885,684,457,-227,227,0
"C01NH",61,188,"1200x900",600,2,600,400,"False",900,195,535,340,340,0
"C01NH",62,412,"1200x900",800,2,600,400,"False",842,280,606,326,326,0
"C01NH",63,547,"1200x900",1000,1,600,400,"False",369,384,576,192,192,1
"C01NH",64,278,"1200x900",800,0,600,400,"False",251,711,586,-125,125,1
"C01NH",65,175,"1200x900",600,2,600,400,"False",1028,432,551,119,119,0
"C01NH",66,497,"1200x900",1000,0,600,400,"False",106,696,491,-205,205,1
"C01NH",67,241,"1200x900",800,0,600,400,"True",129,227,266,39,39,1
"C01NH",68,102,"1200x900",600,1,600,400,"False",861,603,391,-212,212,0
"C01NH",69,310,"1200x900",800,1,600,400,"False",559,592,510,-82,82,0
"C01NH",70,61,"1200x900",600,0,600,400,"False",272,670,613,-57,57,1
"C01NH",71,337,"1200x900",800,1,600,400,"False",299,622,839,217,217,0
"C01NH",72,99,"1200x900",600,1,600,400,"False",811,407,603,196,196,0
"C01NH",73,224,"1200x900",800,0,600,400,"True",161,474,505,31,31,1
"C01NH",74,331,"1200x900",800,1,600,400,"True",240,620,645,25,25,0
"C01NH",75,424,"1200x900",800,2,600,400,"True",903,545,621,76,76,0
"C01NH",76,643,"1200x900",1000,2,600,400,"False",740,325,576,251,251,0
"C01NH",77,441,"1200x900",1000,0,600,400,"True",85,684,629,-55,55,1
"C01NH",78,226,"1200x900",800,0,600,400,"True",187,229,196,-33,33,1
"C01NH",79,242,"1200x900",800,0,600,400,"True",117,448,425,-23,23,1
"C01NH",80,26,"1200x900",600,0,600,400,"True",70,712,661,-51,51,0
"C01NH",81,595,"1200x900",1000,2,600,400,"False",687,640,406,-234,234,0
"C01NH",82,87,"1200x900",600,1,600,400,"False",231,604,349,-255,255,0
"C01NH",83,644,"1200x900",1000,2,600,400,"False",495,486,660,174,174,0
"C01NH",84,317,"1200x900",800,1,600,400,"True",185,564,527,-37,37,0
"C01NH",85,554,"1200x900",1000,1,600,400,"False",79,309,195,-114,114,1
"C01NH",86,342,"1200x900",800,1,600,400,"False",677,204,317,113,113,0
"C01NH",87,20,"1200x900",600,0,600,400,"True",204,545,544,-1,1,1
"C01NH",88,141,"1200x900",600,1,600,400,"True",671,582,584,2,2,0
"C01NH",89,333,"1200x900",800,1,600,400,"True",521,548,545,-3,3,0
"C01NH",90,430,"1200x900",800,2,600,400,"True",922,254,340,86,86,0
"C01NH",91,274,"1200x900",800,0,600,400,"True",146,497,469,-28,28,1
"C01NH",92,133,"1200x900",600,1,600,400,"True",345,551,602,51,51,0
"C01NH",93,268,"1200x900",800,0,600,400,"True",148,400,451,51,51,1
"C01NH",94,122,"1200x900",600,1,600,400,"False",817,709,409,-300,300,0
"C01NH",95,173,"1200x900",600,2,600,400,"False",948,693,474,-219,219,0
"C01NH",96,468,"1200x900",1000,0,600,400,"False",121,219,400,181,181,1
"C01NH",97,195,"1200x900",600,2,600,400,"True",942,249,297,48,48,0
"C01NH",98,190,"1200x900",600,2,600,400,"True",977,238,274,36,36,0
"C01NH",99,576,"1200x900",1000,1,600,400,"False",376,713,535,-178,178,0
"C01NH",101,573,"1200x900",1000,1,600,400,"True",486,615,595,-20,20,0
"C01NH",102,132,"1200x900",600,1,600,400,"False",333,185,501,316,316,0
"C01NH",103,258,"1200x900",800,0,600,400,"False",126,664,523,-141,141,1
"C01NH",104,267,"1200x900",800,0,600,400,"True",145,665,678,13,13,1
"C01NH",105,566,"1200x900",1000,1,600,400,"False",378,472,136,-336,336,1
"C01NH",106,647,"1200x900",1000,2,600,400,"True",560,637,639,2,2,0
"C01NH",107,517,"1200x900",1000,1,600,400,"False",548,182,554,372,372,0
"C01NH",108,544,"1200x900",1000,1,600,400,"False",602,620,324,-296,296,0
"C01NH",109,169,"1200x900",600,2,600,400,"True",924,290,372,82,82,0
"C01NH",112,605,"1200x900",1000,2,600,400,"False",493,665,377,-288,288,0
"C01NH",113,629,"1200x900",1000,2,600,400,"False",681,257,462,205,205,0
"C01NH",114,228,"1200x900",800,0,600,400,"True",174,687,649,-38,38,1
"C01NH",115,631,"1200x900",1000,2,600,400,"True",699,479,523,44,44,0
"C01NH",117,428,"1200x900",800,2,600,400,"False",732,665,485,-180,180,0
"C01NH",118,455,"1200x900",1000,0,600,400,"False",107,718,597,-121,121,1
"C01NH",119,627,"1200x900",1000,2,600,400,"False",760,510,592,82,82,0
"C01NH",121,262,"1200x900",800,0,600,400,"True",196,481,552,71,71,1
"C01NH",122,298,"1200x900",800,1,600,400,"True",311,457,462,5,5,0
"C01NH",123,395,"1200x900",800,2,600,400,"False",743,334,451,117,117,0
"C01NH",124,201,"1200x900",600,2,600,400,"False",1005,462,346,-116,116,0
"C01NH",125,363,"1200x900",800,2,600,400,"False",800,218,435,217,217,0
"C01NH",126,312,"1200x900",800,1,600,400,"False",238,683,434,-249,249,0
"C01NH",127,240,"1200x900",800,0,600,400,"False",330,656,526,-130,130,1
"C01NH",128,189,"1200x900",600,2,600,400,"False",881,397,501,104,104,0
"C01NH",129,116,"1200x900",600,1,600,400,"False",767,289,544,255,255,0
"C01NH",130,457,"1200x900",1000,0,600,400,"False",97,630,485,-145,145,1
"C01NH",131,407,"1200x900",800,2,600,400,"True",989,340,292,-48,48,0
"C01NH",132,380,"1200x900",800,2,600,400,"False",942,228,343,115,115,0
"C01NH",133,581,"1200x900",1000,2,600,400,"False",310,357,561,204,204,0
"C01NH",134,622,"1200x900",1000,2,600,400,"False",307,683,241,-442,442,0
"C01NH",135,246,"1200x900",800,0,600,400,"True",196,418,432,14,14,1
"C01NH",136,423,"1200x900",800,2,600,400,"False",1051,710,590,-120,120,1
"C01NH",137,564,"1200x900",1000,1,600,400,"False",215,264,513,249,249,0
"C01NH",138,259,"1200x900",800,0,600,400,"True",156,180,186,6,6,1
"C01NH",139,167,"1200x900",600,2,600,400,"False",956,241,328,87,87,0
"C01NH",140,519,"1200x900",1000,1,600,400,"False",319,565,307,-258,258,1
"C01NH",141,234,"1200x900",800,0,600,400,"True",72,344,329,-15,15,1
"C01NH",142,514,"1200x900",1000,1,600,400,"False",539,690,356,-334,334,0
"C01NH",143,485,"1200x900",1000,0,600,400,"False",121,694,596,-98,98,1
"C01NH",145,319,"1200x900",800,1,600,400,"False",494,587,850,263,263,1
"C01NH",146,287,"1200x900",800,0,600,400,"True",120,567,533,-34,34,1
"C01NH",148,535,"1200x900",1000,1,600,400,"True",372,410,359,-51,51,0
"C01NH",149,561,"1200x900",1000,1,600,400,"False",231,406,560,154,154,0
"C01NH",150,381,"1200x900",800,2,600,400,"True",705,408,384,-24,24,0
"C01NH",151,500,"1200x900",1000,0,600,400,"False",105,700,251,-449,449,1
"C01NH",152,607,"1200x900",1000,2,600,400,"True",900,573,600,27,27,1
"C01NH",153,265,"1200x900",800,0,600,400,"False",229,353,460,107,107,1
"C01NH",154,577,"1200x900",1000,2,600,400,"True",455,420,490,70,70,0
"C01NH",156,490,"1200x900",1000,0,600,400,"False",114,183,375,192,192,1
"C01NH",157,154,"1200x900",600,2,600,400,"False",941,454,395,-59,59,0
"C01NH",158,366,"1200x900",800,2,600,400,"False",931,464,393,-71,71,0
"C01NH",159,394,"1200x900",800,2,600,400,"False",847,292,475,183,183,0
"C01NH",160,250,"1200x900",800,0,600,400,"True",290,248,294,46,46,1
"C01NH",161,563,"1200x900",1000,1,600,400,"False",201,696,238,-458,458,0
"C01NH",162,382,"1200x900",800,2,600,400,"False",870,523,177,-346,346,0
"C01NH",163,429,"1200x900",800,2,600,400,"False",682,692,501,-191,191,0
"C01NH",164,326,"1200x900",800,1,600,400,"False",103,482,631,149,149,0
"C01NH",165,220,"1200x900",800,0,600,400,"False",108,699,605,-94,94,1
"C01NH",166,30,"1200x900",600,0,600,400,"False",107,353,439,86,86,0
"C01NH",167,82,"1200x900",600,1,600,400,"False",108,213,296,83,83,0
"C01NH",168,494,"1200x900",1000,0,600,400,"False",127,692,424,-268,268,1
"C01NH",169,496,"1200x900",1000,0,600,400,"False",70,639,440,-199,199,1
"C01NH",170,452,"1200x900",1000,0,600,400,"False",97,273,392,119,119,1
"C01NH",171,541,"1200x900",1000,1,600,400,"True",339,478,431,-47,47,0
"C01NH",172,397,"1200x900",800,2,600,400,"False",817,692,523,-169,169,0
"C01NH",173,192,"1200x900",600,2,600,400,"False",1064,320,537,217,217,0
"C01NH",175,525,"1200x900",1000,1,600,400,"False",123,690,592,-98,98,0
"C01NH",176,5,"1200x900",600,0,600,400,"True",228,587,577,-10,10,0
"C01NH",177,347,"1200x900",800,1,600,400,"False",757,295,648,353,353,1
"C01NH",178,113,"1200x900",600,1,600,400,"False",897,657,557,-100,100,0
"C01NH",179,243,"1200x900",800,0,600,400,"False",114,332,438,106,106,1
"C01NH",180,344,"1200x900",800,1,600,400,"True",589,408,390,-18,18,0
"C01NH",181,47,"1200x900",600,0,600,400,"True",303,499,446,-53,53,1
"C01NH",182,442,"1200x900",1000,0,600,400,"False",87,183,261,78,78,1
"C01NH",183,186,"1200x900",600,2,600,400,"False",997,197,304,107,107,0
"C01NH",184,542,"1200x900",1000,1,600,400,"False",304,401,283,-118,118,0
"C01NH",185,582,"1200x900",1000,2,600,400,"True",554,347,423,76,76,0
"C01NH",186,616,"1200x900",1000,2,600,400,"True",854,357,358,1,1,1
"C01NH",188,593,"1200x900",1000,2,600,400,"False",246,719,364,-355,355,0
"C01NH",189,292,"1200x900",800,1,600,400,"False",88,565,672,107,107,0
"C01NH",190,370,"1200x900",800,2,600,400,"False",874,336,553,217,217,0
"C01NH",191,609,"1200x900",1000,2,600,400,"True",697,627,612,-15,15,0
"C01NH",192,560,"1200x900",1000,1,600,400,"False",516,693,434,-259,259,0
"C01NH",193,142,"1200x900",600,1,600,400,"False",286,474,590,116,116,0
"C01NH",194,174,"1200x900",600,2,600,400,"True",998,457,513,56,56,0
"C01NH",195,50,"1200x900",600,0,600,400,"True",75,582,590,8,8,0
"C01NH",196,63,"1200x900",600,0,600,400,"True",311,188,155,-33,33,1
"C01NH",197,341,"1200x900",800,1,600,400,"False",735,632,317,-315,315,1
"C01NH",198,214,"1200x900",600,2,600,400,"True",1046,305,368,63,63,0
"C01NH",199,3,"1200x900",600,0,600,400,"True",298,443,496,53,53,1
"C01NH",200,69,"1200x900",600,0,600,400,"True",322,268,192,-76,76,0
"C01NH",201,323,"1200x900",800,1,600,400,"False",388,348,412,64,64,0
"C01NH",202,385,"1200x900",800,2,600,400,"True",740,456,427,-29,29,0
"C01NH",203,443,"1200x900",1000,0,600,400,"False",99,651,484,-167,167,1
"C01NH",204,263,"1200x900",800,0,600,400,"False",82,396,223,-173,173,1
"C01NH",205,59,"1200x900",600,0,600,400,"False",391,692,620,-72,72,1
"C01NH",206,291,"1200x900",800,1,600,400,"True",522,694,646,-48,48,0
"C01NH",207,449,"1200x900",1000,0,600,400,"True",105,683,637,-46,46,1
"C01NH",208,378,"1200x900",800,2,600,400,"False",1018,708,578,-130,130,0
"C01NH",209,51,"1200x900",600,0,600,400,"False",272,181,265,84,84,1
"C01NH",210,471,"1200x900",1000,0,600,400,"False",122,200,303,103,103,1
"C01NH",211,124,"1200x900",600,1,600,400,"False",345,467,331,-136,136,0
"C01NH",212,537,"1200x900",1000,1,600,400,"False",621,412,807,395,395,1
"C01NH",213,600,"1200x900",1000,2,600,400,"False",765,207,515,308,308,0
"C01NH",214,177,"1200x900",600,2,600,400,"False",912,236,539,303,303,0
"C01NH",215,112,"1200x900",600,1,600,400,"True",681,490,526,36,36,0
"C01NH",216,181,"1200x900",600,2,600,400,"False",1018,223,486,263,263,0
"C01NH",217,459,"1200x900",1000,0,600,400,"False",70,645,510,-135,135,1
"C01NH",218,12,"1200x900",600,0,600,400,"True",365,336,373,37,37,1
"C01NH",219,446,"1200x900",1000,0,600,400,"False",72,298,386,88,88,1
"C01NH",220,534,"1200x900",1000,1,600,400,"False",328,504,592,88,88,1
"C01NH",221,548,"1200x900",1000,1,600,400,"False",103,278,505,227,227,0
"C01NH",222,8,"1200x900",600,0,600,400,"False",156,679,585,-94,94,0
"C01NH",223,304,"1200x900",800,1,600,400,"False",667,605,507,-98,98,0
"C01NH",224,44,"1200x900",600,0,600,400,"True",305,554,519,-35,35,1
"C01NH",225,408,"1200x900",800,2,600,400,"True",758,567,572,5,5,0
"C01NH",226,156,"1200x900",600,2,600,400,"False",913,197,514,317,317,0
"C01NH",227,76,"1200x900",600,1,600,400,"True",647,614,584,-30,30,0
"C01NH",228,71,"1200x900",600,0,600,400,"False",219,248,316,68,68,0
"C01NH",229,375,"1200x900",800,2,600,400,"False",716,384,242,-142,142,0
"C01NH",230,478,"1200x900",1000,0,600,400,"False",79,672,473,-199,199,1
"C01NH",231,110,"1200x900",600,1,600,400,"True",776,550,569,19,19,1
"C01NH",232,77,"1200x900",600,1,600,400,"True",780,525,560,35,35,0
"C01NH",233,121,"1200x900",600,1,600,400,"False",884,364,545,181,181,0
"C01NH",234,270,"1200x900",800,0,600,400,"True",192,418,414,-4,4,1
"C01NH",235,488,"1200x900",1000,0,600,400,"False",129,687,487,-200,200,1
"C01NH",236,306,"1200x900",800,1,600,400,"True",164,524,530,6,6,0
"C01NH",238,222,"1200x900",800,0,600,400,"False",152,206,415,209,209,1
"C01NH",239,419,"1200x900",800,2,600,400,"True",769,351,353,2,2,0
"C01NH",240,401,"1200x900",800,2,600,400,"True",821,260,257,-3,3,0
"C01NH",241,463,"1200x900",1000,0,600,400,"False",115,693,455,-238,238,1
"C01NH",243,352,"1200x900",800,1,600,400,"False",235,717,556,-161,161,0
"C01NH",244,555,"1200x900",1000,1,600,400,"True",444,556,537,-19,19,0
"C01NH",245,505,"1200x900",1000,1,600,400,"False",191,484,325,-159,159,1
"C01NH",246,620,"1200x900",1000,2,600,400,"False",832,649,357,-292,292,0
"C01NH",247,510,"1200x900",1000,1,600,400,"False",486,338,224,-114,114,1
"C01NH",248,293,"1200x900",800,1,600,400,"False",561,396,251,-145,145,0
"C01NH",249,127,"1200x900",600,1,600,400,"False",309,691,338,-353,353,0
"C01NH",250,231,"1200x900",800,0,600,400,"False",251,718,518,-200,200,1
"C01NH",251,39,"1200x900",600,0,600,400,"False",210,609,501,-108,108,0
"C01NH",252,520,"1200x900",1000,1,600,400,"False",564,260,561,301,301,0
"C01NH",253,305,"1200x900",800,1,600,400,"False",471,716,559,-157,157,0
"C01NH",254,467,"1200x900",1000,0,600,400,"False",74,712,512,-200,200,1
"C01NH",255,315,"1200x900",800,1,600,400,"False",105,211,114,-97,97,0
"C01NH",256,36,"1200x900",600,0,600,400,"True",128,346,323,-23,23,1
"C01NH",257,553,"1200x900",1000,1,600,400,"False",116,712,238,-474,474,0
"C01NH",258,21,"1200x900",600,0,600,400,"True",314,383,428,45,45,1
"C01NH",260,499,"1200x900",1000,0,600,400,"True",93,271,295,24,24,1
"C01NH",261,351,"1200x900",800,1,600,400,"False",122,581,326,-255,255,0
"C01NH",262,464,"1200x900",1000,0,600,400,"True",82,222,258,36,36,1
"C01NH",263,340,"1200x900",800,1,600,400,"False",226,240,299,59,59,0
"C01NH",264,358,"1200x900",800,1,600,400,"False",263,635,461,-174,174,0
"C01NH",265,527,"1200x900",1000,1,600,400,"True",565,601,540,-61,61,0
"C01NH",266,371,"1200x900",800,2,600,400,"True",730,560,524,-36,36,0
"C01NH",267,117,"1200x900",600,1,600,400,"False",711,456,593,137,137,0
"C01NH",268,602,"1200x900",1000,2,600,400,"True",865,452,540,88,88,0
"C01NH",269,14,"1200x900",600,0,600,400,"False",399,224,370,146,146,1
"C01NH",270,166,"1200x900",600,2,600,400,"False",896,274,410,136,136,0
"C01NH",271,145,"1200x900",600,2,600,400,"False",1004,630,513,-117,117,0
"C01NH",272,309,"1200x900",800,1,600,400,"False",186,225,522,297,297,0
"C01NH",273,239,"1200x900",800,0,600,400,"True",114,231,207,-24,24,1
"C01NH",274,271,"1200x900",800,0,600,400,"False",74,360,469,109,109,1
"C01NH",275,90,"1200x900",600,1,600,400,"False",560,474,622,148,148,0
"C01NH",276,390,"1200x900",800,2,600,400,"False",982,674,532,-142,142,1
"C01NH",277,518,"1200x900",1000,1,600,400,"False",583,717,503,-214,214,0
"C01NH",278,275,"1200x900",800,0,600,400,"True",120,594,595,1,1,0
"C01NH",279,562,"1200x900",1000,1,600,400,"True",347,540,544,4,4,0
"C01NH",280,329,"1200x900",800,1,600,400,"False",517,239,584,345,345,0
"C01NH",281,491,"1200x900",1000,0,600,400,"False",108,198,290,92,92,1
"C01NH",282,52,"1200x900",600,0,600,400,"True",171,188,242,54,54,0
"C01NH",283,162,"1200x900",600,2,600,400,"True",849,279,304,25,25,0
"C01NH",284,369,"1200x900",800,2,600,400,"False",903,594,368,-226,226,0
"C01NH",285,338,"1200x900",800,1,600,400,"False",813,253,518,265,265,1
"C01NH",286,217,"1200x900",800,0,600,400,"True",85,573,513,-60,60,1
"C01NH",287,433,"1200x900",1000,0,600,400,"False",76,222,312,90,90,1
"C01NH",288,70,"1200x900",600,0,600,400,"True",309,703,672,-31,31,1
"C01NH",289,556,"1200x900",1000,1,600,400,"False",415,420,529,109,109,0
"C01NH",290,551,"1200x900",1000,1,600,400,"False",146,445,334,-111,111,1
"C01NH",291,362,"1200x900",800,2,600,400,"False",819,338,407,69,69,0
"C01NH",292,364,"1200x900",800,2,600,400,"False",1018,204,365,161,161,0
"C01NH",293,185,"1200x900",600,2,600,400,"False",907,212,480,268,268,0
"C01NH",294,324,"1200x900",800,1,600,400,"False",719,712,445,-267,267,1
"C01NH",295,450,"1200x900",1000,0,600,400,"False",130,204,354,150,150,1
"C01NH",297,536,"1200x900",1000,1,600,400,"False",580,213,346,133,133,0
"C01NH",298,105,"1200x900",600,1,600,400,"False",527,440,264,-176,176,0
"C01NH",299,336,"1200x900",800,1,600,400,"True",251,587,538,-49,49,0
"C01NH",300,538,"1200x900",1000,1,600,400,"True",308,457,485,28,28,1
"C01NH",301,256,"1200x900",800,0,600,400,"False",192,656,734,78,78,1
"C01NH",302,62,"1200x900",600,0,600,400,"False",345,346,532,186,186,1
"C01NH",303,176,"1200x900",600,2,600,400,"False",1033,281,429,148,148,0
"C01NH",304,159,"1200x900",600,2,600,400,"False",992,309,432,123,123,0
"C01NH",305,435,"1200x900",1000,0,600,400,"False",119,200,374,174,174,1
"C01NH",306,43,"1200x900",600,0,600,400,"True",277,446,467,21,21,1
"C01NH",307,343,"1200x900",800,1,600,400,"False",407,557,423,-134,134,0
"C01NH",308,633,"1200x900",1000,2,600,400,"False",564,253,476,223,223,0
"C01NH",309,266,"1200x900",800,0,600,400,"True",126,303,335,32,32,1
"C01NH",310,579,"1200x900",1000,2,600,400,"False",803,394,522,128,128,0
"C01NH",311,55,"1200x900",600,0,600,400,"True",211,305,316,11,11,1
"C01NH",313,31,"1200x900",600,0,600,400,"True",365,338,330,-8,8,1
"C01NH",314,339,"1200x900",800,1,600,400,"True",273,545,545,0,0,1
"C01NH",315,406,"1200x900",800,2,600,400,"False",971,233,518,285,285,0
"C01NH",316,569,"1200x900",1000,1,600,400,"False",494,720,457,-263,263,0
"C01NH",317,473,"1200x900",1000,0,600,400,"False",75,323,399,76,76,1
"C01NH",318,436,"1200x900",1000,0,600,400,"False",82,617,510,-107,107,1
"C01NH",320,17,"1200x900",600,0,600,400,"True",402,496,513,17,17,1
"C01NH",322,93,"1200x900",600,1,600,400,"True",139,540,471,-69,69,0
"C01NH",324,493,"1200x900",1000,0,600,400,"False",80,582,490,-92,92,1
"C01NH",325,483,"1200x900",1000,0,600,400,"True",93,191,231,40,40,1
"C01NH",326,513,"1200x900",1000,1,600,400,"False",235,602,352,-250,250,0
"C01NH",327,540,"1200x900",1000,1,600,400,"False",389,568,430,-138,138,1
"C01NH",328,151,"1200x900",600,2,600,400,"False",828,680,504,-176,176,0
"C01NH",330,79,"1200x900",600,1,600,400,"False",731,289,416,127,127,0
"C01NH",331,98,"1200x900",600,1,600,400,"False",625,530,426,-104,104,0
"C01NH",332,325,"1200x900",800,1,600,400,"True",105,394,346,-48,48,0
"C01NH",334,617,"1200x900",1000,2,600,400,"False",294,180,390,210,210,0
"C01NH",335,25,"1200x900",600,0,600,400,"True",263,403,395,-8,8,1
"C01NH",336,296,"1200x900",800,1,600,400,"True",89,279,292,13,13,0
"C01NH",337,418,"1200x900",800,2,600,400,"False",754,507,334,-173,173,0
"C01NH",338,56,"1200x900",600,0,600,400,"False",148,491,375,-116,116,0
"C01NH",339,587,"1200x900",1000,2,600,400,"False",741,686,376,-310,310,0
"C01NH",340,393,"1200x900",800,2,600,400,"False",657,620,418,-202,202,0
"C01NH",341,210,"1200x900",600,2,600,400,"True",835,506,425,-81,81,0
"C01NH",342,48,"1200x900",600,0,600,400,"False",323,645,563,-82,82,1
"C01NH",343,501,"1200x900",1000,0,600,400,"False",96,323,439,116,116,1
"C01NH",344,580,"1200x900",1000,2,600,400,"False",651,267,407,140,140,0
"C01NH",345,498,"1200x900",1000,0,600,400,"True",100,260,241,-19,19,1
"C01NH",346,9,"1200x900",600,0,600,400,"False",509,654,517,-137,137,1
"C01NH",347,264,"1200x900",800,0,600,400,"True",198,660,627,-33,33,1
"C01NH",348,153,"1200x900",600,2,600,400,"True",1037,601,649,48,48,0
"C01NH",349,608,"1200x900",1000,2,600,400,"False",742,250,633,383,383,0
"C01NH",350,357,"1200x900",800,1,600,400,"False",109,594,653,59,59,0
"C01NH",351,480,"1200x900",1000,0,600,400,"False",100,231,402,171,171,1
"C01NH",352,482,"1200x900",1000,0,600,400,"False",79,686,616,-70,70,1
"C01NH",353,299,"1200x900",800,1,600,400,"False",779,274,511,237,237,0
"C01NH",354,594,"1200x900",1000,2,600,400,"False",537,637,517,-120,120,0
"C01NH",355,487,"1200x900",1000,0,600,400,"False",78,670,554,-116,116,1
"C01NH",356,596,"1200x900",1000,2,600,400,"True",706,513,547,34,34,0
"C01NH",358,422,"1200x900",800,2,600,400,"True",712,558,543,-15,15,0
"C01NH",359,545,"1200x900",1000,1,600,400,"True",358,562,531,-31,31,0
"C01NH",361,34,"1200x900",600,0,600,400,"True",361,242,268,26,26,1
"C01NH",363,68,"1200x900",600,0,600,400,"True",165,367,330,-37,37,0
"C01NH",364,322,"1200x900",800,1,600,400,"False",703,206,331,125,125,1
"C01NH",365,276,"1200x900",800,0,600,400,"True",281,217,222,5,5,1
"C01NH",366,614,"1200x900",1000,2,600,400,"False",823,563,344,-219,219,0
"C01NH",367,313,"1200x900",800,1,600,400,"False",588,421,328,-93,93,0
"C01NH",368,49,"1200x900",600,0,600,400,"True",109,380,334,-46,46,0
"C01NH",369,280,"1200x900",800,0,600,400,"True",104,302,252,-50,50,1
"C01NH",370,194,"1200x900",600,2,600,400,"False",896,236,322,86,86,0
"C01NH",371,128,"1200x900",600,1,600,400,"True",661,258,205,-53,53,1
"C01NH",372,37,"1200x900",600,0,600,400,"False",258,403,310,-93,93,1
"C01NH",373,484,"1200x900",1000,0,600,400,"True",100,223,278,55,55,1
"C01NH",374,396,"1200x900",800,2,600,400,"False",678,663,356,-307,307,0
"C01NH",375,144,"1200x900",600,1,600,400,"True",718,371,352,-19,19,0
"C01NH",376,456,"1200x900",1000,0,600,400,"True",91,257,230,-27,27,1
"C01NH",377,374,"1200x900",800,2,600,400,"False",755,450,302,-148,148,0
"C01NH",378,161,"1200x900",600,2,600,400,"False",939,553,419,-134,134,0
"C01NH",379,94,"1200x900",600,1,600,400,"True",729,482,500,18,18,0
"C01NH",380,635,"1200x900",1000,2,600,400,"False",833,402,517,115,115,0
"C01NH",381,532,"1200x900",1000,1,600,400,"False",215,207,468,261,261,0
"C01NH",382,624,"1200x900",1000,2,600,400,"False",693,501,406,-95,95,0
"C01NH",383,404,"1200x900",800,2,600,400,"False",842,396,313,-83,83,0
"C01NH",384,568,"1200x900",1000,1,600,400,"True",286,475,478,3,3,1
"C01NH",385,260,"1200x900",800,0,600,400,"True",103,525,471,-54,54,1
"C01NH",386,295,"1200x900",800,1,600,400,"False",471,334,470,136,136,0
"C01NH",388,630,"1200x900",1000,2,600,400,"False",754,559,449,-110,110,0
"C01NH",389,11,"1200x900",600,0,600,400,"False",372,670,577,-93,93,1
"C01NH",390,155,"1200x900",600,2,600,400,"False",940,269,520,251,251,0
"C01NH",391,502,"1200x900",1000,0,600,400,"False",111,639,498,-141,141,1
"C01NH",392,66,"1200x900",600,0,600,400,"False",155,673,597,-76,76,0
"C01NH",393,101,"1200x900",600,1,600,400,"True",541,656,660,4,4,0
"C01NH",394,522,"1200x900",1000,1,600,400,"False",223,379,691,312,312,0
"C01NH",395,465,"1200x900",1000,0,600,400,"False",85,203,365,162,162,1
"C01NH",396,503,"1200x900",1000,0,600,400,"True",86,279,267,-12,12,1
"C01NH",400,400,"1200x900",800,2,600,400,"False",733,297,393,96,96,0
"C01NH",401,148,"1200x900",600,2,600,400,"True",907,330,345,15,15,0
"C01NH",402,349,"1200x900",800,1,600,400,"False",402,665,542,-123,123,0
"C01NH",403,73,"1200x900",600,1,600,400,"True",94,665,569,-96,96,0
"C01NH",404,58,"1200x900",600,0,600,400,"True",353,655,627,-28,28,1
"C01NH",405,327,"1200x900",800,1,600,400,"False",152,339,448,109,109,0
"C01NH",406,472,"1200x900",1000,0,600,400,"False",77,685,571,-114,114,1
"C01NH",407,376,"1200x900",800,2,600,400,"False",788,275,476,201,201,0
"C01NH",408,233,"1200x900",800,0,600,400,"True",164,700,711,11,11,1
"C01NH",409,235,"1200x900",800,0,600,400,"True",146,646,718,72,72,1
"C01NH",410,143,"1200x900",600,1,600,400,"False",479,284,571,287,287,1
"C01NH",411,184,"1200x900",600,2,600,400,"False",1067,441,675,234,234,0
"C01NH",412,405,"1200x900",800,2,600,400,"False",790,307,520,213,213,0
"C01NH",413,95,"1200x900",600,1,600,400,"True",749,425,443,18,18,1
"C01NH",414,557,"1200x900",1000,1,600,400,"False",677,505,589,84,84,1
"C01NH",415,506,"1200x900",1000,1,600,400,"False",559,567,371,-196,196,1
"C01NH",417,165,"1200x900",600,2,600,400,"False",912,554,668,114,114,0
"C01NH",418,89,"1200x900",600,1,600,400,"True",917,366,329,-37,37,1
"C01NH",419,570,"1200x900",1000,1,600,400,"False",315,352,278,-74,74,0
"C01NH",420,83,"1200x900",600,1,600,400,"False",763,568,367,-201,201,1
"C01NH",421,294,"1200x900",800,1,600,400,"True",262,287,295,8,8,0
"C01NH",422,232,"1200x900",800,0,600,400,"False",84,511,383,-128,128,1
"C01NH",423,111,"1200x900",600,1,600,400,"False",922,552,336,-216,216,1
"C01NH",424,209,"1200x900",600,2,600,400,"False",937,637,475,-162,162,0
"C01NH",425,399,"1200x900",800,2,600,400,"False",603,602,351,-251,251,0
"C01NH",426,32,"1200x900",600,0,600,400,"True",152,563,575,12,12,1
"C01NH",427,361,"1200x900",800,2,600,400,"False",931,328,512,184,184,0
"C01NH",428,384,"1200x900",800,2,600,400,"False",821,707,601,-106,106,0
"C01NH",429,7,"1200x900",600,0,600,400,"False",431,654,537,-117,117,1
"C01NH",430,281,"1200x900",800,0,600,400,"True",112,611,570,-41,41,1
"C01NH",431,255,"1200x900",800,0,600,400,"False",93,709,596,-113,113,1
"C01NH",432,38,"1200x900",600,0,600,400,"True",120,628,579,-49,49,1
"C01NH",433,254,"1200x900",800,0,600,400,"True",136,583,645,62,62,1
"C01NH",434,65,"1200x900",600,0,600,400,"True",442,645,617,-28,28,1
"C01NH",435,645,"1200x900",1000,2,600,400,"False",619,396,606,210,210,0
"C01NH",436,284,"1200x900",800,0,600,400,"True",135,293,275,-18,18,1
"C01NH",437,528,"1200x900",1000,1,600,400,"False",839,227,543,316,316,1
"C01NH",438,45,"1200x900",600,0,600,400,"False",487,678,571,-107,107,1
"C01NH",439,202,"1200x900",600,2,600,400,"True",966,460,497,37,37,0
"C01NH",442,103,"1200x900",600,1,600,400,"True",528,320,352,32,32,1
"C01NH",443,308,"1200x900",800,1,600,400,"False",437,425,484,59,59,0
"C01NH",444,398,"1200x900",800,2,600,400,"False",944,698,558,-140,140,0
"C01NH",445,136,"1200x900",600,1,600,400,"False",264,205,354,149,149,0
"C01NH",446,584,"1200x900",1000,2,600,400,"True",731,413,399,-14,14,0
"C01NH",447,504,"1200x900",1000,0,600,400,"False",107,699,566,-133,133,1
"C01NH",448,22,"1200x900",600,0,600,400,"True",398,591,606,15,15,1
"C01NH",449,86,"1200x900",600,1,600,400,"False",692,388,510,122,122,1
"C01NH",450,575,"1200x900",1000,1,600,400,"False",272,693,591,-102,102,0
"C01NH",451,511,"1200x900",1000,1,600,400,"False",408,390,483,93,93,1
"C01NH",452,170,"1200x900",600,2,600,400,"True",996,468,417,-51,51,0
"C01NH",453,387,"1200x900",800,2,600,400,"True",990,444,518,74,74,0
"C01NH",454,84,"1200x900",600,1,600,400,"False",144,184,293,109,109,0
"C01NH",455,477,"1200x900",1000,0,600,400,"False",88,640,397,-243,243,1
"C01NH",456,414,"1200x900",800,2,600,400,"True",831,592,543,-49,49,0
"C01NH",457,530,"1200x900",1000,1,600,400,"False",584,405,175,-230,230,1
"C01NH",458,180,"1200x900",600,2,600,400,"False",929,270,151,-119,119,0
"C01NH",459,591,"1200x900",1000,2,600,400,"False",698,336,476,140,140,0
"C01NH",460,146,"1200x900",600,2,600,400,"True",989,492,529,37,37,0
"C01NH",461,360,"1200x900",800,1,600,400,"False",203,608,771,163,163,0
"C01NH",462,353,"1200x900",800,1,600,400,"False",90,476,592,116,116,0
"C01NH",463,592,"1200x900",1000,2,600,400,"True",492,392,373,-19,19,0
"C01NH",464,149,"1200x900",600,2,600,400,"True",890,289,352,63,63,0
"C01NH",465,637,"1200x900",1000,2,600,400,"True",750,460,483,23,23,0
"C01NH",466,413,"1200x900",800,2,600,400,"False",849,506,614,108,108,0
"C01NH",467,290,"1200x900",800,1,600,400,"True",789,603,566,-37,37,0
"C01NH",468,619,"1200x900",1000,2,600,400,"False",803,247,686,439,439,0
"C01NH",469,438,"1200x900",1000,0,600,400,"False",77,713,609,-104,104,1
"C01NH",470,391,"1200x900",800,2,600,400,"True",895,521,572,51,51,0
"C01NH",471,552,"1200x900",1000,1,600,400,"False",255,412,694,282,282,0
"C01NH",472,572,"1200x900",1000,1,600,400,"False",302,260,616,356,356,0
"C01NH",473,218,"1200x900",800,0,600,400,"True",106,397,353,-44,44,1
"C01NH",474,640,"1200x900",1000,2,600,400,"False",361,334,530,196,196,0
"C01NH",475,578,"1200x900",1000,2,600,400,"False",966,276,491,215,215,0
"C01NH",476,515,"1200x900",1000,1,600,400,"False",307,217,443,226,226,0
"C01NH",477,279,"1200x900",800,0,600,400,"False",252,202,270,68,68,1
"C01NH",478,4,"1200x900",600,0,600,400,"False",602,200,282,82,82,1
"C01NH",479,476,"1200x900",1000,0,600,400,"True",76,359,349,-10,10,1
"C01NH",480,597,"1200x900",1000,2,600,400,"True",352,239,279,40,40,0
"C01NH",481,115,"1200x900",600,1,600,400,"False",545,307,241,-66,66,0
"C01NH",482,440,"1200x900",1000,0,600,400,"True",71,237,249,12,12,1
"C01NH",483,365,"1200x900",800,2,600,400,"True",1055,305,358,53,53,0
"C01NH",484,171,"1200x900",600,2,600,400,"False",909,200,340,140,140,0
"C01NH",486,261,"1200x900",800,0,600,400,"True",86,713,719,6,6,1
"C01NH",487,208,"1200x900",600,2,600,400,"True",946,399,425,26,26,0
"C01NH",488,610,"1200x900",1000,2,600,400,"True",702,293,358,65,65,0
"C01NH",489,40,"1200x900",600,0,600,400,"True",143,513,556,43,43,0
"C01NH",490,244,"1200x900",800,0,600,400,"False",194,203,356,153,153,1
"C01NH",491,632,"1200x900",1000,2,600,400,"False",984,227,486,259,259,0
"C01NH",492,81,"1200x900",600,1,600,400,"False",696,225,371,146,146,0
"C01NH",493,29,"1200x900",600,0,600,400,"False",385,533,612,79,79,1
"C01NH",494,19,"1200x900",600,0,600,400,"True",286,686,654,-32,32,0
"C01NH",495,74,"1200x900",600,1,600,400,"True",115,358,441,83,83,0
"C01NH",496,238,"1200x900",800,0,600,400,"True",162,283,295,12,12,1
"C01NH",497,285,"1200x900",800,0,600,400,"True",237,396,361,-35,35,1
"C01NH",498,183,"1200x900",600,2,600,400,"True",927,289,325,36,36,0
"C01NH",499,199,"1200x900",600,2,600,400,"False",992,467,275,-192,192,0
"C01NH",501,426,"1200x900",800,2,600,400,"True",830,263,329,66,66,0
"C01NH",502,345,"1200x900",800,1,600,400,"False",841,566,350,-216,216,1
"C01NH",504,392,"1200x900",800,2,600,400,"False",1031,618,348,-270,270,0
"C01NH",505,203,"1200x900",600,2,600,400,"False",938,603,440,-163,163,0
"C01NH",506,257,"1200x900",800,0,600,400,"True",97,219,276,57,57,1
"C01NH",507,57,"1200x900",600,0,600,400,"True",354,508,527,19,19,1
"C01NH",508,289,"1200x900",800,1,600,400,"False",421,703,580,-123,123,1
"C01NH",509,646,"1200x900",1000,2,600,400,"False",829,227,443,216,216,1
"C01NH",510,516,"1200x900",1000,1,600,400,"False",440,559,456,-103,103,0
"C01NH",511,135,"1200x900",600,1,600,400,"False",759,569,189,-380,380,0
"C01NH",512,316,"1200x900",800,1,600,400,"False",362,319,446,127,127,0
"C01NH",513,251,"1200x900",800,0,600,400,"False",88,352,263,-89,89,1
"C01NH",514,328,"1200x900",800,1,600,400,"False",104,649,529,-120,120,0
"C01NH",515,586,"1200x900",1000,2,600,400,"False",802,262,429,167,167,0
"C01NH",516,230,"1200x900",800,0,600,400,"False",99,678,557,-121,121,1
"C01NH",517,445,"1200x900",1000,0,600,400,"True",78,302,345,43,43,1
"C01NH",518,172,"1200x900",600,2,600,400,"True",912,444,411,-33,33,0
"C01NH",519,104,"1200x900",600,1,600,400,"True",448,584,582,-2,2,0
"C01NH",520,356,"1200x900",800,1,600,400,"False",123,484,623,139,139,0
"C01NH",521,479,"1200x900",1000,0,600,400,"False",74,705,557,-148,148,1
"C01NH",522,550,"1200x900",1000,1,600,400,"False",301,459,553,94,94,0
"C01NH",523,160,"1200x900",600,2,600,400,"True",863,606,542,-64,64,0
"C01NH",524,512,"1200x900",1000,1,600,400,"False",139,261,593,332,332,0
"C01NH",525,206,"1200x900",600,2,600,400,"False",975,223,524,301,301,0
"C01NH",526,495,"1200x900",1000,0,600,400,"False",93,692,482,-210,210,1
"C01NH",527,46,"1200x900",600,0,600,400,"True",193,355,377,22,22,1
"C01NH",528,13,"1200x900",600,0,600,400,"True",296,211,264,53,53,1
"C01NH",529,589,"1200x900",1000,2,600,400,"True",856,418,426,8,8,0
"C01NH",530,126,"1200x900",600,1,600,400,"False",849,354,483,129,129,0
"C01NH",531,88,"1200x900",600,1,600,400,"False",186,554,433,-121,121,0
"C01NH",532,200,"1200x900",600,2,600,400,"False",897,302,451,149,149,0
"C01NH",533,599,"1200x900",1000,2,600,400,"False",316,570,349,-221,221,0
"C01NH",534,417,"1200x900",800,2,600,400,"False",750,280,450,170,170,0
"C01NH",535,367,"1200x900",800,2,600,400,"True",613,464,383,-81,81,0
"C01NH",536,543,"1200x900",1000,1,600,400,"False",88,202,470,268,268,0
"C01NH",537,272,"1200x900",800,0,600,400,"True",200,181,175,-6,6,1
"C01NH",538,67,"1200x900",600,0,600,400,"True",289,308,279,-29,29,1
"C01NH",539,138,"1200x900",600,1,600,400,"True",844,580,516,-64,64,1
"C01NH",540,453,"1200x900",1000,0,600,400,"True",71,393,372,-21,21,1
"C01NH",541,134,"1200x900",600,1,600,400,"True",300,188,265,77,77,0
"C01NH",542,27,"1200x900",600,0,600,400,"True",373,309,248,-61,61,1
"C01NH",543,54,"1200x900",600,0,600,400,"False",474,564,475,-89,89,1
"C01NH",544,531,"1200x900",1000,1,600,400,"False",233,362,495,133,133,0
"C01NH",545,330,"1200x900",800,1,600,400,"True",759,301,248,-53,53,1
"C01NH",546,411,"1200x900",800,2,600,400,"True",805,361,376,15,15,0
"C01NH",547,373,"1200x900",800,2,600,400,"False",694,326,411,85,85,0
"C01NH",548,249,"1200x900",800,0,600,400,"True",126,306,299,-7,7,1
"C01NH",549,583,"1200x900",1000,2,600,400,"False",949,284,429,145,145,1
"C01NH",550,60,"1200x900",600,0,600,400,"True",365,213,240,27,27,1
"C01NH",551,15,"1200x900",600,0,600,400,"True",473,352,334,-18,18,1
"C01NH",552,158,"1200x900",600,2,600,400,"True",939,300,353,53,53,0
"C01NH",553,489,"1200x900",1000,0,600,400,"False",88,604,401,-203,203,1
"C01NH",554,559,"1200x900",1000,1,600,400,"False",641,244,460,216,216,0
"C01NH",555,444,"1200x900",1000,0,600,400,"False",101,714,602,-112,112,1
"C01NH",556,574,"1200x900",1000,1,600,400,"False",614,194,538,344,344,0
"C01NH",557,1,"1200x900",600,0,600,400,"True",136,502,460,-42,42,0
"C01NH",558,606,"1200x900",1000,2,600,400,"True",653,627,573,-54,54,0
"C01NH",559,389,"1200x900",800,2,600,400,"True",843,530,515,-15,15,0
"C01NH",560,461,"1200x900",1000,0,600,400,"False",95,711,619,-92,92,1
"C01NH",561,297,"1200x900",800,1,600,400,"False",625,244,442,198,198,0
"C01NH",562,526,"1200x900",1000,1,600,400,"True",497,710,650,-60,60,0
"C01NH",563,372,"1200x900",800,2,600,400,"True",833,620,628,8,8,0
"C01NH",564,409,"1200x900",800,2,600,400,"True",501,659,597,-62,62,0
"C01NH",565,229,"1200x900",800,0,600,400,"True",117,697,654,-43,43,1
"C01NH",566,546,"1200x900",1000,1,600,400,"False",305,374,640,266,266,0
"C01NH",567,475,"1200x900",1000,0,600,400,"False",101,715,605,-110,110,1
"C01NH",569,205,"1200x900",600,2,600,400,"False",1021,504,567,63,63,0
"C01NH",570,611,"1200x900",1000,2,600,400,"True",414,511,572,61,61,0
"C01NH",571,634,"1200x900",1000,2,600,400,"False",735,313,588,275,275,0
"C01NH",572,549,"1200x900",1000,1,600,400,"False",657,366,562,196,196,0
"C01NH",573,211,"1200x900",600,2,600,400,"True",986,407,497,90,90,0
"C01NH",574,236,"1200x900",800,0,600,400,"True",162,350,345,-5,5,1
"C01NH",575,23,"1200x900",600,0,600,400,"True",308,463,443,-20,20,1
"C01NH",576,567,"1200x900",1000,1,600,400,"False",655,297,161,-136,136,1
"C01NH",577,216,"1200x900",600,2,600,400,"True",1029,286,321,35,35,0
"C01NH",578,191,"1200x900",600,2,600,400,"True",962,396,351,-45,45,0
"C01NH",579,481,"1200x900",1000,0,600,400,"True",80,185,244,59,59,1
"C01NH",580,237,"1200x900",800,0,600,400,"False",204,481,573,92,92,1
"C01NH",581,348,"1200x900",800,1,600,400,"False",764,294,454,160,160,0
"C01NH",582,245,"1200x900",800,0,600,400,"False",296,235,319,84,84,1
"C01NH",583,283,"1200x900",800,0,600,400,"True",90,264,196,-68,68,1
"C01NH",584,125,"1200x900",600,1,600,400,"False",750,531,300,-231,231,0
"C01NH",585,603,"1200x900",1000,2,600,400,"False",693,280,494,214,214,0
"C01NH",586,571,"1200x900",1000,1,600,400,"False",239,522,582,60,60,1
"C01NH",587,252,"1200x900",800,0,600,400,"False",224,673,612,-61,61,1
"C01NH",588,286,"1200x900",800,0,600,400,"True",105,378,386,8,8,1
"C01NH",589,118,"1200x900",600,1,600,400,"True",190,588,594,6,6,0
"C01NH",590,6,"1200x900",600,0,600,400,"True",217,689,702,13,13,1
"C01NH",591,302,"1200x900",800,1,600,400,"False",479,467,545,78,78,1
"C01NH",592,147,"1200x900",600,2,600,400,"True",942,418,510,92,92,0
"C01NH",593,386,"1200x900",800,2,600,400,"False",774,301,493,192,192,0
"C01NH",594,421,"1200x900",800,2,600,400,"False",898,394,519,125,125,0
"C01NH",595,109,"1200x900",600,1,600,400,"True",691,589,612,23,23,0
"C01NH",596,434,"1200x900",1000,0,600,400,"False",89,657,533,-124,124,1
"C01NH",597,448,"1200x900",1000,0,600,400,"False",107,641,498,-143,143,1
"C01NH",598,129,"1200x900",600,1,600,400,"False",859,482,385,-97,97,1
"C01NH",599,460,"1200x900",1000,0,600,400,"True",155,189,225,36,36,1
"C01NH",600,486,"1200x900",1000,0,600,400,"False",102,676,472,-204,204,1
"C01NH",601,91,"1200x900",600,1,600,400,"False",417,630,536,-94,94,1
"C01NH",602,598,"1200x900",1000,2,600,400,"True",706,559,530,-29,29,0
"C01NH",603,355,"1200x900",800,1,600,400,"False",77,386,616,230,230,0
"C01NH",604,454,"1200x900",1000,0,600,400,"False",78,687,502,-185,185,1
"C01NH",605,447,"1200x900",1000,0,600,400,"True",71,339,297,-42,42,1
"C01NH",606,53,"1200x900",600,0,600,400,"True",177,189,168,-21,21,0
"C01NH",607,641,"1200x900",1000,2,600,400,"False",897,272,395,123,123,0
"C01NH",608,28,"1200x900",600,0,600,400,"True",336,410,387,-23,23,1
"C01NH",609,402,"1200x900",800,2,600,400,"False",878,234,463,229,229,0
"C01NH",610,439,"1200x900",1000,0,600,400,"True",110,229,255,26,26,1
"C01NH",611,612,"1200x900",1000,2,600,400,"False",706,198,296,98,98,0
"C01NH",612,97,"1200x900",600,1,600,400,"False",760,643,496,-147,147,1
"C01NH",613,474,"1200x900",1000,0,600,400,"True",85,339,312,-27,27,1
"C01NH",614,179,"1200x900",600,2,600,400,"False",908,602,328,-274,274,0
"C01NH",615,558,"1200x900",1000,1,600,400,"False",72,464,371,-93,93,1
"C01NH",616,16,"1200x900",600,0,600,400,"True",297,514,484,-30,30,1
"C01NH",617,377,"1200x900",800,2,600,400,"True",683,388,447,59,59,0
"C01NH",619,223,"1200x900",800,0,600,400,"False",179,191,111,-80,80,1
"C01NH",620,311,"1200x900",800,1,600,400,"False",710,261,471,210,210,0
"C01NH",621,120,"1200x900",600,1,600,400,"True",690,655,616,-39,39,0
"C01NH",622,529,"1200x900",1000,1,600,400,"True",267,412,435,23,23,1
"C01NH",623,64,"1200x900",600,0,600,400,"True",102,339,276,-63,63,0
"C01NH",624,273,"1200x900",800,0,600,400,"False",180,309,162,-147,147,1
"C01NH",625,123,"1200x900",600,1,600,400,"False",761,365,264,-101,101,1
"C01NH",626,521,"1200x900",1000,1,600,400,"False",111,303,208,-95,95,1
"C01NH",627,318,"1200x900",800,1,600,400,"False",788,534,402,-132,132,0
"C01NH",628,388,"1200x900",800,2,600,400,"False",930,320,400,80,80,0
"C01NH",629,492,"1200x900",1000,0,600,400,"False",76,692,590,-102,102,1
"C01NH",630,415,"1200x900",800,2,600,400,"False",823,684,454,-230,230,0
"C01NH",631,451,"1200x900",1000,0,600,400,"False",110,702,582,-120,120,1
"C01NH",632,335,"1200x900",800,1,600,400,"True",124,360,298,-62,62,0
"C01NH",633,539,"1200x900",1000,1,600,400,"True",510,383,358,-25,25,0
"C01NH",634,107,"1200x900",600,1,600,400,"False",878,678,339,-339,339,0
"C01NH",635,2,"1200x900",600,0,600,400,"False",159,323,237,-86,86,0
"C01NH",636,277,"1200x900",800,0,600,400,"True",140,310,322,12,12,1
"C01NH",637,638,"1200x900",1000,2,600,400,"False",385,198,355,157,157,0
"C01NH",638,41,"1200x900",600,0,600,400,"True",370,452,426,-26,26,1
"C01NH",639,458,"1200x900",1000,0,600,400,"False",78,624,464,-160,160,1
"C01NH",640,163,"1200x900",600,2,600,400,"False",1046,665,450,-215,215,0
"C01NH",641,639,"1200x900",1000,2,600,400,"False",504,456,316,-140,140,0
"C01NH",642,100,"1200x900",600,1,600,400,"False",453,511,383,-128,128,0
"C01NH",643,35,"1200x900",600,0,600,400,"True",366,555,537,-18,18,1
"C01NH",644,621,"1200x900",1000,2,600,400,"True",540,478,442,-36,36,0
"C01NH",646,354,"1200x900",800,1,600,400,"False",118,236,431,195,195,0
"C01NH",648,648,"1200x900",1000,2,600,400,"True",557,394,471,77,77,0
"C02EM",1,572,"1200x900",1000,1,600,400,"True",302,260,302,42,42,0
"C02EM",2,237,"1200x900",800,0,600,400,"True",204,481,443,-38,38,1
"C02EM",3,616,"1200x900",1000,2,600,400,"False",854,357,275,-82,82,1
"C02EM",4,207,"1200x900",600,2,600,400,"False",838,235,367,132,132,0
"C02EM",5,353,"1200x900",800,1,600,400,"False",90,476,267,-209,209,0
"C02EM",6,257,"1200x900",800,0,600,400,"True",97,219,162,-57,57,1
"C02EM",7,448,"1200x900",1000,0,600,400,"True",107,641,613,-28,28,1
"C02EM",8,190,"1200x900",600,2,600,400,"False",977,238,342,104,104,0
"C02EM",9,206,"1200x900",600,2,600,400,"True",975,223,241,18,18,0
"C02EM",10,620,"1200x900",1000,2,600,400,"False",832,649,191,-458,458,0
"C02EM",11,86,"1200x900",600,1,600,400,"True",692,388,413,25,25,1
"C02EM",12,218,"1200x900",800,0,600,400,"False",106,397,251,-146,146,1
"C02EM",13,40,"1200x900",600,0,600,400,"True",143,513,469,-44,44,0
"C02EM",14,251,"1200x900",800,0,600,400,"True",88,352,357,5,5,1
"C02EM",15,160,"1200x900",600,2,600,400,"False",863,606,350,-256,256,0
"C02EM",16,253,"1200x900",800,0,600,400,"True",177,424,470,46,46,1
"C02EM",17,49,"1200x900",600,0,600,400,"True",109,380,370,-10,10,0
"C02EM",18,435,"1200x900",1000,0,600,400,"False",119,200,319,119,119,1
"C02EM",19,630,"1200x900",1000,2,600,400,"False",754,559,354,-205,205,0
"C02EM",20,240,"1200x900",800,0,600,400,"False",330,656,765,109,109,1
"C02EM",21,318,"1200x900",800,1,600,400,"False",788,534,753,219,219,0
"C02EM",22,475,"1200x900",1000,0,600,400,"False",101,715,429,-286,286,1
"C02EM",23,76,"1200x900",600,1,600,400,"False",647,614,404,-210,210,0
"C02EM",24,39,"1200x900",600,0,600,400,"False",210,609,533,-76,76,0
"C02EM",25,224,"1200x900",800,0,600,400,"True",161,474,425,-49,49,1
"C02EM",26,573,"1200x900",1000,1,600,400,"False",486,615,502,-113,113,0
"C02EM",27,635,"1200x900",1000,2,600,400,"False",833,402,693,291,291,0
"C02EM",28,314,"1200x900",800,1,600,400,"True",277,616,558,-58,58,1
"C02EM",29,191,"1200x900",600,2,600,400,"True",962,396,347,-49,49,0
"C02EM",30,336,"1200x900",800,1,600,400,"False",251,587,342,-245,245,0
"C02EM",31,268,"1200x900",800,0,600,400,"True",148,400,378,-22,22,1
"C02EM",32,560,"1200x900",1000,1,600,400,"False",516,693,467,-226,226,0
"C02EM",33,100,"1200x900",600,1,600,400,"False",453,511,430,-81,81,0
"C02EM",34,614,"1200x900",1000,2,600,400,"True",823,563,518,-45,45,0
"C02EM",35,164,"1200x900",600,2,600,400,"False",1051,268,426,158,158,0
"C02EM",36,52,"1200x900",600,0,600,400,"True",171,188,151,-37,37,0
"C02EM",37,419,"1200x900",800,2,600,400,"False",769,351,281,-70,70,0
"C02EM",38,438,"1200x900",1000,0,600,400,"False",77,713,577,-136,136,1
"C02EM",39,119,"1200x900",600,1,600,400,"False",168,563,225,-338,338,0
"C02EM",40,297,"1200x900",800,1,600,400,"False",625,244,541,297,297,0
"C02EM",41,479,"1200x900",1000,0,600,400,"True",74,705,705,0,0,1
"C02EM",42,9,"1200x900",600,0,600,400,"False",509,654,533,-121,121,1
"C02EM",43,223,"1200x900",800,0,600,400,"True",179,191,208,17,17,1
"C02EM",44,451,"1200x900",1000,0,600,400,"False",110,702,631,-71,71,1
"C02EM",45,414,"1200x900",800,2,600,400,"False",831,592,497,-95,95,0
"C02EM",46,495,"1200x900",1000,0,600,400,"True",93,692,675,-17,17,1
"C02EM",47,98,"1200x900",600,1,600,400,"False",625,530,630,100,100,0
"C02EM",48,618,"1200x900",1000,2,600,400,"False",276,671,481,-190,190,0
"C02EM",49,135,"1200x900",600,1,600,400,"True",759,569,603,34,34,0
"C02EM",50,261,"1200x900",800,0,600,400,"False",86,713,623,-90,90,1
"C02EM",51,564,"1200x900",1000,1,600,400,"False",215,264,671,407,407,0
"C02EM",52,305,"1200x900",800,1,600,400,"False",471,716,509,-207,207,0
"C02EM",53,565,"1200x900",1000,1,600,400,"True",451,562,540,-22,22,0
"C02EM",54,219,"1200x900",800,0,600,400,"True",202,502,479,-23,23,1
"C02EM",55,568,"1200x900",1000,1,600,400,"False",286,475,345,-130,130,1
"C02EM",56,335,"1200x900",800,1,600,400,"False",124,360,436,76,76,0
"C02EM",57,143,"1200x900",600,1,600,400,"False",479,284,437,153,153,1
"C02EM",58,594,"1200x900",1000,2,600,400,"False",537,637,397,-240,240,0
"C02EM",59,201,"1200x900",600,2,600,400,"False",1005,462,400,-62,62,0
"C02EM",60,173,"1200x900",600,2,600,400,"False",948,693,497,-196,196,0
"C02EM",61,208,"1200x900",600,2,600,400,"False",946,399,461,62,62,0
"C02EM",62,315,"1200x900",800,1,600,400,"False",105,211,396,185,185,0
"C02EM",63,399,"1200x900",800,2,600,400,"False",603,602,235,-367,367,0
"C02EM",64,359,"1200x900",800,1,600,400,"False",653,241,350,109,109,0
"C02EM",65,293,"1200x900",800,1,600,400,"False",561,396,217,-179,179,0
"C02EM",66,580,"1200x900",1000,2,600,400,"False",651,267,547,280,280,0
"C02EM",67,545,"1200x900",1000,1,600,400,"False",358,562,414,-148,148,0
"C02EM",68,7,"1200x900",600,0,600,400,"True",431,654,621,-33,33,1
"C02EM",69,28,"1200x900",600,0,600,400,"False",336,410,502,92,92,1
"C02EM",70,72,"1200x900",600,0,600,400,"True",158,537,503,-34,34,0
"C02EM",71,270,"1200x900",800,0,600,400,"False",192,418,318,-100,100,1
"C02EM",72,327,"1200x900",800,1,600,400,"True",152,339,394,55,55,0
"C02EM",73,184,"1200x900",600,2,600,400,"False",1067,441,578,137,137,0
"C02EM",74,159,"1200x900",600,2,600,400,"True",992,309,323,14,14,0
"C02EM",75,62,"1200x900",600,0,600,400,"True",345,346,346,0,0,1
"C02EM",76,347,"1200x900",800,1,600,400,"False",757,295,441,146,146,1
"C02EM",77,3,"1200x900",600,0,600,400,"True",298,443,444,1,1,1
"C02EM",78,474,"1200x900",1000,0,600,400,"True",85,339,289,-50,50,1
"C02EM",79,387,"1200x900",800,2,600,400,"False",990,444,323,-121,121,0
"C02EM",80,380,"1200x900",800,2,600,400,"False",942,228,391,163,163,0
"C02EM",81,496,"1200x900",1000,0,600,400,"True",70,639,695,56,56,1
"C02EM",82,397,"1200x900",800,2,600,400,"False",817,692,535,-157,157,0
"C02EM",83,34,"1200x900",600,0,600,400,"True",361,242,274,32,32,1
"C02EM",85,511,"1200x900",1000,1,600,400,"False",408,390,661,271,271,1
"C02EM",86,420,"1200x900",800,2,600,400,"False",519,223,523,300,300,0
"C02EM",87,68,"1200x900",600,0,600,400,"True",165,367,397,30,30,0
"C02EM",88,66,"1200x900",600,0,600,400,"False",155,673,564,-109,109,0
"C02EM",89,25,"1200x900",600,0,600,400,"False",263,403,494,91,91,1
"C02EM",90,333,"1200x900",800,1,600,400,"True",521,548,499,-49,49,0
"C02EM",91,610,"1200x900",1000,2,600,400,"False",702,293,454,161,161,0
"C02EM",92,585,"1200x900",1000,2,600,400,"False",698,688,520,-168,168,1
"C02EM",93,134,"1200x900",600,1,600,400,"False",300,188,422,234,234,0
"C02EM",94,348,"1200x900",800,1,600,400,"False",764,294,365,71,71,0
"C02EM",95,464,"1200x900",1000,0,600,400,"True",82,222,202,-20,20,1
"C02EM",96,101,"1200x900",600,1,600,400,"True",541,656,580,-76,76,0
"C02EM",97,542,"1200x900",1000,1,600,400,"True",304,401,349,-52,52,0
"C02EM",98,133,"1200x900",600,1,600,400,"True",345,551,523,-28,28,0
"C02EM",99,521,"1200x900",1000,1,600,400,"True",111,303,307,4,4,1
"C02EM",100,73,"1200x900",600,1,600,400,"False",94,665,324,-341,341,0
"C02EM",101,58,"1200x900",600,0,600,400,"True",353,655,606,-49,49,1
"C02EM",102,113,"1200x900",600,1,600,400,"True",897,657,642,-15,15,0
"C02EM",103,36,"1200x900",600,0,600,400,"False",128,346,498,152,152,1
"C02EM",104,88,"1200x900",600,1,600,400,"False",186,554,668,114,114,0
"C02EM",105,369,"1200x900",800,2,600,400,"True",903,594,616,22,22,0
"C02EM",106,373,"1200x900",800,2,600,400,"False",694,326,487,161,161,0
"C02EM",107,434,"1200x900",1000,0,600,400,"True",89,657,599,-58,58,1
"C02EM",108,427,"1200x900",800,2,600,400,"False",812,380,480,100,100,0
"C02EM",109,330,"1200x900",800,1,600,400,"True",759,301,278,-23,23,1
"C02EM",110,513,"1200x900",1000,1,600,400,"True",235,602,592,-10,10,0
"C02EM",111,8,"1200x900",600,0,600,400,"False",156,679,563,-116,116,0
"C02EM",112,624,"1200x900",1000,2,600,400,"False",693,501,439,-62,62,0
"C02EM",113,11,"1200x900",600,0,600,400,"False",372,670,565,-105,105,1
"C02EM",114,447,"1200x900",1000,0,600,400,"False",71,339,436,97,97,1
"C02EM",115,123,"1200x900",600,1,600,400,"True",761,365,320,-45,45,1
"C02EM",116,221,"1200x900",800,0,600,400,"True",132,520,470,-50,50,1
"C02EM",117,245,"1200x900",800,0,600,400,"False",296,235,308,73,73,1
"C02EM",118,639,"1200x900",1000,2,600,400,"True",504,456,488,32,32,0
"C02EM",119,422,"1200x900",800,2,600,400,"True",712,558,596,38,38,0
"C02EM",120,192,"1200x900",600,2,600,400,"False",1064,320,727,407,407,0
"C02EM",121,94,"1200x900",600,1,600,400,"True",729,482,519,37,37,0
"C02EM",122,363,"1200x900",800,2,600,400,"False",800,218,446,228,228,0
"C02EM",123,228,"1200x900",800,0,600,400,"False",174,687,608,-79,79,1
"C02EM",124,442,"1200x900",1000,0,600,400,"False",87,183,389,206,206,1
"C02EM",125,67,"1200x900",600,0,600,400,"True",289,308,287,-21,21,1
"C02EM",126,551,"1200x900",1000,1,600,400,"True",146,445,471,26,26,1
"C02EM",127,512,"1200x900",1000,1,600,400,"False",139,261,615,354,354,0
"C02EM",128,16,"1200x900",600,0,600,400,"False",297,514,378,-136,136,1
"C02EM",129,155,"1200x900",600,2,600,400,"True",940,269,293,24,24,0
"C02EM",130,313,"1200x900",800,1,600,400,"True",588,421,442,21,21,0
"C02EM",131,50,"1200x900",600,0,600,400,"False",75,582,662,80,80,0
"C02EM",132,606,"1200x900",1000,2,600,400,"False",653,627,463,-164,164,0
"C02EM",133,33,"1200x900",600,0,600,400,"False",198,533,622,89,89,1
"C02EM",134,51,"1200x900",600,0,600,400,"True",272,181,240,59,59,1
"C02EM",135,426,"1200x900",800,2,600,400,"True",830,263,269,6,6,0
"C02EM",136,537,"1200x900",1000,1,600,400,"False",621,412,545,133,133,1
"C02EM",137,367,"1200x900",800,2,600,400,"True",613,464,408,-56,56,0
"C02EM",138,60,"1200x900",600,0,600,400,"False",365,213,284,71,71,1
"C02EM",139,55,"1200x900",600,0,600,400,"False",211,305,401,96,96,1
"C02EM",140,264,"1200x900",800,0,600,400,"False",198,660,447,-213,213,1
"C02EM",141,346,"1200x900",800,1,600,400,"True",269,635,583,-52,52,0
"C02EM",142,226,"1200x900",800,0,600,400,"True",187,229,230,1,1,1
"C02EM",143,648,"1200x900",1000,2,600,400,"False",557,394,273,-121,121,0
"C02EM",144,236,"1200x900",800,0,600,400,"True",162,350,366,16,16,1
"C02EM",145,517,"1200x900",1000,1,600,400,"True",548,182,240,58,58,0
"C02EM",146,61,"1200x900",600,0,600,400,"False",272,670,524,-146,146,1
"C02EM",147,325,"1200x900",800,1,600,400,"False",105,394,333,-61,61,0
"C02EM",148,338,"1200x900",800,1,600,400,"False",813,253,434,181,181,1
"C02EM",149,6,"1200x900",600,0,600,400,"True",217,689,674,-15,15,1
"C02EM",150,569,"1200x900",1000,1,600,400,"False",494,720,479,-241,241,0
"C02EM",151,515,"1200x900",1000,1,600,400,"False",307,217,381,164,164,0
"C02EM",152,176,"1200x900",600,2,600,400,"False",1033,281,448,167,167,0
"C02EM",153,341,"1200x900",800,1,600,400,"True",735,632,614,-18,18,1
"C02EM",154,546,"1200x900",1000,1,600,400,"False",305,374,509,135,135,0
"C02EM",155,579,"1200x900",1000,2,600,400,"True",803,394,342,-52,52,0
"C02EM",156,578,"1200x900",1000,2,600,400,"False",966,276,456,180,180,0
"C02EM",157,554,"1200x900",1000,1,600,400,"True",79,309,374,65,65,1
"C02EM",158,453,"1200x900",1000,0,600,400,"False",71,393,222,-171,171,1
"C02EM",159,482,"1200x900",1000,0,600,400,"True",79,686,662,-24,24,1
"C02EM",160,13,"1200x900",600,0,600,400,"False",296,211,324,113,113,1
"C02EM",161,281,"1200x900",800,0,600,400,"True",112,611,565,-46,46,1
"C02EM",162,287,"1200x900",800,0,600,400,"True",120,567,568,1,1,1
"C02EM",163,516,"1200x900",1000,1,600,400,"False",440,559,418,-141,141,0
"C02EM",164,356,"1200x900",800,1,600,400,"False",123,484,382,-102,102,0
"C02EM",165,532,"1200x900",1000,1,600,400,"False",215,207,365,158,158,0
"C02EM",166,104,"1200x900",600,1,600,400,"False",448,584,452,-132,132,0
"C02EM",167,645,"1200x900",1000,2,600,400,"True",619,396,342,-54,54,0
"C02EM",168,175,"1200x900",600,2,600,400,"True",1028,432,406,-26,26,0
"C02EM",169,460,"1200x900",1000,0,600,400,"True",155,189,199,10,10,1
"C02EM",170,446,"1200x900",1000,0,600,400,"True",72,298,295,-3,3,1
"C02EM",171,525,"1200x900",1000,1,600,400,"False",123,690,493,-197,197,0
"C02EM",172,29,"1200x900",600,0,600,400,"True",385,533,557,24,24,1
"C02EM",173,137,"1200x900",600,1,600,400,"False",789,577,414,-163,163,0
"C02EM",174,220,"1200x900",800,0,600,400,"True",108,699,738,39,39,1
"C02EM",175,26,"1200x900",600,0,600,400,"True",70,712,741,29,29,0
"C02EM",176,285,"1200x900",800,0,600,400,"False",237,396,481,85,85,1
"C02EM",177,591,"1200x900",1000,2,600,400,"True",698,336,398,62,62,0
"C02EM",178,548,"1200x900",1000,1,600,400,"True",103,278,301,23,23,0
"C02EM",180,351,"1200x900",800,1,600,400,"False",122,581,419,-162,162,0
"C02EM",181,65,"1200x900",600,0,600,400,"True",442,645,648,3,3,1
"C02EM",182,151,"1200x900",600,2,600,400,"False",828,680,466,-214,214,0
"C02EM",183,92,"1200x900",600,1,600,400,"True",624,605,552,-53,53,0
"C02EM",184,31,"1200x900",600,0,600,400,"False",365,338,250,-88,88,1
"C02EM",185,272,"1200x900",800,0,600,400,"True",200,181,225,44,44,1
"C02EM",186,368,"1200x900",800,2,600,400,"True",778,515,549,34,34,0
"C02EM",187,400,"1200x900",800,2,600,400,"False",733,297,438,141,141,0
"C02EM",188,563,"1200x900",1000,1,600,400,"False",201,696,465,-231,231,0
"C02EM",189,485,"1200x900",1000,0,600,400,"True",121,694,736,42,42,1
"C02EM",190,395,"1200x900",800,2,600,400,"False",743,334,512,178,178,0
"C02EM",191,74,"1200x900",600,1,600,400,"True",115,358,386,28,28,0
"C02EM",192,171,"1200x900",600,2,600,400,"False",909,200,368,168,168,0
"C02EM",193,405,"1200x900",800,2,600,400,"False",790,307,402,95,95,0
"C02EM",194,538,"1200x900",1000,1,600,400,"False",308,457,202,-255,255,1
"C02EM",195,449,"1200x900",1000,0,600,400,"True",105,683,629,-54,54,1
"C02EM",196,136,"1200x900",600,1,600,400,"False",264,205,517,312,312,0
"C02EM",197,612,"1200x900",1000,2,600,400,"True",706,198,189,-9,9,0
"C02EM",198,198,"1200x900",600,2,600,400,"False",976,500,410,-90,90,0
"C02EM",199,345,"1200x900",800,1,600,400,"True",841,566,605,39,39,1
"C02EM",200,365,"1200x900",800,2,600,400,"False",1055,305,625,320,320,0
"C02EM",201,607,"1200x900",1000,2,600,400,"False",900,573,468,-105,105,1
"C02EM",202,259,"1200x900",800,0,600,400,"True",156,180,182,2,2,1
"C02EM",204,324,"1200x900",800,1,600,400,"False",719,712,451,-261,261,1
"C02EM",205,425,"1200x900",800,2,600,400,"False",621,438,564,126,126,0
"C02EM",206,371,"1200x900",800,2,600,400,"True",730,560,490,-70,70,0
"C02EM",207,95,"1200x900",600,1,600,400,"True",749,425,444,19,19,1
"C02EM",208,540,"1200x900",1000,1,600,400,"False",389,568,288,-280,280,1
"C02EM",209,629,"1200x900",1000,2,600,400,"False",681,257,563,306,306,0
"C02EM",210,247,"1200x900",800,0,600,400,"True",160,424,431,7,7,1
"C02EM",211,189,"1200x900",600,2,600,400,"False",881,397,492,95,95,0
"C02EM",212,317,"1200x900",800,1,600,400,"True",185,564,488,-76,76,0
"C02EM",213,471,"1200x900",1000,0,600,400,"False",122,200,312,112,112,1
"C02EM",214,486,"1200x900",1000,0,600,400,"True",102,676,670,-6,6,1
"C02EM",215,183,"1200x900",600,2,600,400,"False",927,289,575,286,286,0
"C02EM",216,611,"1200x900",1000,2,600,400,"False",414,511,430,-81,81,0
"C02EM",217,638,"1200x900",1000,2,600,400,"False",385,198,570,372,372,0
"C02EM",218,376,"1200x900",800,2,600,400,"False",788,275,369,94,94,0
"C02EM",219,48,"1200x900",600,0,600,400,"True",323,645,596,-49,49,1
"C02EM",220,640,"1200x900",1000,2,600,400,"False",361,334,551,217,217,0
"C02EM",221,507,"1200x900",1000,1,600,400,"True",608,583,638,55,55,1
"C02EM",222,533,"1200x900",1000,1,600,400,"False",355,483,271,-212,212,0
"C02EM",223,19,"1200x900",600,0,600,400,"True",286,686,638,-48,48,0
"C02EM",224,636,"1200x900",1000,2,600,400,"True",575,583,563,-20,20,0
"C02EM",225,617,"1200x900",1000,2,600,400,"False",294,180,581,401,401,0
"C02EM",226,222,"1200x900",800,0,600,400,"True",152,206,229,23,23,1
"C02EM",227,319,"1200x900",800,1,600,400,"False",494,587,397,-190,190,1
"C02EM",228,428,"1200x900",800,2,600,400,"False",732,665,427,-238,238,0
"C02EM",229,372,"1200x900",800,2,600,400,"True",833,620,583,-37,37,0
"C02EM",230,109,"1200x900",600,1,600,400,"True",691,589,610,21,21,0
"C02EM",231,110,"1200x900",600,1,600,400,"True",776,550,580,30,30,1
"C02EM",232,304,"1200x900",800,1,600,400,"False",667,605,407,-198,198,0
"C02EM",233,144,"1200x900",600,1,600,400,"False",718,371,456,85,85,0
"C02EM",234,487,"1200x900",1000,0,600,400,"True",78,670,624,-46,46,1
"C02EM",235,162,"1200x900",600,2,600,400,"False",849,279,502,223,223,0
"C02EM",236,505,"1200x900",1000,1,600,400,"True",191,484,434,-50,50,1
"C02EM",237,266,"1200x900",800,0,600,400,"True",126,303,258,-45,45,1
"C02EM",238,117,"1200x900",600,1,600,400,"False",711,456,373,-83,83,0
"C02EM",239,179,"1200x900",600,2,600,400,"False",908,602,441,-161,161,0
"C02EM",240,535,"1200x900",1000,1,600,400,"False",372,410,287,-123,123,0
"C02EM",241,404,"1200x900",800,2,600,400,"True",842,396,348,-48,48,0
"C02EM",242,90,"1200x900",600,1,600,400,"False",560,474,365,-109,109,0
"C02EM",244,30,"1200x900",600,0,600,400,"True",107,353,349,-4,4,0
"C02EM",245,302,"1200x900",800,1,600,400,"True",479,467,436,-31,31,1
"C02EM",246,596,"1200x900",1000,2,600,400,"True",706,513,547,34,34,0
"C02EM",247,146,"1200x900",600,2,600,400,"True",989,492,460,-32,32,0
"C02EM",248,432,"1200x900",800,2,600,400,"True",792,380,382,2,2,0
"C02EM",250,63,"1200x900",600,0,600,400,"True",311,188,153,-35,35,1
"C02EM",251,549,"1200x900",1000,1,600,400,"False",657,366,271,-95,95,0
"C02EM",252,230,"1200x900",800,0,600,400,"True",99,678,701,23,23,1
"C02EM",253,196,"1200x900",600,2,600,400,"False",1030,397,506,109,109,0
"C02EM",255,581,"1200x900",1000,2,600,400,"False",310,357,681,324,324,0
"C02EM",256,85,"1200x900",600,1,600,400,"False",434,347,593,246,246,0
"C02EM",257,81,"1200x900",600,1,600,400,"True",696,225,280,55,55,0
"C02EM",258,417,"1200x900",800,2,600,400,"False",750,280,369,89,89,0
"C02EM",259,78,"1200x900",600,1,600,400,"True",885,684,574,-110,110,0
"C02EM",260,543,"1200x900",1000,1,600,400,"False",88,202,383,181,181,0
"C02EM",261,284,"1200x900",800,0,600,400,"False",135,293,221,-72,72,1
"C02EM",262,644,"1200x900",1000,2,600,400,"False",495,486,334,-152,152,0
"C02EM",263,44,"1200x900",600,0,600,400,"True",305,554,532,-22,22,1
"C02EM",264,275,"1200x900",800,0,600,400,"True",120,594,624,30,30,0
"C02EM",265,163,"1200x900",600,2,600,400,"True",1046,665,644,-21,21,0
"C02EM",266,478,"1200x900",1000,0,600,400,"True",79,672,740,68,68,1
"C02EM",267,407,"1200x900",800,2,600,400,"False",989,340,530,190,190,0
"C02EM",268,286,"1200x900",800,0,600,400,"True",105,378,336,-42,42,1
"C02EM",269,80,"1200x900",600,1,600,400,"False",616,423,525,102,102,1
"C02EM",270,27,"1200x900",600,0,600,400,"False",373,309,377,68,68,1
"C02EM",271,433,"1200x900",1000,0,600,400,"True",76,222,275,53,53,1
"C02EM",272,528,"1200x900",1000,1,600,400,"False",839,227,499,272,272,1
"C02EM",273,84,"1200x900",600,1,600,400,"False",144,184,328,144,144,0
"C02EM",274,501,"1200x900",1000,0,600,400,"False",96,323,194,-129,129,1
"C02EM",275,439,"1200x900",1000,0,600,400,"True",110,229,227,-2,2,1
"C02EM",276,138,"1200x900",600,1,600,400,"True",844,580,561,-19,19,1
"C02EM",277,105,"1200x900",600,1,600,400,"False",527,440,299,-141,141,0
"C02EM",278,499,"1200x900",1000,0,600,400,"True",93,271,244,-27,27,1
"C02EM",279,477,"1200x900",1000,0,600,400,"True",88,640,597,-43,43,1
"C02EM",280,634,"1200x900",1000,2,600,400,"True",735,313,308,-5,5,0
"C02EM",281,492,"1200x900",1000,0,600,400,"True",76,692,647,-45,45,1
"C02EM",282,111,"1200x900",600,1,600,400,"False",922,552,743,191,191,1
"C02EM",283,246,"1200x900",800,0,600,400,"True",196,418,446,28,28,1
"C02EM",285,126,"1200x900",600,1,600,400,"False",849,354,549,195,195,0
"C02EM",286,242,"1200x900",800,0,600,400,"True",117,448,458,10,10,1
"C02EM",287,556,"1200x900",1000,1,600,400,"False",415,420,527,107,107,0
"C02EM",288,102,"1200x900",600,1,600,400,"True",861,603,592,-11,11,0
"C02EM",289,541,"1200x900",1000,1,600,400,"False",339,478,613,135,135,0
"C02EM",290,20,"1200x900",600,0,600,400,"True",204,545,567,22,22,1
"C02EM",291,308,"1200x900",800,1,600,400,"False",437,425,597,172,172,0
"C02EM",292,301,"1200x900",800,1,600,400,"True",162,574,599,25,25,0
"C02EM",293,254,"1200x900",800,0,600,400,"False",136,583,691,108,108,1
"C02EM",294,561,"1200x900",1000,1,600,400,"False",231,406,204,-202,202,0
"C02EM",295,148,"1200x900",600,2,600,400,"False",907,330,519,189,189,0
"C02EM",296,296,"1200x900",800,1,600,400,"False",89,279,381,102,102,0
"C02EM",297,418,"1200x900",800,2,600,400,"True",754,507,493,-14,14,0
"C02EM",299,508,"1200x900",1000,1,600,400,"True",596,485,447,-38,38,0
"C02EM",300,631,"1200x900",1000,2,600,400,"False",699,479,321,-158,158,0
"C02EM",301,381,"1200x900",800,2,600,400,"True",705,408,368,-40,40,0
"C02EM",302,140,"1200x900",600,1,600,400,"True",700,523,484,-39,39,0
"C02EM",303,188,"1200x900",600,2,600,400,"False",900,195,401,206,206,0
"C02EM",304,600,"1200x900",1000,2,600,400,"False",765,207,417,210,210,0
"C02EM",305,332,"1200x900",800,1,600,400,"False",260,699,390,-309,309,0
"C02EM",306,456,"1200x900",1000,0,600,400,"True",91,257,238,-19,19,1
"C02EM",307,443,"1200x900",1000,0,600,400,"True",99,651,595,-56,56,1
"C02EM",309,627,"1200x900",1000,2,600,400,"True",760,510,434,-76,76,0
"C02EM",310,299,"1200x900",800,1,600,400,"False",779,274,515,241,241,0
"C02EM",311,497,"1200x900",1000,0,600,400,"False",106,696,625,-71,71,1
"C02EM",312,156,"1200x900",600,2,600,400,"False",913,197,581,384,384,0
"C02EM",313,161,"1200x900",600,2,600,400,"True",939,553,561,8,8,0
"C02EM",314,235,"1200x900",800,0,600,400,"True",146,646,636,-10,10,1
"C02EM",315,269,"1200x900",800,0,600,400,"True",160,295,312,17,17,1
"C02EM",316,343,"1200x900",800,1,600,400,"False",407,557,436,-121,121,0
"C02EM",318,466,"1200x900",1000,0,600,400,"True",82,205,185,-20,20,1
"C02EM",319,613,"1200x900",1000,2,600,400,"True",690,374,360,-14,14,0
"C02EM",320,99,"1200x900",600,1,600,400,"True",811,407,361,-46,46,0
"C02EM",321,378,"1200x900",800,2,600,400,"False",1018,708,322,-386,386,0
"C02EM",322,547,"1200x900",1000,1,600,400,"True",369,384,347,-37,37,1
"C02EM",323,536,"1200x900",1000,1,600,400,"False",580,213,286,73,73,0
"C02EM",324,174,"1200x900",600,2,600,400,"False",998,457,253,-204,204,0
"C02EM",325,91,"1200x900",600,1,600,400,"False",417,630,376,-254,254,1
"C02EM",326,82,"1200x900",600,1,600,400,"False",108,213,395,182,182,0
"C02EM",327,461,"1200x900",1000,0,600,400,"False",95,711,574,-137,137,1
"C02EM",328,217,"1200x900",800,0,600,400,"True",85,573,596,23,23,1
"C02EM",329,331,"1200x900",800,1,600,400,"False",240,620,242,-378,378,0
"C02EM",330,421,"1200x900",800,2,600,400,"True",898,394,443,49,49,0
"C02EM",331,455,"1200x900",1000,0,600,400,"False",107,718,637,-81,81,1
"C02EM",337,431,"1200x900",800,2,600,400,"True",694,382,362,-20,20,0
"C02EM",338,350,"1200x900",800,1,600,400,"True",182,566,545,-21,21,0
"C02EM",339,69,"1200x900",600,0,600,400,"True",322,268,259,-9,9,0
"C02EM",340,413,"1200x900",800,2,600,400,"True",849,506,458,-48,48,0
"C02EM",341,437,"1200x900",1000,0,600,400,"True",74,667,618,-49,49,1
"C02EM",342,87,"1200x900",600,1,600,400,"False",231,604,411,-193,193,0
"C02EM",343,141,"1200x900",600,1,600,400,"True",671,582,639,57,57,0
"C02EM",344,23,"1200x900",600,0,600,400,"True",308,463,470,7,7,1
"C02EM",345,385,"1200x900",800,2,600,400,"True",740,456,465,9,9,0
"C02EM",346,46,"1200x900",600,0,600,400,"True",193,355,387,32,32,1
"C02EM",347,514,"1200x900",1000,1,600,400,"False",539,690,435,-255,255,0
"C02EM",348,97,"1200x900",600,1,600,400,"True",760,643,578,-65,65,1
"C02EM",349,153,"1200x900",600,2,600,400,"True",1037,601,625,24,24,0
"C02EM",350,185,"1200x900",600,2,600,400,"False",907,212,505,293,293,0
"C02EM",351,424,"1200x900",800,2,600,400,"False",903,545,397,-148,148,0
"C02EM",352,500,"1200x900",1000,0,600,400,"False",105,700,585,-115,115,1
"C02EM",353,375,"1200x900",800,2,600,400,"True",716,384,413,29,29,0
"C02EM",354,250,"1200x900",800,0,600,400,"True",290,248,284,36,36,1
"C02EM",355,623,"1200x900",1000,2,600,400,"False",636,527,293,-234,234,0
"C02EM",356,510,"1200x900",1000,1,600,400,"False",486,338,93,-245,245,1
"C02EM",357,403,"1200x900",800,2,600,400,"False",625,704,477,-227,227,0
"C02EM",358,349,"1200x900",800,1,600,400,"False",402,665,460,-205,205,0
"C02EM",359,42,"1200x900",600,0,600,400,"True",233,479,501,22,22,0
"C02EM",361,54,"1200x900",600,0,600,400,"True",474,564,545,-19,19,1
"C02EM",362,354,"1200x900",800,1,600,400,"False",118,236,394,158,158,0
"C02EM",363,393,"1200x900",800,2,600,400,"False",657,620,252,-368,368,0
"C02EM",364,122,"1200x900",600,1,600,400,"False",817,709,472,-237,237,0
"C02EM",365,522,"1200x900",1000,1,600,400,"True",223,379,331,-48,48,0
"C02EM",366,45,"1200x900",600,0,600,400,"True",487,678,620,-58,58,1
"C02EM",367,567,"1200x900",1000,1,600,400,"True",655,297,360,63,63,1
"C02EM",368,489,"1200x900",1000,0,600,400,"True",88,604,547,-57,57,1
"C02EM",369,182,"1200x900",600,2,600,400,"True",933,389,390,1,1,0
"C02EM",370,154,"1200x900",600,2,600,400,"False",941,454,331,-123,123,0
"C02EM",371,96,"1200x900",600,1,600,400,"True",433,458,482,24,24,0
"C02EM",372,398,"1200x900",800,2,600,400,"False",944,698,523,-175,175,0
"C02EM",373,410,"1200x900",800,2,600,400,"False",916,477,399,-78,78,0
"C02EM",374,108,"1200x900",600,1,600,400,"False",830,239,389,150,150,0
"C02EM",375,524,"1200x900",1000,1,600,400,"True",534,470,487,17,17,0
"C02EM",377,129,"1200x900",600,1,600,400,"False",859,482,359,-123,123,1
"C02EM",378,57,"1200x900",600,0,600,400,"True",354,508,494,-14,14,1
"C02EM",379,229,"1200x900",800,0,600,400,"False",117,697,592,-105,105,1
"C02EM",380,509,"1200x900",1000,1,600,400,"True",509,434,472,38,38,0
"C02EM",381,79,"1200x900",600,1,600,400,"True",731,289,326,37,37,0
"C02EM",382,216,"1200x900",600,2,600,400,"True",1029,286,257,-29,29,0
"C02EM",383,601,"1200x900",1000,2,600,400,"False",735,697,428,-269,269,0
"C02EM",384,604,"1200x900",1000,2,600,400,"True",459,593,631,38,38,0
"C02EM",385,4,"1200x900",600,0,600,400,"True",602,200,241,41,41,1
"C02EM",386,22,"1200x900",600,0,600,400,"True",398,591,646,55,55,1
"C02EM",387,234,"1200x900",800,0,600,400,"True",72,344,334,-10,10,1
"C02EM",388,622,"1200x900",1000,2,600,400,"False",307,683,381,-302,302,0
"C02EM",389,41,"1200x900",600,0,600,400,"False",370,452,531,79,79,1
"C02EM",391,440,"1200x900",1000,0,600,400,"True",71,237,247,10,10,1
"C02EM",392,534,"1200x900",1000,1,600,400,"True",328,504,514,10,10,1
"C02EM",393,374,"1200x900",800,2,600,400,"True",755,450,376,-74,74,0
"C02EM",394,252,"1200x900",800,0,600,400,"True",224,673,666,-7,7,1
"C02EM",395,628,"1200x900",1000,2,600,400,"False",768,410,608,198,198,0
"C02EM",396,518,"1200x900",1000,1,600,400,"False",583,717,510,-207,207,0
"C02EM",397,180,"1200x900",600,2,600,400,"False",929,270,366,96,96,0
"C02EM",398,450,"1200x900",1000,0,600,400,"False",130,204,296,92,92,1
"C02EM",399,458,"1200x900",1000,0,600,400,"True",78,624,592,-32,32,1
"C02EM",400,619,"1200x900",1000,2,600,400,"False",803,247,410,163,163,0
"C02EM",401,17,"1200x900",600,0,600,400,"False",402,496,614,118,118,1
"C02EM",402,494,"1200x900",1000,0,600,400,"False",127,692,606,-86,86,1
"C02EM",403,641,"1200x900",1000,2,600,400,"False",897,272,626,354,354,0
"C02EM",404,436,"1200x900",1000,0,600,400,"True",82,617,672,55,55,1
"C02EM",405,15,"1200x900",600,0,600,400,"True",473,352,406,54,54,1
"C02EM",406,249,"1200x900",800,0,600,400,"True",126,306,318,12,12,1
"C02EM",407,598,"1200x900",1000,2,600,400,"False",706,559,480,-79,79,0
"C02EM",408,213,"1200x900",600,2,600,400,"False",822,275,394,119,119,0
"C02EM",409,366,"1200x900",800,2,600,400,"False",931,464,337,-127,127,0
"C02EM",410,493,"1200x900",1000,0,600,400,"True",80,582,594,12,12,1
"C02EM",411,473,"1200x900",1000,0,600,400,"True",75,323,297,-26,26,1
"C02EM",412,323,"1200x900",800,1,600,400,"False",388,348,476,128,128,0
"C02EM",413,132,"1200x900",600,1,600,400,"False",333,185,410,225,225,0
"C02EM",414,280,"1200x900",800,0,600,400,"True",104,302,345,43,43,1
"C02EM",415,498,"1200x900",1000,0,600,400,"True",100,260,278,18,18,1
"C02EM",416,273,"1200x900",800,0,600,400,"True",180,309,293,-16,16,1
"C02EM",417,38,"1200x900",600,0,600,400,"True",120,628,570,-58,58,1
"C02EM",418,115,"1200x900",600,1,600,400,"True",545,307,423,116,116,0
"C02EM",419,139,"1200x900",600,1,600,400,"False",192,695,534,-161,161,0
"C02EM",420,21,"1200x900",600,0,600,400,"True",314,383,424,41,41,1
"C02EM",421,70,"1200x900",600,0,600,400,"False",309,703,630,-73,73,1
"C02EM",422,278,"1200x900",800,0,600,400,"True",251,711,716,5,5,1
"C02EM",423,326,"1200x900",800,1,600,400,"False",103,482,650,168,168,0
"C02EM",424,646,"1200x900",1000,2,600,400,"False",829,227,465,238,238,1
"C02EM",425,468,"1200x900",1000,0,600,400,"False",121,219,293,74,74,1
"C02EM",426,291,"1200x900",800,1,600,400,"False",522,694,458,-236,236,0
"C02EM",427,643,"1200x900",1000,2,600,400,"True",740,325,359,34,34,0
"C02EM",428,408,"1200x900",800,2,600,400,"False",758,567,447,-120,120,0
"C02EM",429,47,"1200x900",600,0,600,400,"False",303,499,585,86,86,1
"C02EM",430,523,"1200x900",1000,1,600,400,"False",339,318,384,66,66,0
"C02EM",431,457,"1200x900",1000,0,600,400,"False",97,630,557,-73,73,1
"C02EM",432,227,"1200x900",800,0,600,400,"True",196,551,541,-10,10,1
"C02EM",433,488,"1200x900",1000,0,600,400,"False",129,687,597,-90,90,1
"C02EM",434,430,"1200x900",800,2,600,400,"False",922,254,460,206,206,0
"C02EM",435,145,"1200x900",600,2,600,400,"True",1004,630,547,-83,83,0
"C02EM",436,166,"1200x900",600,2,600,400,"False",896,274,505,231,231,0
"C02EM",437,238,"1200x900",800,0,600,400,"True",162,283,264,-19,19,1
"C02EM",438,384,"1200x900",800,2,600,400,"False",821,707,547,-160,160,0
"C02EM",439,396,"1200x900",800,2,600,400,"True",678,663,622,-41,41,0
"C02EM",440,603,"1200x900",1000,2,600,400,"False",693,280,457,177,177,0
"C02EM",441,12,"1200x900",600,0,600,400,"True",365,336,325,-11,11,1
"C02EM",442,483,"1200x900",1000,0,600,400,"False",93,191,255,64,64,1
"C02EM",443,463,"1200x900",1000,0,600,400,"False",115,693,596,-97,97,1
"C02EM",444,415,"1200x900",800,2,600,400,"True",823,684,679,-5,5,0
"C02EM",445,303,"1200x900",800,1,600,400,"True",241,431,477,46,46,0
"C02EM",446,263,"1200x900",800,0,600,400,"True",82,396,358,-38,38,1
"C02EM",447,445,"1200x900",1000,0,600,400,"False",78,302,418,116,116,1
"C02EM",448,626,"1200x900",1000,2,600,400,"False",329,449,357,-92,92,0
"C02EM",449,209,"1200x900",600,2,600,400,"False",937,637,492,-145,145,0
"C02EM",450,589,"1200x900",1000,2,600,400,"False",856,418,642,224,224,0
"C02EM",451,470,"1200x900",1000,0,600,400,"True",91,666,713,47,47,1
"C02EM",452,592,"1200x900",1000,2,600,400,"False",492,392,596,204,204,0
"C02EM",453,575,"1200x900",1000,1,600,400,"False",272,693,329,-364,364,0
"C02EM",454,152,"1200x900",600,2,600,400,"False",971,399,572,173,173,0
"C02EM",455,597,"1200x900",1000,2,600,400,"False",352,239,522,283,283,0
"C02EM",456,552,"1200x900",1000,1,600,400,"False",255,412,498,86,86,0
"C02EM",457,165,"1200x900",600,2,600,400,"True",912,554,591,37,37,0
"C02EM",458,411,"1200x900",800,2,600,400,"False",805,361,525,164,164,0
"C02EM",459,312,"1200x900",800,1,600,400,"False",238,683,570,-113,113,0
"C02EM",460,282,"1200x900",800,0,600,400,"True",109,246,215,-31,31,1
"C02EM",461,402,"1200x900",800,2,600,400,"False",878,234,541,307,307,0
"C02EM",462,357,"1200x900",800,1,600,400,"False",109,594,492,-102,102,0
"C02EM",463,490,"1200x900",1000,0,600,400,"False",114,183,310,127,127,1
"C02EM",464,625,"1200x900",1000,2,600,400,"False",279,228,755,527,527,0
"C02EM",465,621,"1200x900",1000,2,600,400,"False",540,478,642,164,164,0
"C02EM",466,322,"1200x900",800,1,600,400,"False",703,206,517,311,311,1
"C02EM",467,595,"1200x900",1000,2,600,400,"False",687,640,306,-334,334,0
"C02EM",468,35,"1200x900",600,0,600,400,"True",366,555,523,-32,32,1
"C02EM",469,642,"1200x900",1000,2,600,400,"False",776,316,527,211,211,0
"C02EM",470,423,"1200x900",800,2,600,400,"False",1051,710,529,-181,181,1
"C02EM",471,93,"1200x900",600,1,600,400,"True",139,540,537,-3,3,0
"C02EM",472,262,"1200x900",800,0,600,400,"True",196,481,418,-63,63,1
"C02EM",473,195,"1200x900",600,2,600,400,"False",942,249,458,209,209,0
"C02EM",474,241,"1200x900",800,0,600,400,"True",129,227,244,17,17,1
"C02EM",475,56,"1200x900",600,0,600,400,"False",148,491,390,-101,101,0
"C02EM",476,504,"1200x900",1000,0,600,400,"True",107,699,666,-33,33,1
"C02EM",477,289,"1200x900",800,1,600,400,"True",421,703,723,20,20,1
"C02EM",478,210,"1200x900",600,2,600,400,"False",835,506,737,231,231,0
"C02EM",479,205,"1200x900",600,2,600,400,"True",1021,504,543,39,39,0
"C02EM",480,202,"1200x900",600,2,600,400,"False",966,460,568,108,108,0
"C02EM",481,128,"1200x900",600,1,600,400,"False",661,258,455,197,197,1
"C02EM",482,233,"1200x900",800,0,600,400,"True",164,700,668,-32,32,1
"C02EM",483,386,"1200x900",800,2,600,400,"True",774,301,381,80,80,0
"C02EM",484,520,"1200x900",1000,1,600,400,"True",564,260,279,19,19,0
"C02EM",485,647,"1200x900",1000,2,600,400,"True",560,637,691,54,54,0
"C02EM",486,307,"1200x900",800,1,600,400,"False",716,247,396,149,149,0
"C02EM",487,590,"1200x900",1000,2,600,400,"False",636,278,382,104,104,0
"C02EM",488,271,"1200x900",800,0,600,400,"True",74,360,413,53,53,1
"C02EM",489,409,"1200x900",800,2,600,400,"False",501,659,551,-108,108,0
"C02EM",491,562,"1200x900",1000,1,600,400,"True",347,540,478,-62,62,0
"C02EM",492,344,"1200x900",800,1,600,400,"True",589,408,437,29,29,0
"C02EM",493,364,"1200x900",800,2,600,400,"False",1018,204,531,327,327,0
"C02EM",494,59,"1200x900",600,0,600,400,"True",391,692,636,-56,56,1
"C02EM",495,288,"1200x900",800,0,600,400,"True",180,547,585,38,38,1
"C02EM",496,480,"1200x900",1000,0,600,400,"False",100,231,402,171,171,1
"C02EM",497,18,"1200x900",600,0,600,400,"True",400,318,344,26,26,1
"C02EM",498,328,"1200x900",800,1,600,400,"False",104,649,560,-89,89,0
"C02EM",499,530,"1200x900",1000,1,600,400,"False",584,405,276,-129,129,1
"C02EM",500,329,"1200x900",800,1,600,400,"True",517,239,250,11,11,0
"C02EM",501,321,"1200x900",800,1,600,400,"True",601,190,163,-27,27,0
"C02EM",502,571,"1200x900",1000,1,600,400,"False",239,522,672,150,150,1
"C02EM",503,506,"1200x900",1000,1,600,400,"False",559,567,383,-184,184,1
"C02EM",504,593,"1200x900",1000,2,600,400,"False",246,719,570,-149,149,0
"C02EM",505,444,"1200x900",1000,0,600,400,"False",101,714,647,-67,67,1
"C02EM",506,283,"1200x900",800,0,600,400,"True",90,264,212,-52,52,1
"C02EM",507,459,"1200x900",1000,0,600,400,"False",70,645,536,-109,109,1
"C02EM",508,215,"1200x900",600,2,600,400,"True",939,596,656,60,60,0
"C02EM",509,472,"1200x900",1000,0,600,400,"True",77,685,687,2,2,1
"C02EM",510,377,"1200x900",800,2,600,400,"True",683,388,360,-28,28,0
"C02EM",511,392,"1200x900",800,2,600,400,"True",1031,618,622,4,4,0
"C02EM",512,231,"1200x900",800,0,600,400,"True",251,718,698,-20,20,1
"C02EM",513,211,"1200x900",600,2,600,400,"True",986,407,507,100,100,0
"C02EM",514,416,"1200x900",800,2,600,400,"False",748,617,353,-264,264,0
"C02EM",515,615,"1200x900",1000,2,600,400,"True",736,634,628,-6,6,0
"C02EM",516,583,"1200x900",1000,2,600,400,"True",949,284,315,31,31,1
"C02EM",517,531,"1200x900",1000,1,600,400,"False",233,362,554,192,192,0
"C02EM",518,390,"1200x900",800,2,600,400,"False",982,674,431,-243,243,1
"C02EM",519,277,"1200x900",800,0,600,400,"False",140,310,165,-145,145,1
"C02EM",520,130,"1200x900",600,1,600,400,"False",741,428,291,-137,137,0
"C02EM",521,394,"1200x900",800,2,600,400,"True",847,292,313,21,21,0
"C02EM",523,406,"1200x900",800,2,600,400,"False",971,233,449,216,216,0
"C02EM",524,352,"1200x900",800,1,600,400,"False",235,717,299,-418,418,0
"C02EM",525,255,"1200x900",800,0,600,400,"True",93,709,686,-23,23,1
"C02EM",526,2,"1200x900",600,0,600,400,"True",159,323,253,-70,70,0
"C02EM",527,502,"1200x900",1000,0,600,400,"False",111,639,504,-135,135,1
"C02EM",528,225,"1200x900",800,0,600,400,"True",178,423,457,34,34,1
"C02EM",529,379,"1200x900",800,2,600,400,"False",994,325,591,266,266,0
"C02EM",530,131,"1200x900",600,1,600,400,"False",531,367,579,212,212,0
"C02EM",531,339,"1200x900",800,1,600,400,"True",273,545,498,-47,47,1
"C02EM",532,587,"1200x900",1000,2,600,400,"False",741,686,354,-332,332,0
"C02EM",533,298,"1200x900",800,1,600,400,"True",311,457,434,-23,23,0
"C02EM",534,232,"1200x900",800,0,600,400,"True",84,511,502,-9,9,1
"C02EM",535,360,"1200x900",800,1,600,400,"True",203,608,588,-20,20,0
"C02EM",536,243,"1200x900",800,0,600,400,"True",114,332,352,20,20,1
"C02EM",537,32,"1200x900",600,0,600,400,"True",152,563,552,-11,11,1
"C02EM",538,64,"1200x900",600,0,600,400,"True",102,339,334,-5,5,0
"C02EM",539,114,"1200x900",600,1,600,400,"False",183,697,530,-167,167,0
"C02EM",540,181,"1200x900",600,2,600,400,"False",1018,223,343,120,120,0
"C02EM",541,71,"1200x900",600,0,600,400,"True",219,248,220,-28,28,0
"C02EM",542,527,"1200x900",1000,1,600,400,"False",565,601,300,-301,301,0
"C02EM",543,24,"1200x900",600,0,600,400,"True",430,538,516,-22,22,1
"C02EM",544,276,"1200x900",800,0,600,400,"False",281,217,299,82,82,1
"C02EM",545,526,"1200x900",1000,1,600,400,"False",497,710,467,-243,243,0
"C02EM",546,260,"1200x900",800,0,600,400,"False",103,525,628,103,103,1
"C02EM",547,120,"1200x900",600,1,600,400,"False",690,655,537,-118,118,0
"C02EM",548,584,"1200x900",1000,2,600,400,"True",731,413,359,-54,54,0
"C02EM",549,370,"1200x900",800,2,600,400,"False",874,336,254,-82,82,0
"C02EM",550,467,"1200x900",1000,0,600,400,"False",74,712,621,-91,91,1
"C02EM",551,550,"1200x900",1000,1,600,400,"False",301,459,639,180,180,0
"C02EM",552,248,"1200x900",800,0,600,400,"True",94,240,274,34,34,1
"C02EM",553,632,"1200x900",1000,2,600,400,"False",984,227,563,336,336,0
"C02EM",554,43,"1200x900",600,0,600,400,"True",277,446,436,-10,10,1
"C02EM",555,83,"1200x900",600,1,600,400,"True",763,568,580,12,12,1
"C02EM",556,186,"1200x900",600,2,600,400,"False",997,197,440,243,243,0
"C02EM",557,311,"1200x900",800,1,600,400,"False",710,261,688,427,427,0
"C02EM",558,558,"1200x900",1000,1,600,400,"False",72,464,247,-217,217,1
"C02EM",559,481,"1200x900",1000,0,600,400,"True",80,185,202,17,17,1
"C02EM",560,290,"1200x900",800,1,600,400,"False",789,603,374,-229,229,0
"C02EM",561,588,"1200x900",1000,2,600,400,"False",585,350,259,-91,91,0
"C02EM",562,576,"1200x900",1000,1,600,400,"False",376,713,591,-122,122,0
"C02EM",563,316,"1200x900",800,1,600,400,"True",362,319,341,22,22,0
"C02EM",564,168,"1200x900",600,2,600,400,"True",1001,439,480,41,41,0
"C02EM",565,491,"1200x900",1000,0,600,400,"False",108,198,297,99,99,1
"C02EM",566,142,"1200x900",600,1,600,400,"True",286,474,520,46,46,0
"C02EM",567,112,"1200x900",600,1,600,400,"False",681,490,369,-121,121,0
"C02EM",568,637,"1200x900",1000,2,600,400,"True",750,460,482,22,22,0
"C02EM",569,383,"1200x900",800,2,600,400,"False",855,407,578,171,171,0
"C02EM",570,358,"1200x900",800,1,600,400,"False",263,635,323,-312,312,0
"C02EM",571,125,"1200x900",600,1,600,400,"True",750,531,489,-42,42,0
"C02EM",572,212,"1200x900",600,2,600,400,"False",841,206,349,143,143,0
"C02EM",573,214,"1200x900",600,2,600,400,"False",1046,305,237,-68,68,0
"C02EM",574,193,"1200x900",600,2,600,400,"True",874,588,612,24,24,0
"C02EM",575,14,"1200x900",600,0,600,400,"False",399,224,296,72,72,1
"C02EM",576,89,"1200x900",600,1,600,400,"False",917,366,563,197,197,1
"C02EM",577,582,"1200x900",1000,2,600,400,"True",554,347,408,61,61,0
"C02EM",578,177,"1200x900",600,2,600,400,"True",912,236,310,74,74,0
"C02EM",579,570,"1200x900",1000,1,600,400,"False",315,352,457,105,105,0
"C02EM",580,274,"1200x900",800,0,600,400,"True",146,497,505,8,8,1
"C02EM",582,239,"1200x900",800,0,600,400,"False",114,231,369,138,138,1
"C02EM",583,203,"1200x900",600,2,600,400,"True",938,603,594,-9,9,0
"C02EM",584,633,"1200x900",1000,2,600,400,"False",564,253,488,235,235,0
"C02EM",585,476,"1200x900",1000,0,600,400,"False",76,359,564,205,205,1
"C02EM",586,124,"1200x900",600,1,600,400,"False",345,467,409,-58,58,0
"C02EM",587,106,"1200x900",600,1,600,400,"False",803,659,596,-63,63,1
"C02EM",588,292,"1200x900",800,1,600,400,"True",88,565,514,-51,51,0
"C02EM",589,265,"1200x900",800,0,600,400,"True",229,353,399,46,46,1
"C02EM",590,566,"1200x900",1000,1,600,400,"False",378,472,295,-177,177,1
"C02EM",591,465,"1200x900",1000,0,600,400,"True",85,203,251,48,48,1
"C02EM",592,609,"1200x900",1000,2,600,400,"False",697,627,478,-149,149,0
"C02EM",593,391,"1200x900",800,2,600,400,"False",895,521,416,-105,105,0
"C02EM",594,337,"1200x900",800,1,600,400,"False",299,622,510,-112,112,0
"C02EM",595,361,"1200x900",800,2,600,400,"True",931,328,375,47,47,0
"C02EM",596,294,"1200x900",800,1,600,400,"False",262,287,578,291,291,0
"C02EM",597,127,"1200x900",600,1,600,400,"True",309,691,618,-73,73,0
"C02EM",598,555,"1200x900",1000,1,600,400,"True",444,556,551,-5,5,0
"C02EM",599,258,"1200x900",800,0,600,400,"False",126,664,470,-194,194,1
"C02EM",600,342,"1200x900",800,1,600,400,"False",677,204,290,86,86,0
"C02EM",601,577,"1200x900",1000,2,600,400,"False",455,420,226,-194,194,0
"C02EM",602,10,"1200x900",600,0,600,400,"True",400,499,464,-35,35,1
"C02EM",603,103,"1200x900",600,1,600,400,"True",528,320,392,72,72,1
"C02EM",604,441,"1200x900",1000,0,600,400,"True",85,684,677,-7,7,1
"C02EM",605,118,"1200x900",600,1,600,400,"False",190,588,330,-258,258,0
"C02EM",606,310,"1200x900",800,1,600,400,"False",559,592,506,-86,86,0
"C02EM",607,169,"1200x900",600,2,600,400,"True",924,290,352,62,62,0
"C02EM",608,200,"1200x900",600,2,600,400,"True",897,302,254,-48,48,0
"C02EM",609,199,"1200x900",600,2,600,400,"True",992,467,421,-46,46,0
"C02EM",610,194,"1200x900",600,2,600,400,"False",896,236,435,199,199,0
"C02EM",611,559,"1200x900",1000,1,600,400,"False",641,244,360,116,116,0
"C02EM",612,602,"1200x900",1000,2,600,400,"False",865,452,264,-188,188,0
"C02EM",613,389,"1200x900",800,2,600,400,"False",843,530,410,-120,120,0
"C02EM",614,529,"1200x900",1000,1,600,400,"False",267,412,245,-167,167,1
"C02EM",615,256,"1200x900",800,0,600,400,"True",192,656,610,-46,46,1
"C02EM",616,608,"1200x900",1000,2,600,400,"False",742,250,392,142,142,0
"C02EM",617,37,"1200x900",600,0,600,400,"False",258,403,601,198,198,1
"C02EM",618,539,"1200x900",1000,1,600,400,"False",510,383,499,116,116,0
"C02EM",619,557,"1200x900",1000,1,600,400,"True",677,505,508,3,3,1
"C02EM",620,320,"1200x900",800,1,600,400,"False",644,376,573,197,197,0
"C02EM",621,484,"1200x900",1000,0,600,400,"True",100,223,216,-7,7,1
"C02EM",622,300,"1200x900",800,1,600,400,"True",620,693,727,34,34,0
"C02EM",623,340,"1200x900",800,1,600,400,"False",226,240,338,98,98,0
"C02EM",624,107,"1200x900",600,1,600,400,"False",878,678,556,-122,122,0
"C02EM",625,244,"1200x900",800,0,600,400,"True",194,203,199,-4,4,1
"C02EM",626,452,"1200x900",1000,0,600,400,"True",97,273,331,58,58,1
"C02EM",627,519,"1200x900",1000,1,600,400,"True",319,565,530,-35,35,1
"C02EM",628,355,"1200x900",800,1,600,400,"False",77,386,603,217,217,0
"C02EM",629,306,"1200x900",800,1,600,400,"True",164,524,415,-109,109,0
"C02EM",630,172,"1200x900",600,2,600,400,"False",912,444,623,179,179,0
"C02EM",631,553,"1200x900",1000,1,600,400,"False",116,712,318,-394,394,0
"C02EM",632,187,"1200x900",600,2,600,400,"True",857,639,657,18,18,0
"C02EM",633,167,"1200x900",600,2,600,400,"False",956,241,366,125,125,0
"C02EM",634,309,"1200x900",800,1,600,400,"False",186,225,572,347,347,0
"C02EM",635,5,"1200x900",600,0,600,400,"True",228,587,582,-5,5,0
"C02EM",636,469,"1200x900",1000,0,600,400,"True",73,227,271,44,44,1
"C02EM",637,267,"1200x900",800,0,600,400,"True",145,665,666,1,1,1
"C02EM",638,158,"1200x900",600,2,600,400,"False",939,300,416,116,116,0
"C02EM",639,503,"1200x900",1000,0,600,400,"True",86,279,255,-24,24,1
"C02EM",640,147,"1200x900",600,2,600,400,"True",942,418,476,58,58,0
"C02EM",641,362,"1200x900",800,2,600,400,"False",819,338,521,183,183,0
"C02EM",642,53,"1200x900",600,0,600,400,"True",177,189,236,47,47,0
"C02EM",643,586,"1200x900",1000,2,600,400,"False",802,262,356,94,94,0
"C02EM",644,574,"1200x900",1000,1,600,400,"True",614,194,220,26,26,0
"C02EM",645,149,"1200x900",600,2,600,400,"True",890,289,348,59,59,0
"C02EM",646,454,"1200x900",1000,0,600,400,"False",78,687,615,-72,72,1
"C02EM",647,429,"1200x900",800,2,600,400,"True",682,692,630,-62,62,0
"C02EM",648,279,"1200x900",800,0,600,400,"True",252,202,200,-2,2,1
"C03PY",1,103,"1200x900",600,1,600,400,"False",528,320,229,-91,91,1
"C03PY",2,295,"1200x900",800,1,600,400,"False",471,334,50,-284,284,0
"C03PY",3,173,"1200x900",600,2,600,400,"True",948,693,643,-50,50,0
"C03PY",4,293,"1200x900",800,1,600,400,"True",561,396,449,53,53,0
"C03PY",5,222,"1200x900",800,0,600,400,"True",152,206,175,-31,31,1
"C03PY",6,397,"1200x900",800,2,600,400,"True",817,692,692,0,0,0
"C03PY",7,382,"1200x900",800,2,600,400,"False",870,523,401,-122,122,0
"C03PY",8,33,"1200x900",600,0,600,400,"True",198,533,519,-14,14,1
"C03PY",9,12,"1200x900",600,0,600,400,"True",365,336,351,15,15,1
"C03PY",10,449,"1200x900",1000,0,600,400,"False",105,683,487,-196,196,1
"C03PY",11,28,"1200x900",600,0,600,400,"True",336,410,420,10,10,1
"C03PY",12,14,"1200x900",600,0,600,400,"True",399,224,240,16,16,1
"C03PY",13,407,"1200x900",800,2,600,400,"False",989,340,170,-170,170,0
"C03PY",14,152,"1200x900",600,2,600,400,"False",971,399,128,-271,271,0
"C03PY",15,62,"1200x900",600,0,600,400,"True",345,346,335,-11,11,1
"C03PY",16,40,"1200x900",600,0,600,400,"True",143,513,569,56,56,0
"C03PY",17,554,"1200x900",1000,1,600,400,"False",79,309,114,-195,195,1
"C03PY",18,564,"1200x900",1000,1,600,400,"True",215,264,288,24,24,0
"C03PY",19,527,"1200x900",1000,1,600,400,"True",565,601,605,4,4,0
"C03PY",22,502,"1200x900",1000,0,600,400,"False",111,639,486,-153,153,1
"C03PY",25,514,"1200x900",1000,1,600,400,"True",539,690,650,-40,40,0
"C03PY",26,149,"1200x900",600,2,600,400,"False",890,289,388,99,99,0
"C03PY",27,78,"1200x900",600,1,600,400,"False",885,684,361,-323,323,0
"C03PY",28,572,"1200x900",1000,1,600,400,"False",302,260,482,222,222,0
"C03PY",29,102,"1200x900",600,1,600,400,"True",861,603,574,-29,29,0
"C03PY",30,229,"1200x900",800,0,600,400,"False",117,697,584,-113,113,1
"C03PY",31,163,"1200x900",600,2,600,400,"True",1046,665,606,-59,59,0
"C03PY",32,281,"1200x900",800,0,600,400,"True",112,611,573,-38,38,1
"C03PY",33,359,"1200x900",800,1,600,400,"False",653,241,409,168,168,0
"C03PY",34,260,"1200x900",800,0,600,400,"True",103,525,493,-32,32,1
"C03PY",35,259,"1200x900",800,0,600,400,"False",156,180,336,156,156,1
"C03PY",36,197,"1200x900",600,2,600,400,"True",903,212,261,49,49,0
"C03PY",37,486,"1200x900",1000,0,600,400,"False",102,676,543,-133,133,1
"C03PY",38,490,"1200x900",1000,0,600,400,"False",114,183,329,146,146,1
"C03PY",39,231,"1200x900",800,0,600,400,"False",251,718,594,-124,124,1
"C03PY",40,459,"1200x900",1000,0,600,400,"True",70,645,692,47,47,1
"C03PY",41,95,"1200x900",600,1,600,400,"True",749,425,463,38,38,1
"C03PY",42,184,"1200x900",600,2,600,400,"False",1067,441,803,362,362,0
"C03PY",43,247,"1200x900",800,0,600,400,"False",160,424,508,84,84,1
"C03PY",44,81,"1200x900",600,1,600,400,"False",696,225,326,101,101,0
"C03PY",45,638,"1200x900",1000,2,600,400,"False",385,198,313,115,115,0
"C03PY",46,50,"1200x900",600,0,600,400,"False",75,582,466,-116,116,0
"C03PY",47,353,"1200x900",800,1,600,400,"False",90,476,672,196,196,0
"C03PY",48,246,"1200x900",800,0,600,400,"False",196,418,522,104,104,1
"C03PY",50,141,"1200x900",600,1,600,400,"False",671,582,455,-127,127,0
"C03PY",51,201,"1200x900",600,2,600,400,"True",1005,462,423,-39,39,0
"C03PY",52,212,"1200x900",600,2,600,400,"False",841,206,384,178,178,0
"C03PY",53,211,"1200x900",600,2,600,400,"False",986,407,611,204,204,0
"C03PY",54,612,"1200x900",1000,2,600,400,"True",706,198,282,84,84,0
"C03PY",55,351,"1200x900",800,1,600,400,"False",122,581,452,-129,129,0
"C03PY",56,73,"1200x900",600,1,600,400,"False",94,665,463,-202,202,0
"C03PY",57,405,"1200x900",800,2,600,400,"False",790,307,445,138,138,0
"C03PY",58,268,"1200x900",800,0,600,400,"True",148,400,339,-61,61,1
"C03PY",59,415,"1200x900",800,2,600,400,"False",823,684,518,-166,166,0
"C03PY",60,307,"1200x900",800,1,600,400,"False",716,247,351,104,104,0
"C03PY",61,391,"1200x900",800,2,600,400,"False",895,521,305,-216,216,0
"C03PY",62,193,"1200x900",600,2,600,400,"True",874,588,583,-5,5,0
"C03PY",63,9,"1200x900",600,0,600,400,"False",509,654,565,-89,89,1
"C03PY",64,590,"1200x900",1000,2,600,400,"False",636,278,564,286,286,0
"C03PY",65,578,"1200x900",1000,2,600,400,"False",966,276,486,210,210,0
"C03PY",66,238,"1200x900",800,0,600,400,"False",162,283,378,95,95,1
"C03PY",67,61,"1200x900",600,0,600,400,"False",272,670,609,-61,61,1
"C03PY",68,625,"1200x900",1000,2,600,400,"True",279,228,257,29,29,0
"C03PY",69,204,"1200x900",600,2,600,400,"False",1053,432,271,-161,161,0
"C03PY",70,498,"1200x900",1000,0,600,400,"True",100,260,252,-8,8,1
"C03PY",71,406,"1200x900",800,2,600,400,"False",971,233,432,199,199,0
"C03PY",72,195,"1200x900",600,2,600,400,"False",942,249,348,99,99,0
"C03PY",73,430,"1200x900",800,2,600,400,"True",922,254,307,53,53,0
"C03PY",74,205,"1200x900",600,2,600,400,"True",1021,504,539,35,35,0
"C03PY",75,531,"1200x900",1000,1,600,400,"False",233,362,442,80,80,0
"C03PY",76,239,"1200x900",800,0,600,400,"False",114,231,411,180,180,1
"C03PY",77,644,"1200x900",1000,2,600,400,"False",495,486,352,-134,134,0
"C03PY",78,317,"1200x900",800,1,600,400,"True",185,564,442,-122,122,0
"C03PY",79,162,"1200x900",600,2,600,400,"True",849,279,260,-19,19,0
"C03PY",80,458,"1200x900",1000,0,600,400,"False",78,624,545,-79,79,1
"C03PY",81,634,"1200x900",1000,2,600,400,"False",735,313,468,155,155,0
"C03PY",83,356,"1200x900",800,1,600,400,"True",123,484,444,-40,40,0
"C03PY",84,532,"1200x900",1000,1,600,400,"False",215,207,400,193,193,0
"C03PY",85,75,"1200x900",600,1,600,400,"True",635,558,506,-52,52,0
"C03PY",86,602,"1200x900",1000,2,600,400,"True",865,452,418,-34,34,0
"C03PY",88,22,"1200x900",600,0,600,400,"False",398,591,522,-69,69,1
"C03PY",89,461,"1200x900",1000,0,600,400,"False",95,711,562,-149,149,1
"C03PY",90,287,"1200x900",800,0,600,400,"False",120,567,502,-65,65,1
"C03PY",91,57,"1200x900",600,0,600,400,"True",354,508,532,24,24,1
"C03PY",92,427,"1200x900",800,2,600,400,"True",812,380,423,43,43,0
"C03PY",95,639,"1200x900",1000,2,600,400,"True",504,456,385,-71,71,0
"C03PY",96,374,"1200x900",800,2,600,400,"True",755,450,419,-31,31,0
"C03PY",97,11,"1200x900",600,0,600,400,"False",372,670,583,-87,87,1
"C03PY",98,43,"1200x900",600,0,600,400,"False",277,446,545,99,99,1
"C03PY",99,496,"1200x900",1000,0,600,400,"False",70,639,543,-96,96,1
"C03PY",100,529,"1200x900",1000,1,600,400,"False",267,412,634,222,222,1
"C03PY",101,478,"1200x900",1000,0,600,400,"False",79,672,573,-99,99,1
"C03PY",103,182,"1200x900",600,2,600,400,"False",933,389,569,180,180,0
"C03PY",104,635,"1200x900",1000,2,600,400,"False",833,402,515,113,113,0
"C03PY",105,136,"1200x900",600,1,600,400,"False",264,205,456,251,251,0
"C03PY",106,77,"1200x900",600,1,600,400,"True",780,525,557,32,32,0
"C03PY",107,330,"1200x900",800,1,600,400,"False",759,301,197,-104,104,1
"C03PY",108,190,"1200x900",600,2,600,400,"True",977,238,318,80,80,0
"C03PY",109,557,"1200x900",1000,1,600,400,"False",677,505,381,-124,124,1
"C03PY",110,298,"1200x900",800,1,600,400,"True",311,457,419,-38,38,0
"C03PY",111,258,"1200x900",800,0,600,400,"True",126,664,655,-9,9,1
"C03PY",112,142,"1200x900",600,1,600,400,"True",286,474,399,-75,75,0
"C03PY",113,442,"1200x900",1000,0,600,400,"True",87,183,221,38,38,1
"C03PY",114,234,"1200x900",800,0,600,400,"False",72,344,263,-81,81,1
"C03PY",116,489,"1200x900",1000,0,600,400,"True",88,604,580,-24,24,1
"C03PY",117,15,"1200x900",600,0,600,400,"True",473,352,378,26,26,1
"C03PY",118,545,"1200x900",1000,1,600,400,"True",358,562,572,10,10,0
"C03PY",119,414,"1200x900",800,2,600,400,"True",831,592,595,3,3,0
"C03PY",120,124,"1200x900",600,1,600,400,"True",345,467,512,45,45,0
"C03PY",121,278,"1200x900",800,0,600,400,"True",251,711,709,-2,2,1
"C03PY",122,271,"1200x900",800,0,600,400,"True",74,360,322,-38,38,1
"C03PY",123,345,"1200x900",800,1,600,400,"True",841,566,590,24,24,1
"C03PY",124,285,"1200x900",800,0,600,400,"False",237,396,486,90,90,1
"C03PY",125,533,"1200x900",1000,1,600,400,"False",355,483,587,104,104,0
"C03PY",126,355,"1200x900",800,1,600,400,"True",77,386,431,45,45,0
"C03PY",127,277,"1200x900",800,0,600,400,"True",140,310,243,-67,67,1
"C03PY",128,177,"1200x900",600,2,600,400,"False",912,236,168,-68,68,0
"C03PY",129,492,"1200x900",1000,0,600,400,"False",76,692,489,-203,203,1
"C03PY",130,92,"1200x900",600,1,600,400,"False",624,605,392,-213,213,0
"C03PY",131,309,"1200x900",800,1,600,400,"False",186,225,363,138,138,0
"C03PY",132,308,"1200x900",800,1,600,400,"True",437,425,333,-92,92,0
"C03PY",133,251,"1200x900",800,0,600,400,"True",88,352,364,12,12,1
"C03PY",134,241,"1200x900",800,0,600,400,"True",129,227,275,48,48,1
"C03PY",135,134,"1200x900",600,1,600,400,"False",300,188,134,-54,54,0
"C03PY",136,109,"1200x900",600,1,600,400,"True",691,589,640,51,51,0
"C03PY",137,189,"1200x900",600,2,600,400,"True",881,397,408,11,11,0
"C03PY",138,310,"1200x900",800,1,600,400,"True",559,592,540,-52,52,0
"C03PY",139,376,"1200x900",800,2,600,400,"False",788,275,181,-94,94,0
"C03PY",140,439,"1200x900",1000,0,600,400,"True",110,229,219,-10,10,1
"C03PY",141,562,"1200x900",1000,1,600,400,"True",347,540,540,0,0,0
"C03PY",142,629,"1200x900",1000,2,600,400,"False",681,257,448,191,191,0
"C03PY",143,549,"1200x900",1000,1,600,400,"True",657,366,389,23,23,0
"C03PY",144,419,"1200x900",800,2,600,400,"True",769,351,353,2,2,0
"C03PY",145,577,"1200x900",1000,2,600,400,"False",455,420,514,94,94,0
"C03PY",146,223,"1200x900",800,0,600,400,"True",179,191,162,-29,29,1
"C03PY",147,574,"1200x900",1000,1,600,400,"False",614,194,434,240,240,0
"C03PY",148,216,"1200x900",600,2,600,400,"True",1029,286,305,19,19,0
"C03PY",149,463,"1200x900",1000,0,600,400,"False",115,693,568,-125,125,1
"C03PY",150,186,"1200x900",600,2,600,400,"False",997,197,381,184,184,0
"C03PY",151,227,"1200x900",800,0,600,400,"True",196,551,501,-50,50,1
"C03PY",152,32,"1200x900",600,0,600,400,"False",152,563,468,-95,95,1
"C03PY",153,119,"1200x900",600,1,600,400,"True",168,563,551,-12,12,0
"C03PY",154,468,"1200x900",1000,0,600,400,"True",121,219,277,58,58,1
"C03PY",155,175,"1200x900",600,2,600,400,"False",1028,432,300,-132,132,0
"C03PY",156,583,"1200x900",1000,2,600,400,"True",949,284,291,7,7,1
"C03PY",157,158,"1200x900",600,2,600,400,"True",939,300,296,-4,4,0
"C03PY",158,488,"1200x900",1000,0,600,400,"False",129,687,567,-120,120,1
"C03PY",159,605,"1200x900",1000,2,600,400,"False",493,665,544,-121,121,0
"C03PY",160,632,"1200x900",1000,2,600,400,"False",984,227,655,428,428,0
"C03PY",162,647,"1200x900",1000,2,600,400,"True",560,637,623,-14,14,0
"C03PY",163,544,"1200x900",1000,1,600,400,"False",602,620,470,-150,150,0
"C03PY",164,567,"1200x900",1000,1,600,400,"True",655,297,266,-31,31,1
"C03PY",165,570,"1200x900",1000,1,600,400,"True",315,352,297,-55,55,0
"C03PY",166,143,"1200x900",600,1,600,400,"False",479,284,381,97,97,1
"C03PY",167,289,"1200x900",800,1,600,400,"False",421,703,554,-149,149,1
"C03PY",168,68,"1200x900",600,0,600,400,"True",165,367,329,-38,38,0
"C03PY",169,540,"1200x900",1000,1,600,400,"False",389,568,739,171,171,1
"C03PY",170,464,"1200x900",1000,0,600,400,"False",82,222,452,230,230,1
"C03PY",171,48,"1200x900",600,0,600,400,"True",323,645,620,-25,25,1
"C03PY",172,378,"1200x900",800,2,600,400,"False",1018,708,461,-247,247,0
"C03PY",173,568,"1200x900",1000,1,600,400,"False",286,475,624,149,149,1
"C03PY",174,335,"1200x900",800,1,600,400,"False",124,360,540,180,180,0
"C03PY",175,185,"1200x900",600,2,600,400,"False",907,212,441,229,229,0
"C03PY",176,217,"1200x900",800,0,600,400,"False",85,573,430,-143,143,1
"C03PY",177,340,"1200x900",800,1,600,400,"False",226,240,387,147,147,0
"C03PY",178,404,"1200x900",800,2,600,400,"False",842,396,236,-160,160,0
"C03PY",179,209,"1200x900",600,2,600,400,"True",937,637,565,-72,72,0
"C03PY",180,110,"1200x900",600,1,600,400,"True",776,550,560,10,10,1
"C03PY",182,621,"1200x900",1000,2,600,400,"True",540,478,418,-60,60,0
"C03PY",183,499,"1200x900",1000,0,600,400,"False",93,271,358,87,87,1
"C03PY",185,465,"1200x900",1000,0,600,400,"False",85,203,285,82,82,1
"C03PY",186,115,"1200x900",600,1,600,400,"True",545,307,314,7,7,0
"C03PY",187,203,"1200x900",600,2,600,400,"True",938,603,540,-63,63,0
"C03PY",188,524,"1200x900",1000,1,600,400,"False",534,470,528,58,58,0
"C03PY",189,240,"1200x900",800,0,600,400,"False",330,656,580,-76,76,1
"C03PY",190,85,"1200x900",600,1,600,400,"False",434,347,464,117,117,0
"C03PY",191,392,"1200x900",800,2,600,400,"True",1031,618,574,-44,44,0
"C03PY",192,219,"1200x900",800,0,600,400,"True",202,502,481,-21,21,1
"C03PY",193,346,"1200x900",800,1,600,400,"False",269,635,520,-115,115,0
"C03PY",197,1,"1200x900",600,0,600,400,"True",136,502,502,0,0,0
"C03PY",199,59,"1200x900",600,0,600,400,"True",391,692,710,18,18,1
"C03PY",200,71,"1200x900",600,0,600,400,"True",219,248,306,58,58,0
"C03PY",201,16,"1200x900",600,0,600,400,"False",297,514,419,-95,95,1
"C03PY",202,249,"1200x900",800,0,600,400,"True",126,306,340,34,34,1
"C03PY",203,99,"1200x900",600,1,600,400,"True",811,407,408,1,1,0
"C03PY",205,364,"1200x900",800,2,600,400,"False",1018,204,621,417,417,0
"C03PY",206,448,"1200x900",1000,0,600,400,"False",107,641,558,-83,83,1
"C03PY",207,275,"1200x900",800,0,600,400,"False",120,594,476,-118,118,0
"C03PY",208,594,"1200x900",1000,2,600,400,"False",537,637,488,-149,149,0
"C03PY",209,261,"1200x900",800,0,600,400,"True",86,713,719,6,6,1
"C03PY",210,516,"1200x900",1000,1,600,400,"False",440,559,644,85,85,0
"C03PY",211,123,"1200x900",600,1,600,400,"True",761,365,422,57,57,1
"C03PY",212,559,"1200x900",1000,1,600,400,"True",641,244,312,68,68,0
"C03PY",213,98,"1200x900",600,1,600,400,"True",625,530,543,13,13,0
"C03PY",214,413,"1200x900",800,2,600,400,"True",849,506,519,13,13,0
"C03PY",215,477,"1200x900",1000,0,600,400,"False",88,640,560,-80,80,1
"C03PY",216,563,"1200x900",1000,1,600,400,"True",201,696,716,20,20,0
"C03PY",217,324,"1200x900",800,1,600,400,"False",719,712,585,-127,127,1
"C03PY",218,480,"1200x900",1000,0,600,400,"False",100,231,407,176,176,1
"C03PY",219,94,"1200x900",600,1,600,400,"True",729,482,515,33,33,0
"C03PY",220,571,"1200x900",1000,1,600,400,"False",239,522,608,86,86,1
"C03PY",221,17,"1200x900",600,0,600,400,"True",402,496,535,39,39,1
"C03PY",222,196,"1200x900",600,2,600,400,"True",1030,397,383,-14,14,0
"C03PY",223,611,"1200x900",1000,2,600,400,"True",414,511,511,0,0,0
"C03PY",224,242,"1200x900",800,0,600,400,"True",117,448,446,-2,2,1
"C03PY",225,41,"1200x900",600,0,600,400,"True",370,452,474,22,22,1
"C03PY",226,139,"1200x900",600,1,600,400,"False",192,695,517,-178,178,0
"C03PY",227,538,"1200x900",1000,1,600,400,"False",308,457,600,143,143,1
"C03PY",228,643,"1200x900",1000,2,600,400,"False",740,325,493,168,168,0
"C03PY",230,18,"1200x900",600,0,600,400,"False",400,318,388,70,70,1
"C03PY",231,569,"1200x900",1000,1,600,400,"False",494,720,589,-131,131,0
"C03PY",232,128,"1200x900",600,1,600,400,"False",661,258,401,143,143,1
"C03PY",233,36,"1200x900",600,0,600,400,"True",128,346,324,-22,22,1
"C03PY",234,3,"1200x900",600,0,600,400,"False",298,443,542,99,99,1
"C03PY",235,636,"1200x900",1000,2,600,400,"False",575,583,416,-167,167,0
"C03PY",236,83,"1200x900",600,1,600,400,"True",763,568,532,-36,36,1
"C03PY",237,88,"1200x900",600,1,600,400,"True",186,554,571,17,17,0
"C03PY",238,89,"1200x900",600,1,600,400,"False",917,366,517,151,151,1
"C03PY",239,338,"1200x900",800,1,600,400,"False",813,253,490,237,237,1
"C03PY",240,86,"1200x900",600,1,600,400,"True",692,388,356,-32,32,1
"C03PY",242,390,"1200x900",800,2,600,400,"False",982,674,554,-120,120,1
"C03PY",243,284,"1200x900",800,0,600,400,"True",135,293,350,57,57,1
"C03PY",244,535,"1200x900",1000,1,600,400,"True",372,410,426,16,16,0
"C03PY",245,619,"1200x900",1000,2,600,400,"True",803,247,281,34,34,0
"C03PY",246,148,"1200x900",600,2,600,400,"True",907,330,316,-14,14,0
"C03PY",247,120,"1200x900",600,1,600,400,"True",690,655,612,-43,43,0
"C03PY",249,454,"1200x900",1000,0,600,400,"False",78,687,608,-79,79,1
"C03PY",250,373,"1200x900",800,2,600,400,"True",694,326,338,12,12,0
"C03PY",251,82,"1200x900",600,1,600,400,"False",108,213,152,-61,61,0
"C03PY",252,610,"1200x900",1000,2,600,400,"True",702,293,338,45,45,0
"C03PY",253,168,"1200x900",600,2,600,400,"False",1001,439,233,-206,206,0
"C03PY",254,347,"1200x900",800,1,600,400,"False",757,295,627,332,332,1
"C03PY",255,250,"1200x900",800,0,600,400,"False",290,248,333,85,85,1
"C03PY",256,154,"1200x900",600,2,600,400,"False",941,454,269,-185,185,0
"C03PY",257,243,"1200x900",800,0,600,400,"True",114,332,293,-39,39,1
"C03PY",258,383,"1200x900",800,2,600,400,"False",855,407,501,94,94,0
"C03PY",259,604,"1200x900",1000,2,600,400,"False",459,593,437,-156,156,0
"C03PY",260,299,"1200x900",800,1,600,400,"False",779,274,553,279,279,0
"C03PY",261,161,"1200x900",600,2,600,400,"False",939,553,666,113,113,0
"C03PY",262,573,"1200x900",1000,1,600,400,"True",486,615,648,33,33,0
"C03PY",263,403,"1200x900",800,2,600,400,"False",625,704,619,-85,85,0
"C03PY",264,255,"1200x900",800,0,600,400,"True",93,709,707,-2,2,1
"C03PY",265,276,"1200x900",800,0,600,400,"False",281,217,403,186,186,1
"C03PY",266,42,"1200x900",600,0,600,400,"False",233,479,406,-73,73,0
"C03PY",267,296,"1200x900",800,1,600,400,"False",89,279,99,-180,180,0
"C03PY",268,587,"1200x900",1000,2,600,400,"False",741,686,359,-327,327,0
"C03PY",269,363,"1200x900",800,2,600,400,"True",800,218,238,20,20,0
"C03PY",270,630,"1200x900",1000,2,600,400,"True",754,559,511,-48,48,0
"C03PY",271,589,"1200x900",1000,2,600,400,"False",856,418,570,152,152,0
"C03PY",272,270,"1200x900",800,0,600,400,"True",192,418,453,35,35,1
"C03PY",273,517,"1200x900",1000,1,600,400,"False",548,182,328,146,146,0
"C03PY",274,60,"1200x900",600,0,600,400,"True",365,213,240,27,27,1
"C03PY",275,291,"1200x900",800,1,600,400,"False",522,694,429,-265,265,0
"C03PY",276,372,"1200x900",800,2,600,400,"True",833,620,554,-66,66,0
"C03PY",277,49,"1200x900",600,0,600,400,"True",109,380,421,41,41,0
"C03PY",278,64,"1200x900",600,0,600,400,"True",102,339,397,58,58,0
"C03PY",279,426,"1200x900",800,2,600,400,"False",830,263,375,112,112,0
"C03PY",280,526,"1200x900",1000,1,600,400,"True",497,710,698,-12,12,0
"C03PY",281,138,"1200x900",600,1,600,400,"False",844,580,765,185,185,1
"C03PY",282,543,"1200x900",1000,1,600,400,"False",88,202,534,332,332,0
"C03PY",283,37,"1200x900",600,0,600,400,"True",258,403,404,1,1,1
"C03PY",284,505,"1200x900",1000,1,600,400,"False",191,484,342,-142,142,1
"C03PY",285,323,"1200x900",800,1,600,400,"True",388,348,368,20,20,0
"C03PY",286,213,"1200x900",600,2,600,400,"True",822,275,318,43,43,0
"C03PY",287,379,"1200x900",800,2,600,400,"False",994,325,548,223,223,0
"C03PY",288,235,"1200x900",800,0,600,400,"True",146,646,602,-44,44,1
"C03PY",289,169,"1200x900",600,2,600,400,"False",924,290,408,118,118,0
"C03PY",290,67,"1200x900",600,0,600,400,"True",289,308,323,15,15,1
"C03PY",291,352,"1200x900",800,1,600,400,"False",235,717,532,-185,185,0
"C03PY",292,586,"1200x900",1000,2,600,400,"False",802,262,565,303,303,0
"C03PY",293,107,"1200x900",600,1,600,400,"False",878,678,582,-96,96,0
"C03PY",294,179,"1200x900",600,2,600,400,"False",908,602,744,142,142,0
"C03PY",296,113,"1200x900",600,1,600,400,"True",897,657,695,38,38,0
"C03PY",299,144,"1200x900",600,1,600,400,"False",718,371,462,91,91,0
"C03PY",300,312,"1200x900",800,1,600,400,"False",238,683,545,-138,138,0
"C03PY",302,228,"1200x900",800,0,600,400,"False",174,687,591,-96,96,1
"C03PY",303,440,"1200x900",1000,0,600,400,"False",71,237,445,208,208,1
"C03PY",305,582,"1200x900",1000,2,600,400,"False",554,347,500,153,153,0
"C03PY",306,460,"1200x900",1000,0,600,400,"False",155,189,407,218,218,1
"C03PY",307,325,"1200x900",800,1,600,400,"False",105,394,234,-160,160,0
"C03PY",308,593,"1200x900",1000,2,600,400,"True",246,719,676,-43,43,0
"C03PY",309,145,"1200x900",600,2,600,400,"True",1004,630,675,45,45,0
"C03PY",310,100,"1200x900",600,1,600,400,"False",453,511,349,-162,162,0
"C03PY",311,202,"1200x900",600,2,600,400,"False",966,460,357,-103,103,0
"C03PY",312,437,"1200x900",1000,0,600,400,"False",74,667,532,-135,135,1
"C03PY",313,398,"1200x900",800,2,600,400,"False",944,698,494,-204,204,0
"C03PY",314,292,"1200x900",800,1,600,400,"True",88,565,569,4,4,0
"C03PY",315,286,"1200x900",800,0,600,400,"False",105,378,497,119,119,1
"C03PY",317,640,"1200x900",1000,2,600,400,"True",361,334,398,64,64,0
"C03PY",318,560,"1200x900",1000,1,600,400,"False",516,693,504,-189,189,0
"C03PY",319,591,"1200x900",1000,2,600,400,"False",698,336,261,-75,75,0
"C03PY",320,331,"1200x900",800,1,600,400,"False",240,620,499,-121,121,0
"C03PY",321,267,"1200x900",800,0,600,400,"True",145,665,616,-49,49,1
"C03PY",322,395,"1200x900",800,2,600,400,"False",743,334,478,144,144,0
"C03PY",323,512,"1200x900",1000,1,600,400,"False",139,261,377,116,116,0
"C03PY",324,194,"1200x900",600,2,600,400,"True",896,236,296,60,60,0
"C03PY",325,262,"1200x900",800,0,600,400,"False",196,481,393,-88,88,1
"C03PY",326,509,"1200x900",1000,1,600,400,"True",509,434,444,10,10,0
"C03PY",327,366,"1200x900",800,2,600,400,"False",931,464,334,-130,130,0
"C03PY",328,487,"1200x900",1000,0,600,400,"False",78,670,503,-167,167,1
"C03PY",329,547,"1200x900",1000,1,600,400,"False",369,384,581,197,197,1
"C03PY",330,121,"1200x900",600,1,600,400,"False",884,364,472,108,108,0
"C03PY",332,444,"1200x900",1000,0,600,400,"False",101,714,513,-201,201,1
"C03PY",333,385,"1200x900",800,2,600,400,"True",740,456,500,44,44,0
"C03PY",334,418,"1200x900",800,2,600,400,"True",754,507,482,-25,25,0
"C03PY",335,21,"1200x900",600,0,600,400,"True",314,383,412,29,29,1
"C03PY",336,283,"1200x900",800,0,600,400,"True",90,264,314,50,50,1
"C03PY",337,45,"1200x900",600,0,600,400,"False",487,678,566,-112,112,1
"C03PY",338,603,"1200x900",1000,2,600,400,"False",693,280,375,95,95,0
"C03PY",339,266,"1200x900",800,0,600,400,"True",126,303,279,-24,24,1
"C03PY",340,101,"1200x900",600,1,600,400,"False",541,656,400,-256,256,0
"C03PY",341,326,"1200x900",800,1,600,400,"True",103,482,426,-56,56,0
"C03PY",342,183,"1200x900",600,2,600,400,"False",927,289,403,114,114,0
"C03PY",343,206,"1200x900",600,2,600,400,"False",975,223,318,95,95,0
"C03PY",344,365,"1200x900",800,2,600,400,"False",1055,305,632,327,327,0
"C03PY",345,272,"1200x900",800,0,600,400,"False",200,181,301,120,120,1
"C03PY",346,288,"1200x900",800,0,600,400,"False",180,547,619,72,72,1
"C03PY",347,116,"1200x900",600,1,600,400,"True",767,289,400,111,111,0
"C03PY",348,305,"1200x900",800,1,600,400,"False",471,716,519,-197,197,0
"C03PY",349,322,"1200x900",800,1,600,400,"False",703,206,418,212,212,1
"C03PY",350,525,"1200x900",1000,1,600,400,"False",123,690,576,-114,114,0
"C03PY",351,191,"1200x900",600,2,600,400,"False",962,396,299,-97,97,0
"C03PY",352,198,"1200x900",600,2,600,400,"False",976,500,411,-89,89,0
"C03PY",353,451,"1200x900",1000,0,600,400,"False",110,702,571,-131,131,1
"C03PY",354,214,"1200x900",600,2,600,400,"True",1046,305,424,119,119,0
"C03PY",355,601,"1200x900",1000,2,600,400,"False",735,697,461,-236,236,0
"C03PY",356,244,"1200x900",800,0,600,400,"False",194,203,289,86,86,1
"C03PY",357,433,"1200x900",1000,0,600,400,"False",76,222,385,163,163,1
"C03PY",358,130,"1200x900",600,1,600,400,"True",741,428,399,-29,29,0
"C03PY",359,641,"1200x900",1000,2,600,400,"False",897,272,490,218,218,0
"C03PY",360,530,"1200x900",1000,1,600,400,"False",584,405,55,-350,350,1
"C03PY",361,104,"1200x900",600,1,600,400,"True",448,584,529,-55,55,0
"C03PY",362,150,"1200x900",600,2,600,400,"True",897,345,312,-33,33,0
"C03PY",363,350,"1200x900",800,1,600,400,"False",182,566,455,-111,111,0
"C03PY",364,232,"1200x900",800,0,600,400,"True",84,511,466,-45,45,1
"C03PY",365,410,"1200x900",800,2,600,400,"False",916,477,389,-88,88,0
"C03PY",366,74,"1200x900",600,1,600,400,"True",115,358,394,36,36,0
"C03PY",367,556,"1200x900",1000,1,600,400,"True",415,420,379,-41,41,0
"C03PY",369,200,"1200x900",600,2,600,400,"False",897,302,395,93,93,0
"C03PY",370,26,"1200x900",600,0,600,400,"False",70,712,559,-153,153,0
"C03PY",371,180,"1200x900",600,2,600,400,"False",929,270,374,104,104,0
"C03PY",372,300,"1200x900",800,1,600,400,"False",620,693,456,-237,237,0
"C03PY",373,368,"1200x900",800,2,600,400,"False",778,515,413,-102,102,0
"C03PY",374,273,"1200x900",800,0,600,400,"False",180,309,408,99,99,1
"C03PY",375,558,"1200x900",1000,1,600,400,"True",72,464,492,28,28,1
"C03PY",379,264,"1200x900",800,0,600,400,"True",198,660,716,56,56,1
"C03PY",380,360,"1200x900",800,1,600,400,"False",203,608,667,59,59,0
"C03PY",381,302,"1200x900",800,1,600,400,"False",479,467,556,89,89,1
"C03PY",383,542,"1200x900",1000,1,600,400,"False",304,401,300,-101,101,0
"C03PY",384,135,"1200x900",600,1,600,400,"True",759,569,585,16,16,0
"C03PY",385,580,"1200x900",1000,2,600,400,"True",651,267,330,63,63,0
"C03PY",386,515,"1200x900",1000,1,600,400,"True",307,217,258,41,41,0
"C03PY",388,377,"1200x900",800,2,600,400,"True",683,388,346,-42,42,0
"C03PY",389,539,"1200x900",1000,1,600,400,"True",510,383,367,-16,16,0
"C03PY",390,411,"1200x900",800,2,600,400,"True",805,361,336,-25,25,0
"C03PY",393,388,"1200x900",800,2,600,400,"False",930,320,411,91,91,0
"C03PY",394,371,"1200x900",800,2,600,400,"False",730,560,441,-119,119,0
"C03PY",395,20,"1200x900",600,0,600,400,"True",204,545,581,36,36,1
"C03PY",396,400,"1200x900",800,2,600,400,"False",733,297,492,195,195,0
"C03PY",397,471,"1200x900",1000,0,600,400,"False",122,200,352,152,152,1
"C03PY",398,470,"1200x900",1000,0,600,400,"False",91,666,549,-117,117,1
"C03PY",399,34,"1200x900",600,0,600,400,"True",361,242,246,4,4,1
"C03PY",400,620,"1200x900",1000,2,600,400,"False",832,649,286,-363,363,0
"C03PY",401,122,"1200x900",600,1,600,400,"True",817,709,655,-54,54,0
"C03PY",402,297,"1200x900",800,1,600,400,"False",625,244,410,166,166,0
"C03PY",403,457,"1200x900",1000,0,600,400,"True",97,630,579,-51,51,1
"C03PY",404,221,"1200x900",800,0,600,400,"True",132,520,489,-31,31,1
"C03PY",405,393,"1200x900",800,2,600,400,"True",657,620,600,-20,20,0
"C03PY",406,343,"1200x900",800,1,600,400,"True",407,557,543,-14,14,0
"C03PY",407,342,"1200x900",800,1,600,400,"False",677,204,445,241,241,0
"C03PY",408,313,"1200x900",800,1,600,400,"True",588,421,384,-37,37,0
"C03PY",409,497,"1200x900",1000,0,600,400,"False",106,696,603,-93,93,1
"C03PY",410,484,"1200x900",1000,0,600,400,"False",100,223,427,204,204,1
"C03PY",411,140,"1200x900",600,1,600,400,"True",700,523,473,-50,50,0
"C03PY",412,51,"1200x900",600,0,600,400,"True",272,181,174,-7,7,1
"C03PY",413,438,"1200x900",1000,0,600,400,"True",77,713,755,42,42,1
"C03PY",414,456,"1200x900",1000,0,600,400,"False",91,257,386,129,129,1
"C03PY",415,380,"1200x900",800,2,600,400,"False",942,228,385,157,157,0
"C03PY",416,171,"1200x900",600,2,600,400,"True",909,200,278,78,78,0
"C03PY",417,39,"1200x900",600,0,600,400,"True",210,609,663,54,54,0
"C03PY",418,420,"1200x900",800,2,600,400,"False",519,223,414,191,191,0
"C03PY",419,491,"1200x900",1000,0,600,400,"False",108,198,301,103,103,1
"C03PY",420,252,"1200x900",800,0,600,400,"False",224,673,607,-66,66,1
"C03PY",421,446,"1200x900",1000,0,600,400,"True",72,298,337,39,39,1
"C03PY",422,483,"1200x900",1000,0,600,400,"False",93,191,267,76,76,1
"C03PY",423,375,"1200x900",800,2,600,400,"False",716,384,326,-58,58,0
"C03PY",424,481,"1200x900",1000,0,600,400,"False",80,185,308,123,123,1
"C03PY",425,31,"1200x900",600,0,600,400,"True",365,338,331,-7,7,1
"C03PY",426,237,"1200x900",800,0,600,400,"False",204,481,627,146,146,1
"C03PY",427,494,"1200x900",1000,0,600,400,"True",127,692,653,-39,39,1
"C03PY",428,220,"1200x900",800,0,600,400,"True",108,699,744,45,45,1
"C03PY",429,290,"1200x900",800,1,600,400,"True",789,603,638,35,35,0
"C03PY",430,344,"1200x900",800,1,600,400,"False",589,408,486,78,78,0
"C03PY",431,431,"1200x900",800,2,600,400,"False",694,382,445,63,63,0
"C03PY",432,230,"1200x900",800,0,600,400,"True",99,678,612,-66,66,1
"C03PY",433,548,"1200x900",1000,1,600,400,"False",103,278,453,175,175,0
"C03PY",434,443,"1200x900",1000,0,600,400,"True",99,651,600,-51,51,1
"C03PY",436,23,"1200x900",600,0,600,400,"True",308,463,488,25,25,1
"C03PY",437,606,"1200x900",1000,2,600,400,"False",653,627,478,-149,149,0
"C03PY",438,199,"1200x900",600,2,600,400,"True",992,467,416,-51,51,0
"C03PY",439,537,"1200x900",1000,1,600,400,"False",621,412,522,110,110,1
"C03PY",440,316,"1200x900",800,1,600,400,"False",362,319,411,92,92,0
"C03PY",442,332,"1200x900",800,1,600,400,"False",260,699,815,116,116,0
"C03PY",443,467,"1200x900",1000,0,600,400,"True",74,712,692,-20,20,1
"C03PY",444,164,"1200x900",600,2,600,400,"True",1051,268,297,29,29,0
"C03PY",445,72,"1200x900",600,0,600,400,"True",158,537,502,-35,35,0
"C03PY",446,13,"1200x900",600,0,600,400,"False",296,211,353,142,142,1
"C03PY",447,617,"1200x900",1000,2,600,400,"False",294,180,361,181,181,0
"C03PY",448,172,"1200x900",600,2,600,400,"False",912,444,375,-69,69,0
"C03PY",449,565,"1200x900",1000,1,600,400,"True",451,562,589,27,27,0
"C03PY",450,609,"1200x900",1000,2,600,400,"True",697,627,574,-53,53,0
"C03PY",451,510,"1200x900",1000,1,600,400,"False",486,338,63,-275,275,1
"C03PY",452,341,"1200x900",800,1,600,400,"True",735,632,632,0,0,1
"C03PY",453,453,"1200x900",1000,0,600,400,"False",71,393,534,141,141,1
"C03PY",454,279,"1200x900",800,0,600,400,"False",252,202,363,161,161,1
"C03PY",455,97,"1200x900",600,1,600,400,"False",760,643,739,96,96,1
"C03PY",456,450,"1200x900",1000,0,600,400,"False",130,204,379,175,175,1
"C03PY",457,367,"1200x900",800,2,600,400,"True",613,464,520,56,56,0
"C03PY",458,27,"1200x900",600,0,600,400,"True",373,309,319,10,10,1
"C03PY",459,472,"1200x900",1000,0,600,400,"False",77,685,558,-127,127,1
"C03PY",460,597,"1200x900",1000,2,600,400,"True",352,239,311,72,72,0
"C03PY",461,614,"1200x900",1000,2,600,400,"False",823,563,422,-141,141,0
"C03PY",462,381,"1200x900",800,2,600,400,"True",705,408,391,-17,17,0
"C03PY",463,452,"1200x900",1000,0,600,400,"True",97,273,332,59,59,1
"C03PY",464,256,"1200x900",800,0,600,400,"True",192,656,598,-58,58,1
"C03PY",465,226,"1200x900",800,0,600,400,"False",187,229,302,73,73,1
"C03PY",466,30,"1200x900",600,0,600,400,"True",107,353,332,-21,21,0
"C03PY",467,522,"1200x900",1000,1,600,400,"False",223,379,458,79,79,0
"C03PY",468,462,"1200x900",1000,0,600,400,"False",102,672,564,-108,108,1
"C03PY",470,493,"1200x900",1000,0,600,400,"False",80,582,507,-75,75,1
"C03PY",472,624,"1200x900",1000,2,600,400,"False",693,501,424,-77,77,0
"C03PY",473,645,"1200x900",1000,2,600,400,"True",619,396,444,48,48,0
"C03PY",475,455,"1200x900",1000,0,600,400,"False",107,718,631,-87,87,1
"C03PY",476,147,"1200x900",600,2,600,400,"False",942,418,286,-132,132,0
"C03PY",477,137,"1200x900",600,1,600,400,"False",789,577,498,-79,79,0
"C03PY",478,394,"1200x900",800,2,600,400,"False",847,292,439,147,147,0
"C03PY",481,10,"1200x900",600,0,600,400,"True",400,499,468,-31,31,1
"C03PY",482,167,"1200x900",600,2,600,400,"True",956,241,323,82,82,0
"C03PY",484,2,"1200x900",600,0,600,400,"True",159,323,306,-17,17,0
"C03PY",485,155,"1200x900",600,2,600,400,"True",940,269,282,13,13,0
"C03PY",486,66,"1200x900",600,0,600,400,"True",155,673,724,51,51,0
"C03PY",487,29,"1200x900",600,0,600,400,"True",385,533,589,56,56,1
"C03PY",488,476,"1200x900",1000,0,600,400,"False",76,359,466,107,107,1
"C03PY",489,25,"1200x900",600,0,600,400,"True",263,403,455,52,52,1
"C03PY",490,188,"1200x900",600,2,600,400,"False",900,195,358,163,163,0
"C03PY",491,93,"1200x900",600,1,600,400,"True",139,540,502,-38,38,0
"C03PY",492,248,"1200x900",800,0,600,400,"False",94,240,370,130,130,1
"C03PY",493,600,"1200x900",1000,2,600,400,"False",765,207,414,207,207,0
"C03PY",494,303,"1200x900",800,1,600,400,"True",241,431,504,73,73,0
"C03PY",495,500,"1200x900",1000,0,600,400,"False",105,700,626,-74,74,1
"C03PY",496,534,"1200x900",1000,1,600,400,"False",328,504,595,91,91,1
"C03PY",497,401,"1200x900",800,2,600,400,"False",821,260,401,141,141,0
"C03PY",498,575,"1200x900",1000,1,600,400,"True",272,693,683,-10,10,0
"C03PY",499,225,"1200x900",800,0,600,400,"False",178,423,345,-78,78,1
"C03PY",500,608,"1200x900",1000,2,600,400,"False",742,250,549,299,299,0
"C03PY",501,192,"1200x900",600,2,600,400,"False",1064,320,449,129,129,0
"C03PY",502,409,"1200x900",800,2,600,400,"False",501,659,777,118,118,0
"C03PY",503,423,"1200x900",800,2,600,400,"False",1051,710,590,-120,120,1
"C03PY",504,315,"1200x900",800,1,600,400,"False",105,211,84,-127,127,0
"C03PY",505,114,"1200x900",600,1,600,400,"False",183,697,405,-292,292,0
"C03PY",506,424,"1200x900",800,2,600,400,"False",903,545,402,-143,143,0
"C03PY",507,504,"1200x900",1000,0,600,400,"False",107,699,481,-218,218,1
"C03PY",509,159,"1200x900",600,2,600,400,"True",992,309,362,53,53,0
"C03PY",510,178,"1200x900",600,2,600,400,"True",1041,510,496,-14,14,0
"C03PY",511,646,"1200x900",1000,2,600,400,"False",829,227,396,169,169,1
"C03PY",512,622,"1200x900",1000,2,600,400,"False",307,683,384,-299,299,0
"C03PY",513,501,"1200x900",1000,0,600,400,"False",96,323,434,111,111,1
"C03PY",516,553,"1200x900",1000,1,600,400,"False",116,712,312,-400,400,0
"C03PY",517,623,"1200x900",1000,2,600,400,"True",636,527,517,-10,10,0
"C03PY",519,91,"1200x900",600,1,600,400,"True",417,630,602,-28,28,1
"C03PY",520,35,"1200x900",600,0,600,400,"True",366,555,604,49,49,1
"C03PY",523,369,"1200x900",800,2,600,400,"True",903,594,508,-86,86,0
"C03PY",524,485,"1200x900",1000,0,600,400,"False",121,694,630,-64,64,1
"C03PY",525,354,"1200x900",800,1,600,400,"True",118,236,188,-48,48,0
"C03PY",526,387,"1200x900",800,2,600,400,"False",990,444,272,-172,172,0
"C03PY",527,447,"1200x900",1000,0,600,400,"True",71,339,381,42,42,1
"C03PY",529,615,"1200x900",1000,2,600,400,"False",736,634,472,-162,162,0
"C03PY",530,56,"1200x900",600,0,600,400,"True",148,491,528,37,37,0
"C03PY",531,38,"1200x900",600,0,600,400,"True",120,628,635,7,7,1
"C03PY",532,151,"1200x900",600,2,600,400,"False",828,680,592,-88,88,0
"C03PY",533,432,"1200x900",800,2,600,400,"False",792,380,581,201,201,0
"C03PY",535,508,"1200x900",1000,1,600,400,"True",596,485,537,52,52,0
"C03PY",538,479,"1200x900",1000,0,600,400,"False",74,705,499,-206,206,1
"C03PY",539,466,"1200x900",1000,0,600,400,"False",82,205,366,161,161,1
"C03PY",540,348,"1200x900",800,1,600,400,"True",764,294,309,15,15,0
"C03PY",542,253,"1200x900",800,0,600,400,"True",177,424,419,-5,5,1
"C03PY",543,65,"1200x900",600,0,600,400,"False",442,645,586,-59,59,1
"C03PY",544,126,"1200x900",600,1,600,400,"True",849,354,395,41,41,0
"C03PY",545,588,"1200x900",1000,2,600,400,"False",585,350,442,92,92,0
"C03PY",546,84,"1200x900",600,1,600,400,"False",144,184,292,108,108,0
"C03PY",547,399,"1200x900",800,2,600,400,"True",603,602,524,-78,78,0
"C03PY",550,637,"1200x900",1000,2,600,400,"False",750,460,336,-124,124,0
"C03PY",551,208,"1200x900",600,2,600,400,"False",946,399,456,57,57,0
"C03PY",552,105,"1200x900",600,1,600,400,"False",527,440,815,375,375,0
"C03PY",553,8,"1200x900",600,0,600,400,"False",156,679,748,69,69,0
"C03PY",554,495,"1200x900",1000,0,600,400,"True",93,692,676,-16,16,1
"C03PY",555,166,"1200x900",600,2,600,400,"True",896,274,298,24,24,0
"C03PY",556,170,"1200x900",600,2,600,400,"False",996,468,355,-113,113,0
"C03PY",557,607,"1200x900",1000,2,600,400,"True",900,573,547,-26,26,1
"C03PY",558,47,"1200x900",600,0,600,400,"True",303,499,505,6,6,1
"C03PY",559,318,"1200x900",800,1,600,400,"False",788,534,670,136,136,0
"C03PY",560,536,"1200x900",1000,1,600,400,"False",580,213,321,108,108,0
"C03PY",561,257,"1200x900",800,0,600,400,"True",97,219,167,-52,52,1
"C03PY",562,7,"1200x900",600,0,600,400,"True",431,654,681,27,27,1
"C03PY",563,304,"1200x900",800,1,600,400,"False",667,605,320,-285,285,0
"C03PY",564,599,"1200x900",1000,2,600,400,"False",316,570,723,153,153,0
"C03PY",565,434,"1200x900",1000,0,600,400,"False",89,657,757,100,100,1
"C03PY",566,550,"1200x900",1000,1,600,400,"True",301,459,519,60,60,0
"C03PY",567,328,"1200x900",800,1,600,400,"False",104,649,714,65,65,0
"C03PY",568,518,"1200x900",1000,1,600,400,"True",583,717,710,-7,7,0
"C03PY",569,402,"1200x900",800,2,600,400,"True",878,234,233,-1,1,0
"C03PY",570,269,"1200x900",800,0,600,400,"True",160,295,299,4,4,1
"C03PY",571,334,"1200x900",800,1,600,400,"True",481,665,657,-8,8,0
"C03PY",572,339,"1200x900",800,1,600,400,"False",273,545,468,-77,77,1
"C03PY",573,165,"1200x900",600,2,600,400,"True",912,554,503,-51,51,0
"C03PY",574,561,"1200x900",1000,1,600,400,"False",231,406,619,213,213,0
"C03PY",575,108,"1200x900",600,1,600,400,"False",830,239,362,123,123,0
"C03PY",576,46,"1200x900",600,0,600,400,"True",193,355,403,48,48,1
"C03PY",577,521,"1200x900",1000,1,600,400,"True",111,303,314,11,11,1
"C03PY",578,320,"1200x900",800,1,600,400,"True",644,376,393,17,17,0
"C03PY",579,282,"1200x900",800,0,600,400,"True",109,246,305,59,59,1
"C03PY",580,294,"1200x900",800,1,600,400,"True",262,287,286,-1,1,0
"C03PY",581,4,"1200x900",600,0,600,400,"False",602,200,350,150,150,1
"C03PY",582,528,"1200x900",1000,1,600,400,"False",839,227,467,240,240,1
"C03PY",583,58,"1200x900",600,0,600,400,"False",353,655,495,-160,160,1
"C03PY",584,133,"1200x900",600,1,600,400,"True",345,551,604,53,53,0
"C03PY",586,358,"1200x900",800,1,600,400,"False",263,635,353,-282,282,0
"C03PY",587,361,"1200x900",800,2,600,400,"True",931,328,341,13,13,0
"C03PY",588,254,"1200x900",800,0,600,400,"True",136,583,533,-50,50,1
"C03PY",589,441,"1200x900",1000,0,600,400,"False",85,684,614,-70,70,1
"C03PY",590,595,"1200x900",1000,2,600,400,"False",687,640,394,-246,246,0
"C03PY",591,336,"1200x900",800,1,600,400,"True",251,587,578,-9,9,0
"C03PY",592,306,"1200x900",800,1,600,400,"False",164,524,670,146,146,0
"C03PY",593,598,"1200x900",1000,2,600,400,"True",706,559,547,-12,12,0
"C03PY",594,207,"1200x900",600,2,600,400,"False",838,235,359,124,124,0
"C03PY",595,396,"1200x900",800,2,600,400,"False",678,663,493,-170,170,0
"C03PY",596,474,"1200x900",1000,0,600,400,"True",85,339,370,31,31,1
"C03PY",597,218,"1200x900",800,0,600,400,"True",106,397,328,-69,69,1
"C03PY",598,552,"1200x900",1000,1,600,400,"False",255,412,584,172,172,0
"C03PY",599,69,"1200x900",600,0,600,400,"False",322,268,403,135,135,0
"C03PY",600,153,"1200x900",600,2,600,400,"False",1037,601,678,77,77,0
"C03PY",601,513,"1200x900",1000,1,600,400,"False",235,602,291,-311,311,0
"C03PY",602,551,"1200x900",1000,1,600,400,"True",146,445,521,76,76,1
"C03PY",603,435,"1200x900",1000,0,600,400,"False",119,200,323,123,123,1
"C03PY",604,321,"1200x900",800,1,600,400,"True",601,190,238,48,48,0
"C03PY",605,627,"1200x900",1000,2,600,400,"False",760,510,630,120,120,0
"C03PY",606,482,"1200x900",1000,0,600,400,"False",79,686,548,-138,138,1
"C03PY",607,245,"1200x900",800,0,600,400,"False",296,235,362,127,127,1
"C03PY",608,157,"1200x900",600,2,600,400,"False",1016,323,216,-107,107,0
"C03PY",609,44,"1200x900",600,0,600,400,"False",305,554,464,-90,90,1
"C03PY",610,613,"1200x900",1000,2,600,400,"True",690,374,416,42,42,0
"C03PY",611,503,"1200x900",1000,0,600,400,"True",86,279,335,56,56,1
"C03PY",612,111,"1200x900",600,1,600,400,"True",922,552,508,-44,44,1
"C03PY",613,436,"1200x900",1000,0,600,400,"False",82,617,538,-79,79,1
"C03PY",614,118,"1200x900",600,1,600,400,"False",190,588,464,-124,124,0
"C03PY",615,425,"1200x900",800,2,600,400,"True",621,438,472,34,34,0
"C03PY",616,520,"1200x900",1000,1,600,400,"True",564,260,282,22,22,0
"C03PY",617,176,"1200x900",600,2,600,400,"True",1033,281,300,19,19,0
"C03PY",619,125,"1200x900",600,1,600,400,"True",750,531,475,-56,56,0
"C03PY",620,156,"1200x900",600,2,600,400,"False",913,197,333,136,136,0
"C03PY",621,507,"1200x900",1000,1,600,400,"False",608,583,471,-112,112,1
"C03PY",622,263,"1200x900",800,0,600,400,"True",82,396,329,-67,67,1
"C03PY",623,132,"1200x900",600,1,600,400,"True",333,185,177,-8,8,0
"C03PY",624,473,"1200x900",1000,0,600,400,"True",75,323,340,17,17,1
"C03PY",625,541,"1200x900",1000,1,600,400,"True",339,478,459,-19,19,0
"C03PY",626,19,"1200x900",600,0,600,400,"False",286,686,608,-78,78,0
"C03PY",627,546,"1200x900",1000,1,600,400,"False",305,374,460,86,86,0
"C03PY",629,616,"1200x900",1000,2,600,400,"True",854,357,332,-25,25,1
"C03PY",630,236,"1200x900",800,0,600,400,"True",162,350,329,-21,21,1
"C03PY",631,475,"1200x900",1000,0,600,400,"False",101,715,539,-176,176,1
"C03PY",632,445,"1200x900",1000,0,600,400,"False",78,302,488,186,186,1
"C03PY",633,54,"1200x900",600,0,600,400,"True",474,564,589,25,25,1
"C03PY",634,416,"1200x900",800,2,600,400,"False",748,617,404,-213,213,0
"C03PY",635,63,"1200x900",600,0,600,400,"True",311,188,181,-7,7,1
"C03PY",636,631,"1200x900",1000,2,600,400,"True",699,479,532,53,53,0
"C03PY",637,566,"1200x900",1000,1,600,400,"False",378,472,343,-129,129,1
"C03PY",638,633,"1200x900",1000,2,600,400,"False",564,253,472,219,219,0
"C03PY",639,233,"1200x900",800,0,600,400,"False",164,700,769,69,69,1
"C03PY",640,265,"1200x900",800,0,600,400,"False",229,353,537,184,184,1
"C03PY",641,370,"1200x900",800,2,600,400,"True",874,336,336,0,0,0
"C03PY",642,5,"1200x900",600,0,600,400,"False",228,587,488,-99,99,0
"C03PY",643,215,"1200x900",600,2,600,400,"False",939,596,472,-124,124,0
"C03PY",644,53,"1200x900",600,0,600,400,"False",177,189,321,132,132,0
"C03PY",645,160,"1200x900",600,2,600,400,"True",863,606,552,-54,54,0
"C03PY",646,181,"1200x900",600,2,600,400,"True",1018,223,269,46,46,0
"C03PY",647,52,"1200x900",600,0,600,400,"True",171,188,227,39,39,0
"C03PY",648,386,"1200x900",800,2,600,400,"True",774,301,337,36,36,0
"C04TL",1,413,"1200x900",800,2,600,400,"True",849,506,543,37,37,0
"C04TL",2,119,"1200x900",600,1,600,400,"False",168,563,394,-169,169,0
"C04TL",3,108,"1200x900",600,1,600,400,"False",830,239,483,244,244,0
"C04TL",4,113,"1200x900",600,1,600,400,"True",897,657,700,43,43,0
"C04TL",5,526,"1200x900",1000,1,600,400,"False",497,710,538,-172,172,0
"C04TL",6,570,"1200x900",1000,1,600,400,"False",315,352,572,220,220,0
"C04TL",7,233,"1200x900",800,0,600,400,"True",164,700,693,-7,7,1
"C04TL",8,542,"1200x900",1000,1,600,400,"False",304,401,563,162,162,0
"C04TL",9,297,"1200x900",800,1,600,400,"True",625,244,258,14,14,0
"C04TL",10,286,"1200x900",800,0,600,400,"True",105,378,344,-34,34,1
"C04TL",11,283,"1200x900",800,0,600,400,"True",90,264,240,-24,24,1
"C04TL",12,600,"1200x900",1000,2,600,400,"False",765,207,363,156,156,0
"C04TL",13,42,"1200x900",600,0,600,400,"True",233,479,446,-33,33,0
"C04TL",14,109,"1200x900",600,1,600,400,"False",691,589,307,-282,282,0
"C04TL",15,511,"1200x900",1000,1,600,400,"True",408,390,442,52,52,1
"C04TL",16,338,"1200x900",800,1,600,400,"False",813,253,471,218,218,1
"C04TL",17,449,"1200x900",1000,0,600,400,"False",105,683,766,83,83,1
"C04TL",18,311,"1200x900",800,1,600,400,"True",710,261,295,34,34,0
"C04TL",19,432,"1200x900",800,2,600,400,"True",792,380,454,74,74,0
"C04TL",20,336,"1200x900",800,1,600,400,"False",251,587,442,-145,145,0
"C04TL",21,196,"1200x900",600,2,600,400,"False",1030,397,520,123,123,0
"C04TL",22,94,"1200x900",600,1,600,400,"True",729,482,418,-64,64,0
"C04TL",23,346,"1200x900",800,1,600,400,"False",269,635,538,-97,97,0
"C04TL",24,184,"1200x900",600,2,600,400,"False",1067,441,758,317,317,0
"C04TL",25,88,"1200x900",600,1,600,400,"True",186,554,502,-52,52,0
"C04TL",26,423,"1200x900",800,2,600,400,"True",1051,710,550,-160,160,1
"C04TL",27,497,"1200x900",1000,0,600,400,"True",106,696,637,-59,59,1
"C04TL",28,361,"1200x900",800,2,600,400,"False",931,328,449,121,121,0
"C04TL",29,53,"1200x900",600,0,600,400,"False",177,189,306,117,117,0
"C04TL",30,167,"1200x900",600,2,600,400,"True",956,241,305,64,64,0
"C04TL",31,359,"1200x900",800,1,600,400,"True",653,241,260,19,19,0
"C04TL",32,640,"1200x900",1000,2,600,400,"False",361,334,254,-80,80,0
"C04TL",33,180,"1200x900",600,2,600,400,"True",929,270,331,61,61,0
"C04TL",34,525,"1200x900",1000,1,600,400,"False",123,690,444,-246,246,0
"C04TL",35,103,"1200x900",600,1,600,400,"False",528,320,440,120,120,1
"C04TL",36,240,"1200x900",800,0,600,400,"False",330,656,567,-89,89,1
"C04TL",37,541,"1200x900",1000,1,600,400,"True",339,478,452,-26,26,0
"C04TL",38,483,"1200x900",1000,0,600,400,"False",93,191,353,162,162,1
"C04TL",39,641,"1200x900",1000,2,600,400,"False",897,272,356,84,84,0
"C04TL",40,356,"1200x900",800,1,600,400,"True",123,484,528,44,44,0
"C04TL",41,249,"1200x900",800,0,600,400,"True",126,306,280,-26,26,1
"C04TL",42,374,"1200x900",800,2,600,400,"False",755,450,365,-85,85,0
"C04TL",43,135,"1200x900",600,1,600,400,"True",759,569,610,41,41,0
"C04TL",44,90,"1200x900",600,1,600,400,"False",560,474,311,-163,163,0
"C04TL",45,181,"1200x900",600,2,600,400,"False",1018,223,385,162,162,0
"C04TL",46,389,"1200x900",800,2,600,400,"False",843,530,197,-333,333,0
"C04TL",47,415,"1200x900",800,2,600,400,"False",823,684,485,-199,199,0
"C04TL",48,481,"1200x900",1000,0,600,400,"True",80,185,119,-66,66,1
"C04TL",49,194,"1200x900",600,2,600,400,"False",896,236,494,258,258,0
"C04TL",50,325,"1200x900",800,1,600,400,"False",105,394,492,98,98,0
"C04TL",51,205,"1200x900",600,2,600,400,"False",1021,504,416,-88,88,0
"C04TL",52,333,"1200x900",800,1,600,400,"False",521,548,244,-304,304,0
"C04TL",53,213,"1200x900",600,2,600,400,"False",822,275,484,209,209,0
"C04TL",54,520,"1200x900",1000,1,600,400,"False",564,260,434,174,174,0
"C04TL",55,222,"1200x900",800,0,600,400,"True",152,206,231,25,25,1
"C04TL",56,530,"1200x900",1000,1,600,400,"False",584,405,218,-187,187,1
"C04TL",57,459,"1200x900",1000,0,600,400,"True",70,645,682,37,37,1
"C04TL",58,55,"1200x900",600,0,600,400,"True",211,305,297,-8,8,1
"C04TL",59,97,"1200x900",600,1,600,400,"False",760,643,449,-194,194,1
"C04TL",60,40,"1200x900",600,0,600,400,"True",143,513,537,24,24,0
"C04TL",61,277,"1200x900",800,0,600,400,"True",140,310,294,-16,16,1
"C04TL",62,349,"1200x900",800,1,600,400,"False",402,665,362,-303,303,0
"C04TL",63,419,"1200x900",800,2,600,400,"True",769,351,319,-32,32,0
"C04TL",64,8,"1200x900",600,0,600,400,"False",156,679,749,70,70,0
"C04TL",65,488,"1200x900",1000,0,600,400,"True",129,687,698,11,11,1
"C04TL",66,152,"1200x900",600,2,600,400,"False",971,399,339,-60,60,0
"C04TL",67,5,"1200x900",600,0,600,400,"True",228,587,526,-61,61,0
"C04TL",68,616,"1200x900",1000,2,600,400,"True",854,357,389,32,32,1
"C04TL",69,223,"1200x900",800,0,600,400,"True",179,191,171,-20,20,1
"C04TL",70,57,"1200x900",600,0,600,400,"True",354,508,446,-62,62,1
"C04TL",71,316,"1200x900",800,1,600,400,"False",362,319,429,110,110,0
"C04TL",72,204,"1200x900",600,2,600,400,"True",1053,432,385,-47,47,0
"C04TL",73,527,"1200x900",1000,1,600,400,"False",565,601,714,113,113,0
"C04TL",74,134,"1200x900",600,1,600,400,"True",300,188,165,-23,23,0
"C04TL",75,549,"1200x900",1000,1,600,400,"True",657,366,409,43,43,0
"C04TL",76,366,"1200x900",800,2,600,400,"False",931,464,335,-129,129,0
"C04TL",77,321,"1200x900",800,1,600,400,"True",601,190,241,51,51,0
"C04TL",78,576,"1200x900",1000,1,600,400,"True",376,713,664,-49,49,0
"C04TL",79,615,"1200x900",1000,2,600,400,"True",736,634,470,-164,164,0
"C04TL",80,114,"1200x900",600,1,600,400,"False",183,697,846,149,149,0
"C04TL",81,169,"1200x900",600,2,600,400,"True",924,290,293,3,3,0
"C04TL",82,75,"1200x900",600,1,600,400,"True",635,558,536,-22,22,0
"C04TL",83,565,"1200x900",1000,1,600,400,"True",451,562,619,57,57,0
"C04TL",84,125,"1200x900",600,1,600,400,"True",750,531,558,27,27,0
"C04TL",85,596,"1200x900",1000,2,600,400,"False",706,513,594,81,81,0
"C04TL",86,21,"1200x900",600,0,600,400,"True",314,383,331,-52,52,1
"C04TL",87,341,"1200x900",800,1,600,400,"True",735,632,635,3,3,1
"C04TL",88,267,"1200x900",800,0,600,400,"True",145,665,708,43,43,1
"C04TL",89,39,"1200x900",600,0,600,400,"True",210,609,623,14,14,0
"C04TL",91,478,"1200x900",1000,0,600,400,"True",79,672,665,-7,7,1
"C04TL",92,290,"1200x900",800,1,600,400,"True",789,603,641,38,38,0
"C04TL",93,447,"1200x900",1000,0,600,400,"True",71,339,295,-44,44,1
"C04TL",94,275,"1200x900",800,0,600,400,"True",120,594,633,39,39,0
"C04TL",95,54,"1200x900",600,0,600,400,"True",474,564,552,-12,12,1
"C04TL",96,30,"1200x900",600,0,600,400,"True",107,353,393,40,40,0
"C04TL",97,637,"1200x900",1000,2,600,400,"True",750,460,506,46,46,0
"C04TL",98,532,"1200x900",1000,1,600,400,"False",215,207,370,163,163,0
"C04TL",99,221,"1200x900",800,0,600,400,"True",132,520,475,-45,45,1
"C04TL",100,592,"1200x900",1000,2,600,400,"False",492,392,330,-62,62,0
"C04TL",101,1,"1200x900",600,0,600,400,"True",136,502,474,-28,28,0
"C04TL",102,339,"1200x900",800,1,600,400,"False",273,545,374,-171,171,1
"C04TL",103,642,"1200x900",1000,2,600,400,"False",776,316,503,187,187,0
"C04TL",104,504,"1200x900",1000,0,600,400,"False",107,699,850,151,151,1
"C04TL",105,534,"1200x900",1000,1,600,400,"False",328,504,677,173,173,1
"C04TL",106,381,"1200x900",800,2,600,400,"False",705,408,520,112,112,0
"C04TL",107,318,"1200x900",800,1,600,400,"False",788,534,850,316,316,0
"C04TL",108,81,"1200x900",600,1,600,400,"False",696,225,375,150,150,0
"C04TL",109,302,"1200x900",800,1,600,400,"True",479,467,435,-32,32,1
"C04TL",110,548,"1200x900",1000,1,600,400,"True",103,278,298,20,20,0
"C04TL",111,521,"1200x900",1000,1,600,400,"False",111,303,643,340,340,1
"C04TL",112,461,"1200x900",1000,0,600,400,"True",95,711,688,-23,23,1
"C04TL",113,422,"1200x900",800,2,600,400,"False",712,558,428,-130,130,0
"C04TL",114,403,"1200x900",800,2,600,400,"False",625,704,511,-193,193,0
"C04TL",115,328,"1200x900",800,1,600,400,"False",104,649,429,-220,220,0
"C04TL",116,528,"1200x900",1000,1,600,400,"False",839,227,610,383,383,1
"C04TL",117,187,"1200x900",600,2,600,400,"False",857,639,402,-237,237,0
"C04TL",118,294,"1200x900",800,1,600,400,"True",262,287,237,-50,50,0
"C04TL",119,647,"1200x900",1000,2,600,400,"False",560,637,327,-310,310,0
"C04TL",120,129,"1200x900",600,1,600,400,"False",859,482,381,-101,101,1
"C04TL",121,254,"1200x900",800,0,600,400,"True",136,583,621,38,38,1
"C04TL",122,259,"1200x900",800,0,600,400,"True",156,180,240,60,60,1
"C04TL",123,15,"1200x900",600,0,600,400,"False",473,352,217,-135,135,1
"C04TL",124,648,"1200x900",1000,2,600,400,"True",557,394,467,73,73,0
"C04TL",125,353,"1200x900",800,1,600,400,"True",90,476,448,-28,28,0
"C04TL",126,454,"1200x900",1000,0,600,400,"False",78,687,800,113,113,1
"C04TL",127,166,"1200x900",600,2,600,400,"True",896,274,212,-62,62,0
"C04TL",128,228,"1200x900",800,0,600,400,"False",174,687,606,-81,81,1
"C04TL",129,543,"1200x900",1000,1,600,400,"True",88,202,246,44,44,0
"C04TL",130,41,"1200x900",600,0,600,400,"True",370,452,424,-28,28,1
"C04TL",132,29,"1200x900",600,0,600,400,"True",385,533,517,-16,16,1
"C04TL",133,219,"1200x900",800,0,600,400,"True",202,502,495,-7,7,1
"C04TL",134,608,"1200x900",1000,2,600,400,"False",742,250,480,230,230,0
"C04TL",135,501,"1200x900",1000,0,600,400,"False",96,323,234,-89,89,1
"C04TL",137,200,"1200x900",600,2,600,400,"True",897,302,300,-2,2,0
"C04TL",138,255,"1200x900",800,0,600,400,"False",93,709,525,-184,184,1
"C04TL",139,173,"1200x900",600,2,600,400,"False",948,693,340,-353,353,0
"C04TL",140,589,"1200x900",1000,2,600,400,"False",856,418,570,152,152,0
"C04TL",141,279,"1200x900",800,0,600,400,"True",252,202,175,-27,27,1
"C04TL",142,144,"1200x900",600,1,600,400,"False",718,371,498,127,127,0
"C04TL",143,244,"1200x900",800,0,600,400,"True",194,203,205,2,2,1
"C04TL",144,104,"1200x900",600,1,600,400,"True",448,584,540,-44,44,0
"C04TL",145,334,"1200x900",800,1,600,400,"True",481,665,660,-5,5,0
"C04TL",146,26,"1200x900",600,0,600,400,"True",70,712,684,-28,28,0
"C04TL",147,360,"1200x900",800,1,600,400,"False",203,608,700,92,92,0
"C04TL",148,440,"1200x900",1000,0,600,400,"False",71,237,355,118,118,1
"C04TL",149,550,"1200x900",1000,1,600,400,"False",301,459,383,-76,76,0
"C04TL",150,605,"1200x900",1000,2,600,400,"False",493,665,445,-220,220,0
"C04TL",151,568,"1200x900",1000,1,600,400,"True",286,475,429,-46,46,1
"C04TL",152,514,"1200x900",1000,1,600,400,"False",539,690,573,-117,117,0
"C04TL",153,274,"1200x900",800,0,600,400,"True",146,497,471,-26,26,1
"C04TL",154,327,"1200x900",800,1,600,400,"False",152,339,271,-68,68,0
"C04TL",155,438,"1200x900",1000,0,600,400,"False",77,713,505,-208,208,1
"C04TL",156,269,"1200x900",800,0,600,400,"True",160,295,360,65,65,1
"C04TL",157,479,"1200x900",1000,0,600,400,"False",74,705,600,-105,105,1
"C04TL",158,252,"1200x900",800,0,600,400,"True",224,673,661,-12,12,1
"C04TL",159,120,"1200x900",600,1,600,400,"False",690,655,319,-336,336,0
"C04TL",160,245,"1200x900",800,0,600,400,"True",296,235,203,-32,32,1
"C04TL",161,536,"1200x900",1000,1,600,400,"True",580,213,175,-38,38,0
"C04TL",162,407,"1200x900",800,2,600,400,"False",989,340,253,-87,87,0
"C04TL",163,584,"1200x900",1000,2,600,400,"False",731,413,328,-85,85,0
"C04TL",164,246,"1200x900",800,0,600,400,"True",196,418,365,-53,53,1
"C04TL",165,450,"1200x900",1000,0,600,400,"False",130,204,266,62,62,1
"C04TL",166,310,"1200x900",800,1,600,400,"False",559,592,369,-223,223,0
"C04TL",167,411,"1200x900",800,2,600,400,"False",805,361,469,108,108,0
"C04TL",168,506,"1200x900",1000,1,600,400,"False",559,567,276,-291,291,1
"C04TL",169,551,"1200x900",1000,1,600,400,"True",146,445,420,-25,25,1
"C04TL",170,66,"1200x900",600,0,600,400,"False",155,673,334,-339,339,0
"C04TL",171,105,"1200x900",600,1,600,400,"True",527,440,401,-39,39,0
"C04TL",172,421,"1200x900",800,2,600,400,"False",898,394,296,-98,98,0
"C04TL",173,198,"1200x900",600,2,600,400,"False",976,500,328,-172,172,0
"C04TL",174,313,"1200x900",800,1,600,400,"True",588,421,475,54,54,0
"C04TL",175,192,"1200x900",600,2,600,400,"False",1064,320,147,-173,173,0
"C04TL",176,182,"1200x900",600,2,600,400,"True",933,389,405,16,16,0
"C04TL",177,280,"1200x900",800,0,600,400,"True",104,302,263,-39,39,1
"C04TL",178,85,"1200x900",600,1,600,400,"False",434,347,418,71,71,0
"C04TL",179,394,"1200x900",800,2,600,400,"False",847,292,392,100,100,0
"C04TL",180,150,"1200x900",600,2,600,400,"False",897,345,572,227,227,0
"C04TL",181,216,"1200x900",600,2,600,400,"True",1029,286,345,59,59,0
"C04TL",182,460,"1200x900",1000,0,600,400,"True",155,189,173,-16,16,1
"C04TL",183,599,"1200x900",1000,2,600,400,"False",316,570,127,-443,443,0
"C04TL",184,91,"1200x900",600,1,600,400,"False",417,630,379,-251,251,1
"C04TL",185,387,"1200x900",800,2,600,400,"True",990,444,455,11,11,0
"C04TL",186,59,"1200x900",600,0,600,400,"True",391,692,672,-20,20,1
"C04TL",187,340,"1200x900",800,1,600,400,"False",226,240,457,217,217,0
"C04TL",188,23,"1200x900",600,0,600,400,"True",308,463,412,-51,51,1
"C04TL",189,467,"1200x900",1000,0,600,400,"True",74,712,667,-45,45,1
"C04TL",190,232,"1200x900",800,0,600,400,"False",84,511,605,94,94,1
"C04TL",191,533,"1200x900",1000,1,600,400,"False",355,483,386,-97,97,0
"C04TL",192,36,"1200x900",600,0,600,400,"False",128,346,525,179,179,1
"C04TL",193,588,"1200x900",1000,2,600,400,"True",585,350,405,55,55,0
"C04TL",194,613,"1200x900",1000,2,600,400,"False",690,374,268,-106,106,0
"C04TL",195,636,"1200x900",1000,2,600,400,"True",575,583,622,39,39,0
"C04TL",196,165,"1200x900",600,2,600,400,"True",912,554,540,-14,14,0
"C04TL",197,443,"1200x900",1000,0,600,400,"True",99,651,637,-14,14,1
"C04TL",198,572,"1200x900",1000,1,600,400,"False",302,260,364,104,104,0
"C04TL",199,331,"1200x900",800,1,600,400,"True",240,620,523,-97,97,0
"C04TL",200,582,"1200x900",1000,2,600,400,"True",554,347,407,60,60,0
"C04TL",202,285,"1200x900",800,0,600,400,"False",237,396,256,-140,140,1
"C04TL",203,385,"1200x900",800,2,600,400,"False",740,456,529,73,73,0
"C04TL",204,273,"1200x900",800,0,600,400,"True",180,309,293,-16,16,1
"C04TL",205,545,"1200x900",1000,1,600,400,"False",358,562,453,-109,109,0
"C04TL",207,357,"1200x900",800,1,600,400,"True",109,594,555,-39,39,0
"C04TL",208,638,"1200x900",1000,2,600,400,"False",385,198,585,387,387,0
"C04TL",209,263,"1200x900",800,0,600,400,"True",82,396,361,-35,35,1
"C04TL",210,32,"1200x900",600,0,600,400,"True",152,563,534,-29,29,1
"C04TL",211,47,"1200x900",600,0,600,400,"True",303,499,455,-44,44,1
"C04TL",212,427,"1200x900",800,2,600,400,"False",812,380,468,88,88,0
"C04TL",213,162,"1200x900",600,2,600,400,"False",849,279,373,94,94,0
"C04TL",214,398,"1200x900",800,2,600,400,"False",944,698,480,-218,218,0
"C04TL",215,453,"1200x900",1000,0,600,400,"True",71,393,427,34,34,1
"C04TL",216,268,"1200x900",800,0,600,400,"True",148,400,445,45,45,1
"C04TL",217,594,"1200x900",1000,2,600,400,"False",537,637,431,-206,206,0
"C04TL",218,408,"1200x900",800,2,600,400,"False",758,567,727,160,160,0
"C04TL",219,154,"1200x900",600,2,600,400,"True",941,454,412,-42,42,0
"C04TL",220,201,"1200x900",600,2,600,400,"False",1005,462,382,-80,80,0
"C04TL",221,174,"1200x900",600,2,600,400,"True",998,457,492,35,35,0
"C04TL",222,343,"1200x900",800,1,600,400,"False",407,557,414,-143,143,0
"C04TL",223,210,"1200x900",600,2,600,400,"False",835,506,428,-78,78,0
"C04TL",224,10,"1200x900",600,0,600,400,"True",400,499,522,23,23,1
"C04TL",226,100,"1200x900",600,1,600,400,"False",453,511,332,-179,179,0
"C04TL",227,295,"1200x900",800,1,600,400,"True",471,334,350,16,16,0
"C04TL",229,462,"1200x900",1000,0,600,400,"False",102,672,576,-96,96,1
"C04TL",230,25,"1200x900",600,0,600,400,"True",263,403,416,13,13,1
"C04TL",231,284,"1200x900",800,0,600,400,"True",135,293,288,-5,5,1
"C04TL",232,620,"1200x900",1000,2,600,400,"False",832,649,393,-256,256,0
"C04TL",233,553,"1200x900",1000,1,600,400,"False",116,712,390,-322,322,0
"C04TL",234,471,"1200x900",1000,0,600,400,"True",122,200,221,21,21,1
"C04TL",235,633,"1200x900",1000,2,600,400,"False",564,253,622,369,369,0
"C04TL",236,38,"1200x900",600,0,600,400,"False",120,628,739,111,111,1
"C04TL",237,590,"1200x900",1000,2,600,400,"True",636,278,376,98,98,0
"C04TL",238,502,"1200x900",1000,0,600,400,"True",111,639,682,43,43,1
"C04TL",239,583,"1200x900",1000,2,600,400,"True",949,284,321,37,37,1
"C04TL",240,378,"1200x900",800,2,600,400,"False",1018,708,612,-96,96,0
"C04TL",241,203,"1200x900",600,2,600,400,"True",938,603,516,-87,87,0
"C04TL",242,524,"1200x900",1000,1,600,400,"False",534,470,631,161,161,0
"C04TL",243,237,"1200x900",800,0,600,400,"False",204,481,378,-103,103,1
"C04TL",244,224,"1200x900",800,0,600,400,"True",161,474,471,-3,3,1
"C04TL",245,45,"1200x900",600,0,600,400,"True",487,678,686,8,8,1
"C04TL",246,171,"1200x900",600,2,600,400,"False",909,200,497,297,297,0
"C04TL",247,639,"1200x900",1000,2,600,400,"True",504,456,403,-53,53,0
"C04TL",248,227,"1200x900",800,0,600,400,"True",196,551,526,-25,25,1
"C04TL",249,28,"1200x900",600,0,600,400,"True",336,410,388,-22,22,1
"C04TL",250,74,"1200x900",600,1,600,400,"False",115,358,297,-61,61,0
"C04TL",251,82,"1200x900",600,1,600,400,"False",108,213,365,152,152,0
"C04TL",252,477,"1200x900",1000,0,600,400,"False",88,640,515,-125,125,1
"C04TL",253,561,"1200x900",1000,1,600,400,"False",231,406,592,186,186,0
"C04TL",254,554,"1200x900",1000,1,600,400,"False",79,309,179,-130,130,1
"C04TL",255,424,"1200x900",800,2,600,400,"False",903,545,182,-363,363,0
"C04TL",256,587,"1200x900",1000,2,600,400,"False",741,686,340,-346,346,0
"C04TL",257,126,"1200x900",600,1,600,400,"True",849,354,418,64,64,0
"C04TL",258,480,"1200x900",1000,0,600,400,"True",100,231,242,11,11,1
"C04TL",259,288,"1200x900",800,0,600,400,"True",180,547,530,-17,17,1
"C04TL",260,139,"1200x900",600,1,600,400,"False",192,695,476,-219,219,0
"C04TL",261,518,"1200x900",1000,1,600,400,"True",583,717,657,-60,60,0
"C04TL",263,149,"1200x900",600,2,600,400,"True",890,289,305,16,16,0
"C04TL",264,347,"1200x900",800,1,600,400,"False",757,295,483,188,188,1
"C04TL",265,566,"1200x900",1000,1,600,400,"False",378,472,306,-166,166,1
"C04TL",266,235,"1200x900",800,0,600,400,"False",146,646,315,-331,331,1
"C04TL",267,33,"1200x900",600,0,600,400,"True",198,533,494,-39,39,1
"C04TL",268,558,"1200x900",1000,1,600,400,"False",72,464,346,-118,118,1
"C04TL",269,496,"1200x900",1000,0,600,400,"False",70,639,437,-202,202,1
"C04TL",270,265,"1200x900",800,0,600,400,"False",229,353,276,-77,77,1
"C04TL",271,435,"1200x900",1000,0,600,400,"False",119,200,303,103,103,1
"C04TL",272,607,"1200x900",1000,2,600,400,"False",900,573,471,-102,102,1
"C04TL",273,342,"1200x900",800,1,600,400,"False",677,204,341,137,137,0
"C04TL",274,303,"1200x900",800,1,600,400,"False",241,431,325,-106,106,0
"C04TL",275,92,"1200x900",600,1,600,400,"True",624,605,530,-75,75,0
"C04TL",277,555,"1200x900",1000,1,600,400,"True",444,556,529,-27,27,0
"C04TL",279,49,"1200x900",600,0,600,400,"True",109,380,410,30,30,0
"C04TL",281,43,"1200x900",600,0,600,400,"True",277,446,448,2,2,1
"C04TL",282,612,"1200x900",1000,2,600,400,"False",706,198,453,255,255,0
"C04TL",283,529,"1200x900",1000,1,600,400,"True",267,412,428,16,16,1
"C04TL",284,335,"1200x900",800,1,600,400,"True",124,360,375,15,15,0
"C04TL",285,106,"1200x900",600,1,600,400,"False",803,659,556,-103,103,1
"C04TL",286,261,"1200x900",800,0,600,400,"True",86,713,663,-50,50,1
"C04TL",287,131,"1200x900",600,1,600,400,"False",531,367,446,79,79,0
"C04TL",288,199,"1200x900",600,2,600,400,"False",992,467,588,121,121,0
"C04TL",289,160,"1200x900",600,2,600,400,"False",863,606,469,-137,137,0
"C04TL",290,355,"1200x900",800,1,600,400,"False",77,386,584,198,198,0
"C04TL",291,379,"1200x900",800,2,600,400,"False",994,325,702,377,377,0
"C04TL",292,508,"1200x900",1000,1,600,400,"True",596,485,509,24,24,0
"C04TL",293,395,"1200x900",800,2,600,400,"False",743,334,439,105,105,0
"C04TL",295,457,"1200x900",1000,0,600,400,"False",97,630,501,-129,129,1
"C04TL",296,469,"1200x900",1000,0,600,400,"False",73,227,341,114,114,1
"C04TL",297,20,"1200x900",600,0,600,400,"False",204,545,464,-81,81,1
"C04TL",298,6,"1200x900",600,0,600,400,"False",217,689,586,-103,103,1
"C04TL",300,516,"1200x900",1000,1,600,400,"False",440,559,300,-259,259,0
"C04TL",301,239,"1200x900",800,0,600,400,"True",114,231,192,-39,39,1
"C04TL",302,546,"1200x900",1000,1,600,400,"True",305,374,386,12,12,0
"C04TL",305,428,"1200x900",800,2,600,400,"True",732,665,624,-41,41,0
"C04TL",306,473,"1200x900",1000,0,600,400,"True",75,323,286,-37,37,1
"C04TL",307,470,"1200x900",1000,0,600,400,"False",91,666,491,-175,175,1
"C04TL",308,118,"1200x900",600,1,600,400,"False",190,588,754,166,166,0
"C04TL",309,575,"1200x900",1000,1,600,400,"True",272,693,627,-66,66,0
"C04TL",312,420,"1200x900",800,2,600,400,"False",519,223,339,116,116,0
"C04TL",313,382,"1200x900",800,2,600,400,"True",870,523,507,-16,16,0
"C04TL",314,130,"1200x900",600,1,600,400,"True",741,428,418,-10,10,0
"C04TL",315,238,"1200x900",800,0,600,400,"True",162,283,287,4,4,1
"C04TL",316,11,"1200x900",600,0,600,400,"False",372,670,597,-73,73,1
"C04TL",318,138,"1200x900",600,1,600,400,"False",844,580,669,89,89,1
"C04TL",319,396,"1200x900",800,2,600,400,"False",678,663,564,-99,99,0
"C04TL",320,598,"1200x900",1000,2,600,400,"False",706,559,369,-190,190,0
"C04TL",321,52,"1200x900",600,0,600,400,"True",171,188,154,-34,34,0
"C04TL",322,301,"1200x900",800,1,600,400,"False",162,574,439,-135,135,0
"C04TL",323,466,"1200x900",1000,0,600,400,"True",82,205,234,29,29,1
"C04TL",324,351,"1200x900",800,1,600,400,"True",122,581,532,-49,49,0
"C04TL",325,189,"1200x900",600,2,600,400,"False",881,397,498,101,101,0
"C04TL",326,71,"1200x900",600,0,600,400,"False",219,248,362,114,114,0
"C04TL",327,455,"1200x900",1000,0,600,400,"False",107,718,513,-205,205,1
"C04TL",328,304,"1200x900",800,1,600,400,"False",667,605,381,-224,224,0
"C04TL",329,4,"1200x900",600,0,600,400,"False",602,200,325,125,125,1
"C04TL",330,76,"1200x900",600,1,600,400,"True",647,614,576,-38,38,0
"C04TL",331,132,"1200x900",600,1,600,400,"False",333,185,281,96,96,0
"C04TL",332,101,"1200x900",600,1,600,400,"True",541,656,662,6,6,0
"C04TL",333,388,"1200x900",800,2,600,400,"False",930,320,558,238,238,0
"C04TL",334,300,"1200x900",800,1,600,400,"False",620,693,526,-167,167,0
"C04TL",335,510,"1200x900",1000,1,600,400,"True",486,338,291,-47,47,1
"C04TL",336,352,"1200x900",800,1,600,400,"True",235,717,656,-61,61,0
"C04TL",338,593,"1200x900",1000,2,600,400,"False",246,719,631,-88,88,0
"C04TL",340,362,"1200x900",800,2,600,400,"True",819,338,374,36,36,0
"C04TL",341,433,"1200x900",1000,0,600,400,"True",76,222,220,-2,2,1
"C04TL",342,425,"1200x900",800,2,600,400,"False",621,438,668,230,230,0
"C04TL",343,63,"1200x900",600,0,600,400,"True",311,188,205,17,17,1
"C04TL",344,190,"1200x900",600,2,600,400,"False",977,238,180,-58,58,0
"C04TL",345,211,"1200x900",600,2,600,400,"False",986,407,288,-119,119,0
"C04TL",346,48,"1200x900",600,0,600,400,"True",323,645,624,-21,21,1
"C04TL",347,117,"1200x900",600,1,600,400,"False",711,456,592,136,136,0
"C04TL",348,448,"1200x900",1000,0,600,400,"False",107,641,561,-80,80,1
"C04TL",349,644,"1200x900",1000,2,600,400,"False",495,486,334,-152,152,0
"C04TL",350,445,"1200x900",1000,0,600,400,"False",78,302,375,73,73,1
"C04TL",351,323,"1200x900",800,1,600,400,"False",388,348,627,279,279,0
"C04TL",352,586,"1200x900",1000,2,600,400,"True",802,262,198,-64,64,0
"C04TL",353,390,"1200x900",800,2,600,400,"False",982,674,749,75,75,1
"C04TL",354,262,"1200x900",800,0,600,400,"False",196,481,603,122,122,1
"C04TL",355,251,"1200x900",800,0,600,400,"True",88,352,313,-39,39,1
"C04TL",356,365,"1200x900",800,2,600,400,"False",1055,305,674,369,369,0
"C04TL",357,46,"1200x900",600,0,600,400,"True",193,355,389,34,34,1
"C04TL",358,60,"1200x900",600,0,600,400,"False",365,213,331,118,118,1
"C04TL",359,13,"1200x900",600,0,600,400,"False",296,211,293,82,82,1
"C04TL",360,247,"1200x900",800,0,600,400,"True",160,424,395,-29,29,1
"C04TL",361,308,"1200x900",800,1,600,400,"True",437,425,477,52,52,0
"C04TL",362,367,"1200x900",800,2,600,400,"True",613,464,413,-51,51,0
"C04TL",363,212,"1200x900",600,2,600,400,"False",841,206,614,408,408,0
"C04TL",364,188,"1200x900",600,2,600,400,"False",900,195,368,173,173,0
"C04TL",365,490,"1200x900",1000,0,600,400,"False",114,183,271,88,88,1
"C04TL",366,229,"1200x900",800,0,600,400,"False",117,697,499,-198,198,1
"C04TL",367,123,"1200x900",600,1,600,400,"True",761,365,339,-26,26,1
"C04TL",368,77,"1200x900",600,1,600,400,"False",780,525,259,-266,266,0
"C04TL",369,564,"1200x900",1000,1,600,400,"False",215,264,374,110,110,0
"C04TL",371,145,"1200x900",600,2,600,400,"True",1004,630,576,-54,54,0
"C04TL",372,539,"1200x900",1000,1,600,400,"True",510,383,415,32,32,0
"C04TL",373,404,"1200x900",800,2,600,400,"False",842,396,592,196,196,0
"C04TL",374,234,"1200x900",800,0,600,400,"True",72,344,373,29,29,1
"C04TL",375,270,"1200x900",800,0,600,400,"True",192,418,402,-16,16,1
"C04TL",376,645,"1200x900",1000,2,600,400,"False",619,396,490,94,94,0
"C04TL",377,571,"1200x900",1000,1,600,400,"False",239,522,400,-122,122,1
"C04TL",379,319,"1200x900",800,1,600,400,"True",494,587,576,-11,11,1
"C04TL",380,250,"1200x900",800,0,600,400,"False",290,248,455,207,207,1
"C04TL",381,148,"1200x900",600,2,600,400,"True",907,330,320,-10,10,0
"C04TL",382,580,"1200x900",1000,2,600,400,"False",651,267,442,175,175,0
"C04TL",383,610,"1200x900",1000,2,600,400,"False",702,293,446,153,153,0
"C04TL",384,458,"1200x900",1000,0,600,400,"False",78,624,469,-155,155,1
"C04TL",385,417,"1200x900",800,2,600,400,"True",750,280,255,-25,25,0
"C04TL",387,375,"1200x900",800,2,600,400,"True",716,384,415,31,31,0
"C04TL",388,444,"1200x900",1000,0,600,400,"False",101,714,576,-138,138,1
"C04TL",389,611,"1200x900",1000,2,600,400,"False",414,511,688,177,177,0
"C04TL",390,622,"1200x900",1000,2,600,400,"False",307,683,348,-335,335,0
"C04TL",391,179,"1200x900",600,2,600,400,"False",908,602,422,-180,180,0
"C04TL",392,230,"1200x900",800,0,600,400,"False",99,678,603,-75,75,1
"C04TL",393,289,"1200x900",800,1,600,400,"False",421,703,774,71,71,1
"C04TL",394,272,"1200x900",800,0,600,400,"False",200,181,448,267,267,1
"C04TL",395,563,"1200x900",1000,1,600,400,"True",201,696,639,-57,57,0
"C04TL",396,96,"1200x900",600,1,600,400,"False",433,458,598,140,140,0
"C04TL",397,348,"1200x900",800,1,600,400,"False",764,294,387,93,93,0
"C04TL",398,345,"1200x900",800,1,600,400,"False",841,566,646,80,80,1
"C04TL",399,83,"1200x900",600,1,600,400,"True",763,568,637,69,69,1
"C04TL",400,464,"1200x900",1000,0,600,400,"False",82,222,441,219,219,1
"C04TL",401,35,"1200x900",600,0,600,400,"False",366,555,402,-153,153,1
"C04TL",402,410,"1200x900",800,2,600,400,"True",916,477,429,-48,48,0
"C04TL",404,186,"1200x900",600,2,600,400,"False",997,197,470,273,273,0
"C04TL",405,606,"1200x900",1000,2,600,400,"False",653,627,399,-228,228,0
"C04TL",406,69,"1200x900",600,0,600,400,"False",322,268,375,107,107,0
"C04TL",407,61,"1200x900",600,0,600,400,"False",272,670,529,-141,141,1
"C04TL",408,175,"1200x900",600,2,600,400,"True",1028,432,432,0,0,0
"C04TL",409,12,"1200x900",600,0,600,400,"False",365,336,407,71,71,1
"C04TL",410,515,"1200x900",1000,1,600,400,"False",307,217,424,207,207,0
"C04TL",411,512,"1200x900",1000,1,600,400,"False",139,261,440,179,179,0
"C04TL",412,27,"1200x900",600,0,600,400,"False",373,309,431,122,122,1
"C04TL",413,133,"1200x900",600,1,600,400,"False",345,551,619,68,68,0
"C04TL",414,326,"1200x900",800,1,600,400,"False",103,482,593,111,111,0
"C04TL",415,168,"1200x900",600,2,600,400,"False",1001,439,575,136,136,0
"C04TL",416,416,"1200x900",800,2,600,400,"False",748,617,510,-107,107,0
"C04TL",417,401,"1200x900",800,2,600,400,"True",821,260,297,37,37,0
"C04TL",418,121,"1200x900",600,1,600,400,"True",884,364,389,25,25,0
"C04TL",419,143,"1200x900",600,1,600,400,"False",479,284,378,94,94,1
"C04TL",420,65,"1200x900",600,0,600,400,"False",442,645,461,-184,184,1
"C04TL",421,625,"1200x900",1000,2,600,400,"True",279,228,247,19,19,0
"C04TL",422,317,"1200x900",800,1,600,400,"False",185,564,814,250,250,0
"C04TL",423,78,"1200x900",600,1,600,400,"True",885,684,630,-54,54,0
"C04TL",424,344,"1200x900",800,1,600,400,"False",589,408,319,-89,89,0
"C04TL",425,581,"1200x900",1000,2,600,400,"True",310,357,347,-10,10,0
"C04TL",427,434,"1200x900",1000,0,600,400,"False",89,657,520,-137,137,1
"C04TL",428,624,"1200x900",1000,2,600,400,"False",693,501,680,179,179,0
"C04TL",429,540,"1200x900",1000,1,600,400,"False",389,568,281,-287,287,1
"C04TL",430,306,"1200x900",800,1,600,400,"False",164,524,705,181,181,0
"C04TL",431,632,"1200x900",1000,2,600,400,"False",984,227,635,408,408,0
"C04TL",432,151,"1200x900",600,2,600,400,"True",828,680,669,-11,11,0
"C04TL",433,380,"1200x900",800,2,600,400,"False",942,228,358,130,130,0
"C04TL",434,68,"1200x900",600,0,600,400,"True",165,367,306,-61,61,0
"C04TL",435,208,"1200x900",600,2,600,400,"True",946,399,332,-67,67,0
"C04TL",436,569,"1200x900",1000,1,600,400,"False",494,720,396,-324,324,0
"C04TL",437,392,"1200x900",800,2,600,400,"True",1031,618,623,5,5,0
"C04TL",438,95,"1200x900",600,1,600,400,"True",749,425,435,10,10,1
"C04TL",439,161,"1200x900",600,2,600,400,"True",939,553,463,-90,90,0
"C04TL",440,253,"1200x900",800,0,600,400,"True",177,424,443,19,19,1
"C04TL",441,67,"1200x900",600,0,600,400,"True",289,308,309,1,1,1
"C04TL",442,406,"1200x900",800,2,600,400,"True",971,233,378,145,145,0
"C04TL",443,22,"1200x900",600,0,600,400,"True",398,591,559,-32,32,1
"C04TL",444,258,"1200x900",800,0,600,400,"False",126,664,558,-106,106,1
"C04TL",445,577,"1200x900",1000,2,600,400,"True",455,420,464,44,44,0
"C04TL",446,191,"1200x900",600,2,600,400,"False",962,396,643,247,247,0
"C04TL",447,499,"1200x900",1000,0,600,400,"True",93,271,340,69,69,1
"C04TL",448,517,"1200x900",1000,1,600,400,"False",548,182,360,178,178,0
"C04TL",449,170,"1200x900",600,2,600,400,"False",996,468,397,-71,71,0
"C04TL",450,137,"1200x900",600,1,600,400,"True",789,577,580,3,3,0
"C04TL",451,485,"1200x900",1000,0,600,400,"True",121,694,676,-18,18,1
"C04TL",452,298,"1200x900",800,1,600,400,"False",311,457,615,158,158,0
"C04TL",453,371,"1200x900",800,2,600,400,"True",730,560,574,14,14,0
"C04TL",454,405,"1200x900",800,2,600,400,"False",790,307,482,175,175,0
"C04TL",455,324,"1200x900",800,1,600,400,"False",719,712,441,-271,271,1
"C04TL",456,513,"1200x900",1000,1,600,400,"False",235,602,270,-332,332,0
"C04TL",457,64,"1200x900",600,0,600,400,"True",102,339,389,50,50,0
"C04TL",458,547,"1200x900",1000,1,600,400,"True",369,384,374,-10,10,1
"C04TL",459,322,"1200x900",800,1,600,400,"True",703,206,268,62,62,1
"C04TL",460,544,"1200x900",1000,1,600,400,"False",602,620,394,-226,226,0
"C04TL",461,220,"1200x900",800,0,600,400,"True",108,699,666,-33,33,1
"C04TL",462,19,"1200x900",600,0,600,400,"True",286,686,672,-14,14,0
"C04TL",463,519,"1200x900",1000,1,600,400,"True",319,565,550,-15,15,1
"C04TL",465,266,"1200x900",800,0,600,400,"False",126,303,411,108,108,1
"C04TL",466,383,"1200x900",800,2,600,400,"True",855,407,378,-29,29,0
"C04TL",467,560,"1200x900",1000,1,600,400,"True",516,693,650,-43,43,0
"C04TL",468,176,"1200x900",600,2,600,400,"False",1033,281,508,227,227,0
"C04TL",469,369,"1200x900",800,2,600,400,"False",903,594,665,71,71,0
"C04TL",470,141,"1200x900",600,1,600,400,"False",671,582,413,-169,169,0
"C04TL",471,164,"1200x900",600,2,600,400,"False",1051,268,114,-154,154,0
"C04TL",472,271,"1200x900",800,0,600,400,"True",74,360,330,-30,30,1
"C04TL",473,163,"1200x900",600,2,600,400,"True",1046,665,655,-10,10,0
"C04TL",474,418,"1200x900",800,2,600,400,"True",754,507,522,15,15,0
"C04TL",475,124,"1200x900",600,1,600,400,"False",345,467,281,-186,186,0
"C04TL",476,363,"1200x900",800,2,600,400,"False",800,218,362,144,144,0
"C04TL",477,484,"1200x900",1000,0,600,400,"False",100,223,61,-162,162,1
"C04TL",478,472,"1200x900",1000,0,600,400,"False",77,685,531,-154,154,1
"C04TL",479,177,"1200x900",600,2,600,400,"True",912,236,244,8,8,0
"C04TL",480,115,"1200x900",600,1,600,400,"False",545,307,208,-99,99,0
"C04TL",481,236,"1200x900",800,0,600,400,"False",162,350,520,170,170,1
"C04TL",482,309,"1200x900",800,1,600,400,"False",186,225,393,168,168,0
"C04TL",483,429,"1200x900",800,2,600,400,"True",682,692,665,-27,27,0
"C04TL",484,50,"1200x900",600,0,600,400,"True",75,582,582,0,0,0
"C04TL",485,626,"1200x900",1000,2,600,400,"False",329,449,543,94,94,0
"C04TL",486,226,"1200x900",800,0,600,400,"True",187,229,287,58,58,1
"C04TL",487,337,"1200x900",800,1,600,400,"False",299,622,475,-147,147,0
"C04TL",488,314,"1200x900",800,1,600,400,"True",277,616,593,-23,23,1
"C04TL",489,172,"1200x900",600,2,600,400,"True",912,444,451,7,7,0
"C04TL",490,307,"1200x900",800,1,600,400,"True",716,247,271,24,24,0
"C04TL",491,646,"1200x900",1000,2,600,400,"True",829,227,304,77,77,1
"C04TL",492,17,"1200x900",600,0,600,400,"False",402,496,408,-88,88,1
"C04TL",493,24,"1200x900",600,0,600,400,"False",430,538,453,-85,85,1
"C04TL",495,393,"1200x900",800,2,600,400,"False",657,620,307,-313,313,0
"C04TL",496,386,"1200x900",800,2,600,400,"False",774,301,184,-117,117,0
"C04TL",497,579,"1200x900",1000,2,600,400,"False",803,394,577,183,183,0
"C04TL",498,257,"1200x900",800,0,600,400,"False",97,219,300,81,81,1
"C04TL",500,260,"1200x900",800,0,600,400,"True",103,525,566,41,41,1
"C04TL",501,628,"1200x900",1000,2,600,400,"True",768,410,361,-49,49,0
"C04TL",502,315,"1200x900",800,1,600,400,"True",105,211,160,-51,51,0
"C04TL",503,136,"1200x900",600,1,600,400,"True",264,205,220,15,15,0
"C04TL",504,158,"1200x900",600,2,600,400,"False",939,300,211,-89,89,0
"C04TL",505,368,"1200x900",800,2,600,400,"False",778,515,323,-192,192,0
"C04TL",506,373,"1200x900",800,2,600,400,"False",694,326,562,236,236,0
"C04TL",507,93,"1200x900",600,1,600,400,"False",139,540,310,-230,230,0
"C04TL",508,509,"1200x900",1000,1,600,400,"True",509,434,495,61,61,0
"C04TL",509,591,"1200x900",1000,2,600,400,"True",698,336,477,141,141,0
"C04TL",510,157,"1200x900",600,2,600,400,"True",1016,323,266,-57,57,0
"C04TL",511,451,"1200x900",1000,0,600,400,"False",110,702,468,-234,234,1
"C04TL",512,89,"1200x900",600,1,600,400,"False",917,366,510,144,144,1
"C04TL",513,18,"1200x900",600,0,600,400,"True",400,318,379,61,61,1
"C04TL",514,241,"1200x900",800,0,600,400,"True",129,227,270,43,43,1
"C04TL",515,293,"1200x900",800,1,600,400,"True",561,396,411,15,15,0
"C04TL",516,214,"1200x900",600,2,600,400,"False",1046,305,201,-104,104,0
"C04TL",517,102,"1200x900",600,1,600,400,"False",861,603,531,-72,72,0
"C04TL",518,574,"1200x900",1000,1,600,400,"False",614,194,360,166,166,0
"C04TL",519,207,"1200x900",600,2,600,400,"False",838,235,545,310,310,0
"C04TL",520,372,"1200x900",800,2,600,400,"False",833,620,420,-200,200,0
"C04TL",521,242,"1200x900",800,0,600,400,"True",117,448,434,-14,14,1
"C04TL",522,72,"1200x900",600,0,600,400,"True",158,537,524,-13,13,0
"C04TL",523,218,"1200x900",800,0,600,400,"True",106,397,460,63,63,1
"C04TL",524,595,"1200x900",1000,2,600,400,"False",687,640,364,-276,276,0
"C04TL",525,556,"1200x900",1000,1,600,400,"True",415,420,380,-40,40,0
"C04TL",526,431,"1200x900",800,2,600,400,"False",694,382,147,-235,235,0
"C04TL",527,538,"1200x900",1000,1,600,400,"True",308,457,451,-6,6,1
"C04TL",528,531,"1200x900",1000,1,600,400,"False",233,362,485,123,123,0
"C04TL",529,305,"1200x900",800,1,600,400,"True",471,716,736,20,20,0
"C04TL",530,70,"1200x900",600,0,600,400,"True",309,703,668,-35,35,1
"C04TL",531,476,"1200x900",1000,0,600,400,"False",76,359,492,133,133,1
"C04TL",532,397,"1200x900",800,2,600,400,"False",817,692,525,-167,167,0
"C04TL",533,491,"1200x900",1000,0,600,400,"False",108,198,523,325,325,1
"C04TL",534,370,"1200x900",800,2,600,400,"True",874,336,376,40,40,0
"C04TL",535,312,"1200x900",800,1,600,400,"False",238,683,572,-111,111,0
"C04TL",536,482,"1200x900",1000,0,600,400,"False",79,686,617,-69,69,1
"C04TL",537,452,"1200x900",1000,0,600,400,"False",97,273,364,91,91,1
"C04TL",538,441,"1200x900",1000,0,600,400,"False",85,684,563,-121,121,1
"C04TL",539,185,"1200x900",600,2,600,400,"False",907,212,318,106,106,0
"C04TL",540,329,"1200x900",800,1,600,400,"False",517,239,412,173,173,0
"C04TL",541,299,"1200x900",800,1,600,400,"True",779,274,278,4,4,0
"C04TL",542,627,"1200x900",1000,2,600,400,"True",760,510,482,-28,28,0
"C04TL",543,3,"1200x900",600,0,600,400,"True",298,443,413,-30,30,1
"C04TL",545,474,"1200x900",1000,0,600,400,"True",85,339,271,-68,68,1
"C04TL",546,629,"1200x900",1000,2,600,400,"False",681,257,437,180,180,0
"C04TL",547,486,"1200x900",1000,0,600,400,"False",102,676,496,-180,180,1
"C04TL",548,426,"1200x900",800,2,600,400,"True",830,263,418,155,155,0
"C04TL",549,107,"1200x900",600,1,600,400,"False",878,678,614,-64,64,0
"C04TL",550,537,"1200x900",1000,1,600,400,"False",621,412,754,342,342,1
"C04TL",551,44,"1200x900",600,0,600,400,"True",305,554,616,62,62,1
"C04TL",552,475,"1200x900",1000,0,600,400,"True",101,715,689,-26,26,1
"C04TL",553,487,"1200x900",1000,0,600,400,"False",78,670,606,-64,64,1
"C04TL",554,493,"1200x900",1000,0,600,400,"False",80,582,509,-73,73,1
"C04TL",555,500,"1200x900",1000,0,600,400,"False",105,700,544,-156,156,1
"C04TL",556,140,"1200x900",600,1,600,400,"True",700,523,526,3,3,0
"C04TL",557,282,"1200x900",800,0,600,400,"False",109,246,388,142,142,1
"C04TL",558,436,"1200x900",1000,0,600,400,"True",82,617,562,-55,55,1
"C04TL",559,522,"1200x900",1000,1,600,400,"False",223,379,613,234,234,0
"C04TL",560,391,"1200x900",800,2,600,400,"False",895,521,341,-180,180,0
"C04TL",561,495,"1200x900",1000,0,600,400,"False",93,692,582,-110,110,1
"C04TL",562,631,"1200x900",1000,2,600,400,"False",699,479,317,-162,162,0
"C04TL",563,287,"1200x900",800,0,600,400,"False",120,567,461,-106,106,1
"C04TL",564,225,"1200x900",800,0,600,400,"True",178,423,384,-39,39,1
"C04TL",565,567,"1200x900",1000,1,600,400,"False",655,297,86,-211,211,1
"C04TL",566,507,"1200x900",1000,1,600,400,"True",608,583,559,-24,24,1
"C04TL",567,79,"1200x900",600,1,600,400,"False",731,289,120,-169,169,0
"C04TL",568,414,"1200x900",800,2,600,400,"True",831,592,562,-30,30,0
"C04TL",569,430,"1200x900",800,2,600,400,"False",922,254,379,125,125,0
"C04TL",570,37,"1200x900",600,0,600,400,"True",258,403,448,45,45,1
"C04TL",571,73,"1200x900",600,1,600,400,"True",94,665,605,-60,60,0
"C04TL",572,110,"1200x900",600,1,600,400,"True",776,550,488,-62,62,1
"C04TL",573,111,"1200x900",600,1,600,400,"True",922,552,521,-31,31,1
"C04TL",574,98,"1200x900",600,1,600,400,"True",625,530,511,-19,19,0
"C04TL",575,621,"1200x900",1000,2,600,400,"False",540,478,688,210,210,0
"C04TL",576,122,"1200x900",600,1,600,400,"False",817,709,516,-193,193,0
"C04TL",577,384,"1200x900",800,2,600,400,"False",821,707,576,-131,131,0
"C04TL",578,437,"1200x900",1000,0,600,400,"True",74,667,659,-8,8,1
"C04TL",579,603,"1200x900",1000,2,600,400,"True",693,280,266,-14,14,0
"C04TL",580,442,"1200x900",1000,0,600,400,"True",87,183,115,-68,68,1
"C04TL",581,296,"1200x900",800,1,600,400,"False",89,279,219,-60,60,0
"C04TL",582,332,"1200x900",800,1,600,400,"False",260,699,461,-238,238,0
"C04TL",583,2,"1200x900",600,0,600,400,"True",159,323,382,59,59,0
"C04TL",584,552,"1200x900",1000,1,600,400,"False",255,412,644,232,232,0
"C04TL",585,358,"1200x900",800,1,600,400,"False",263,635,348,-287,287,0
"C04TL",586,364,"1200x900",800,2,600,400,"False",1018,204,398,194,194,0
"C04TL",587,14,"1200x900",600,0,600,400,"False",399,224,364,140,140,1
"C04TL",588,456,"1200x900",1000,0,600,400,"False",91,257,336,79,79,1
"C04TL",589,535,"1200x900",1000,1,600,400,"False",372,410,327,-83,83,0
"C04TL",590,16,"1200x900",600,0,600,400,"False",297,514,420,-94,94,1
"C04TL",591,87,"1200x900",600,1,600,400,"False",231,604,490,-114,114,0
"C04TL",592,463,"1200x900",1000,0,600,400,"False",115,693,612,-81,81,1
"C04TL",593,465,"1200x900",1000,0,600,400,"False",85,203,388,185,185,1
"C04TL",594,276,"1200x900",800,0,600,400,"False",281,217,302,85,85,1
"C04TL",595,618,"1200x900",1000,2,600,400,"True",276,671,655,-16,16,0
"C04TL",596,80,"1200x900",600,1,600,400,"False",616,423,607,184,184,1
"C04TL",597,248,"1200x900",800,0,600,400,"False",94,240,401,161,161,1
"C04TL",599,573,"1200x900",1000,1,600,400,"False",486,615,539,-76,76,0
"C04TL",601,489,"1200x900",1000,0,600,400,"True",88,604,620,16,16,1
"C04TL",602,494,"1200x900",1000,0,600,400,"True",127,692,640,-52,52,1
"C04TL",603,31,"1200x900",600,0,600,400,"True",365,338,404,66,66,1
"C04TL",604,320,"1200x900",800,1,600,400,"True",644,376,335,-41,41,0
"C04TL",605,578,"1200x900",1000,2,600,400,"False",966,276,643,367,367,0
"C04TL",606,209,"1200x900",600,2,600,400,"True",937,637,548,-89,89,0
"C04TL",607,197,"1200x900",600,2,600,400,"False",903,212,596,384,384,0
"C04TL",608,116,"1200x900",600,1,600,400,"True",767,289,394,105,105,0
"C04TL",609,183,"1200x900",600,2,600,400,"False",927,289,404,115,115,0
"C04TL",610,264,"1200x900",800,0,600,400,"False",198,660,587,-73,73,1
"C04TL",611,446,"1200x900",1000,0,600,400,"False",72,298,389,91,91,1
"C04TL",612,7,"1200x900",600,0,600,400,"False",431,654,561,-93,93,1
"C04TL",613,354,"1200x900",800,1,600,400,"False",118,236,354,118,118,0
"C04TL",614,614,"1200x900",1000,2,600,400,"False",823,563,403,-160,160,0
"C04TL",615,9,"1200x900",600,0,600,400,"True",509,654,612,-42,42,1
"C04TL",616,84,"1200x900",600,1,600,400,"True",144,184,257,73,73,0
"C04TL",617,243,"1200x900",800,0,600,400,"True",114,332,276,-56,56,1
"C04TL",618,634,"1200x900",1000,2,600,400,"False",735,313,189,-124,124,0
"C04TL",619,86,"1200x900",600,1,600,400,"False",692,388,297,-91,91,1
"C04TL",620,127,"1200x900",600,1,600,400,"True",309,691,609,-82,82,0
"C04TL",621,503,"1200x900",1000,0,600,400,"False",86,279,460,181,181,1
"C04TL",622,399,"1200x900",800,2,600,400,"True",603,602,523,-79,79,0
"C04TL",623,142,"1200x900",600,1,600,400,"False",286,474,617,143,143,0
"C04TL",624,617,"1200x900",1000,2,600,400,"False",294,180,673,493,493,0
"C04TL",625,409,"1200x900",800,2,600,400,"True",501,659,686,27,27,0
"C04TL",626,505,"1200x900",1000,1,600,400,"True",191,484,498,14,14,1
"C04TL",627,128,"1200x900",600,1,600,400,"True",661,258,241,-17,17,1
"C04TL",628,597,"1200x900",1000,2,600,400,"True",352,239,299,60,60,0
"C04TL",629,56,"1200x900",600,0,600,400,"False",148,491,379,-112,112,0
"C04TL",630,256,"1200x900",800,0,600,400,"True",192,656,680,24,24,1
"C04TL",631,559,"1200x900",1000,1,600,400,"False",641,244,361,117,117,0
"C04TL",632,62,"1200x900",600,0,600,400,"True",345,346,360,14,14,1
"C04TL",634,34,"1200x900",600,0,600,400,"True",361,242,262,20,20,1
"C04TL",635,156,"1200x900",600,2,600,400,"False",913,197,311,114,114,0
"C04TL",636,377,"1200x900",800,2,600,400,"True",683,388,358,-30,30,0
"C04TL",637,330,"1200x900",800,1,600,400,"False",759,301,164,-137,137,1
"C04TL",638,376,"1200x900",800,2,600,400,"True",788,275,256,-19,19,0
"C04TL",640,278,"1200x900",800,0,600,400,"True",251,711,709,-2,2,1
"C04TL",641,217,"1200x900",800,0,600,400,"True",85,573,535,-38,38,1
"C04TL",642,492,"1200x900",1000,0,600,400,"True",76,692,649,-43,43,1
"C04TL",643,58,"1200x900",600,0,600,400,"True",353,655,722,67,67,1
"C04TL",644,291,"1200x900",800,1,600,400,"False",522,694,594,-100,100,0
"C04TL",645,412,"1200x900",800,2,600,400,"False",842,280,189,-91,91,0
"C04TL",646,609,"1200x900",1000,2,600,400,"False",697,627,355,-272,272,0
"C04TL",647,562,"1200x900",1000,1,600,400,"True",347,540,512,-28,28,0
"C04TL",648,557,"1200x900",1000,1,600,400,"False",677,505,687,182,182,1
"C05GY",1,529,"1200x900",1000,1,600,400,"False",267,412,562,150,150,1
"C05GY",2,121,"1200x900",600,1,600,400,"False",884,364,455,91,91,0
"C05GY",3,13,"1200x900",600,0,600,400,"True",296,211,163,-48,48,1
"C05GY",4,492,"1200x900",1000,0,600,400,"True",76,692,767,75,75,1
"C05GY",5,22,"1200x900",600,0,600,400,"True",398,591,568,-23,23,1
"C05GY",6,140,"1200x900",600,1,600,400,"True",700,523,529,6,6,0
"C05GY",7,206,"1200x900",600,2,600,400,"False",975,223,133,-90,90,0
"C05GY",8,196,"1200x900",600,2,600,400,"False",1030,397,231,-166,166,0
"C05GY",9,607,"1200x900",1000,2,600,400,"False",900,573,630,57,57,1
"C05GY",10,187,"1200x900",600,2,600,400,"False",857,639,453,-186,186,0
"C05GY",11,153,"1200x900",600,2,600,400,"False",1037,601,741,140,140,0
"C05GY",12,645,"1200x900",1000,2,600,400,"False",619,396,575,179,179,0
"C05GY",13,191,"1200x900",600,2,600,400,"False",962,396,283,-113,113,0
"C05GY",14,40,"1200x900",600,0,600,400,"True",143,513,540,27,27,0
"C05GY",15,618,"1200x900",1000,2,600,400,"False",276,671,523,-148,148,0
"C05GY",16,76,"1200x900",600,1,600,400,"False",647,614,678,64,64,0
"C05GY",17,357,"1200x900",800,1,600,400,"False",109,594,501,-93,93,0
"C05GY",18,260,"1200x900",800,0,600,400,"True",103,525,521,-4,4,1
"C05GY",19,190,"1200x900",600,2,600,400,"True",977,238,250,12,12,0
"C05GY",20,555,"1200x900",1000,1,600,400,"False",444,556,690,134,134,0
"C05GY",21,240,"1200x900",800,0,600,400,"True",330,656,641,-15,15,1
"C05GY",22,348,"1200x900",800,1,600,400,"True",764,294,318,24,24,0
"C05GY",23,305,"1200x900",800,1,600,400,"True",471,716,742,26,26,0
"C05GY",24,624,"1200x900",1000,2,600,400,"False",693,501,293,-208,208,0
"C05GY",25,619,"1200x900",1000,2,600,400,"False",803,247,378,131,131,0
"C05GY",26,81,"1200x900",600,1,600,400,"True",696,225,240,15,15,0
"C05GY",27,444,"1200x900",1000,0,600,400,"True",101,714,655,-59,59,1
"C05GY",28,205,"1200x900",600,2,600,400,"False",1021,504,677,173,173,0
"C05GY",29,164,"1200x900",600,2,600,400,"True",1051,268,286,18,18,0
"C05GY",30,366,"1200x900",800,2,600,400,"True",931,464,244,-220,220,0
"C05GY",31,582,"1200x900",1000,2,600,400,"True",554,347,355,8,8,0
"C05GY",32,43,"1200x900",600,0,600,400,"False",277,446,371,-75,75,1
"C05GY",33,367,"1200x900",800,2,600,400,"False",613,464,251,-213,213,0
"C05GY",34,275,"1200x900",800,0,600,400,"False",120,594,504,-90,90,0
"C05GY",35,301,"1200x900",800,1,600,400,"True",162,574,507,-67,67,0
"C05GY",36,374,"1200x900",800,2,600,400,"True",755,450,503,53,53,0
"C05GY",37,553,"1200x900",1000,1,600,400,"False",116,712,420,-292,292,0
"C05GY",38,635,"1200x900",1000,2,600,400,"True",833,402,178,-224,224,0
"C05GY",39,93,"1200x900",600,1,600,400,"True",139,540,484,-56,56,0
"C05GY",40,595,"1200x900",1000,2,600,400,"False",687,640,407,-233,233,0
"C05GY",41,101,"1200x900",600,1,600,400,"True",541,656,685,29,29,0
"C05GY",42,620,"1200x900",1000,2,600,400,"False",832,649,461,-188,188,0
"C05GY",43,298,"1200x900",800,1,600,400,"True",311,457,494,37,37,0
"C05GY",44,432,"1200x900",800,2,600,400,"True",792,380,379,-1,1,0
"C05GY",45,423,"1200x900",800,2,600,400,"False",1051,710,592,-118,118,1
"C05GY",46,457,"1200x900",1000,0,600,400,"True",97,630,683,53,53,1
"C05GY",47,8,"1200x900",600,0,600,400,"True",156,679,718,39,39,0
"C05GY",48,32,"1200x900",600,0,600,400,"True",152,563,570,7,7,1
"C05GY",49,146,"1200x900",600,2,600,400,"True",989,492,187,-305,305,0
"C05GY",50,230,"1200x900",800,0,600,400,"False",99,678,609,-69,69,1
"C05GY",51,169,"1200x900",600,2,600,400,"True",924,290,327,37,37,0
"C05GY",52,249,"1200x900",800,0,600,400,"False",126,306,378,72,72,1
"C05GY",53,464,"1200x900",1000,0,600,400,"False",82,222,287,65,65,1
"C05GY",54,568,"1200x900",1000,1,600,400,"True",286,475,485,10,10,1
"C05GY",55,66,"1200x900",600,0,600,400,"False",155,673,746,73,73,0
"C05GY",56,647,"1200x900",1000,2,600,400,"True",560,637,653,16,16,0
"C05GY",57,545,"1200x900",1000,1,600,400,"True",358,562,562,0,0,0
"C05GY",58,16,"1200x900",600,0,600,400,"True",297,514,549,35,35,1
"C05GY",59,495,"1200x900",1000,0,600,400,"True",93,692,710,18,18,1
"C05GY",60,401,"1200x900",800,2,600,400,"True",821,260,207,-53,53,0
"C05GY",61,350,"1200x900",800,1,600,400,"False",182,566,390,-176,176,0
"C05GY",62,291,"1200x900",800,1,600,400,"False",522,694,812,118,118,0
"C05GY",63,149,"1200x900",600,2,600,400,"True",890,289,235,-54,54,0
"C05GY",64,646,"1200x900",1000,2,600,400,"False",829,227,480,253,253,1
"C05GY",65,585,"1200x900",1000,2,600,400,"True",698,688,221,-467,467,1
"C05GY",66,551,"1200x900",1000,1,600,400,"True",146,445,242,-203,203,1
"C05GY",67,468,"1200x900",1000,0,600,400,"True",121,219,260,41,41,1
"C05GY",68,575,"1200x900",1000,1,600,400,"True",272,693,626,-67,67,0
"C05GY",69,85,"1200x900",600,1,600,400,"False",434,347,477,130,130,0
"C05GY",70,610,"1200x900",1000,2,600,400,"True",702,293,322,29,29,0
"C05GY",71,570,"1200x900",1000,1,600,400,"True",315,352,354,2,2,0
"C05GY",72,5,"1200x900",600,0,600,400,"True",228,587,580,-7,7,0
"C05GY",73,220,"1200x900",800,0,600,400,"True",108,699,654,-45,45,1
"C05GY",74,642,"1200x900",1000,2,600,400,"False",776,316,123,-193,193,0
"C05GY",75,98,"1200x900",600,1,600,400,"True",625,530,538,8,8,0
"C05GY",76,451,"1200x900",1000,0,600,400,"True",110,702,652,-50,50,1
"C05GY",77,567,"1200x900",1000,1,600,400,"False",655,297,100,-197,197,1
"C05GY",78,158,"1200x900",600,2,600,400,"False",939,300,554,254,254,0
"C05GY",79,556,"1200x900",1000,1,600,400,"False",415,420,571,151,151,0
"C05GY",80,266,"1200x900",800,0,600,400,"True",126,303,333,30,30,1
"C05GY",81,537,"1200x900",1000,1,600,400,"False",621,412,505,93,93,1
"C05GY",82,261,"1200x900",800,0,600,400,"True",86,713,735,22,22,1
"C05GY",83,80,"1200x900",600,1,600,400,"False",616,423,525,102,102,1
"C05GY",84,253,"1200x900",800,0,600,400,"True",177,424,461,37,37,1
"C05GY",85,402,"1200x900",800,2,600,400,"False",878,234,367,133,133,0
"C05GY",86,331,"1200x900",800,1,600,400,"True",240,620,644,24,24,0
"C05GY",87,41,"1200x900",600,0,600,400,"True",370,452,413,-39,39,1
"C05GY",88,643,"1200x900",1000,2,600,400,"True",740,325,370,45,45,0
"C05GY",89,395,"1200x900",800,2,600,400,"True",743,334,330,-4,4,0
"C05GY",90,413,"1200x900",800,2,600,400,"False",849,506,624,118,118,0
"C05GY",91,297,"1200x900",800,1,600,400,"True",625,244,307,63,63,0
"C05GY",92,292,"1200x900",800,1,600,400,"True",88,565,523,-42,42,0
"C05GY",93,262,"1200x900",800,0,600,400,"True",196,481,478,-3,3,1
"C05GY",94,371,"1200x900",800,2,600,400,"False",730,560,474,-86,86,0
"C05GY",95,563,"1200x900",1000,1,600,400,"True",201,696,712,16,16,0
"C05GY",96,133,"1200x900",600,1,600,400,"False",345,551,695,144,144,0
"C05GY",97,588,"1200x900",1000,2,600,400,"True",585,350,320,-30,30,0
"C05GY",98,461,"1200x900",1000,0,600,400,"False",95,711,617,-94,94,1
"C05GY",99,470,"1200x900",1000,0,600,400,"False",91,666,590,-76,76,1
"C05GY",100,370,"1200x900",800,2,600,400,"False",874,336,236,-100,100,0
"C05GY",101,302,"1200x900",800,1,600,400,"False",479,467,571,104,104,1
"C05GY",102,90,"1200x900",600,1,600,400,"False",560,474,284,-190,190,0
"C05GY",103,326,"1200x900",800,1,600,400,"True",103,482,424,-58,58,0
"C05GY",104,338,"1200x900",800,1,600,400,"False",813,253,117,-136,136,1
"C05GY",105,125,"1200x900",600,1,600,400,"True",750,531,513,-18,18,0
"C05GY",106,151,"1200x900",600,2,600,400,"False",828,680,430,-250,250,0
"C05GY",107,433,"1200x900",1000,0,600,400,"True",76,222,281,59,59,1
"C05GY",108,235,"1200x900",800,0,600,400,"False",146,646,519,-127,127,1
"C05GY",109,436,"1200x900",1000,0,600,400,"True",82,617,556,-61,61,1
"C05GY",110,221,"1200x900",800,0,600,400,"True",132,520,517,-3,3,1
"C05GY",111,222,"1200x900",800,0,600,400,"False",152,206,296,90,90,1
"C05GY",112,361,"1200x900",800,2,600,400,"True",931,328,355,27,27,0
"C05GY",113,180,"1200x900",600,2,600,400,"True",929,270,315,45,45,0
"C05GY",114,503,"1200x900",1000,0,600,400,"False",86,279,344,65,65,1
"C05GY",115,328,"1200x900",800,1,600,400,"False",104,649,409,-240,240,0
"C05GY",116,376,"1200x900",800,2,600,400,"True",788,275,323,48,48,0
"C05GY",117,130,"1200x900",600,1,600,400,"True",741,428,416,-12,12,0
"C05GY",118,129,"1200x900",600,1,600,400,"False",859,482,286,-196,196,1
"C05GY",119,564,"1200x900",1000,1,600,400,"False",215,264,355,91,91,0
"C05GY",120,285,"1200x900",800,0,600,400,"False",237,396,302,-94,94,1
"C05GY",121,640,"1200x900",1000,2,600,400,"False",361,334,483,149,149,0
"C05GY",122,304,"1200x900",800,1,600,400,"False",667,605,321,-284,284,0
"C05GY",123,347,"1200x900",800,1,600,400,"True",757,295,274,-21,21,1
"C05GY",124,88,"1200x900",600,1,600,400,"True",186,554,528,-26,26,0
"C05GY",125,573,"1200x900",1000,1,600,400,"True",486,615,630,15,15,0
"C05GY",126,467,"1200x900",1000,0,600,400,"True",74,712,724,12,12,1
"C05GY",127,614,"1200x900",1000,2,600,400,"True",823,563,509,-54,54,0
"C05GY",128,392,"1200x900",800,2,600,400,"True",1031,618,537,-81,81,0
"C05GY",129,142,"1200x900",600,1,600,400,"True",286,474,446,-28,28,0
"C05GY",130,422,"1200x900",800,2,600,400,"False",712,558,379,-179,179,0
"C05GY",131,405,"1200x900",800,2,600,400,"True",790,307,556,249,249,0
"C05GY",132,576,"1200x900",1000,1,600,400,"True",376,713,759,46,46,0
"C05GY",133,245,"1200x900",800,0,600,400,"False",296,235,324,89,89,1
"C05GY",134,70,"1200x900",600,0,600,400,"True",309,703,705,2,2,1
"C05GY",135,411,"1200x900",800,2,600,400,"False",805,361,444,83,83,0
"C05GY",136,604,"1200x900",1000,2,600,400,"True",459,593,624,31,31,0
"C05GY",137,460,"1200x900",1000,0,600,400,"True",155,189,186,-3,3,1
"C05GY",138,600,"1200x900",1000,2,600,400,"False",765,207,529,322,322,0
"C05GY",139,626,"1200x900",1000,2,600,400,"False",329,449,121,-328,328,0
"C05GY",140,201,"1200x900",600,2,600,400,"True",1005,462,422,-40,40,0
"C05GY",141,231,"1200x900",800,0,600,400,"False",251,718,612,-106,106,1
"C05GY",142,94,"1200x900",600,1,600,400,"False",729,482,552,70,70,0
"C05GY",143,403,"1200x900",800,2,600,400,"False",625,704,586,-118,118,0
"C05GY",144,119,"1200x900",600,1,600,400,"True",168,563,602,39,39,0
"C05GY",145,223,"1200x900",800,0,600,400,"True",179,191,178,-13,13,1
"C05GY",146,380,"1200x900",800,2,600,400,"False",942,228,323,95,95,0
"C05GY",147,100,"1200x900",600,1,600,400,"False",453,511,313,-198,198,0
"C05GY",148,48,"1200x900",600,0,600,400,"True",323,645,608,-37,37,1
"C05GY",149,504,"1200x900",1000,0,600,400,"False",107,699,596,-103,103,1
"C05GY",150,136,"1200x900",600,1,600,400,"True",264,205,166,-39,39,0
"C05GY",151,179,"1200x900",600,2,600,400,"False",908,602,850,248,248,0
"C05GY",152,296,"1200x900",800,1,600,400,"False",89,279,407,128,128,0
"C05GY",153,244,"1200x900",800,0,600,400,"True",194,203,260,57,57,1
"C05GY",154,407,"1200x900",800,2,600,400,"False",989,340,271,-69,69,0
"C05GY",155,82,"1200x900",600,1,600,400,"False",108,213,359,146,146,0
"C05GY",156,424,"1200x900",800,2,600,400,"False",903,545,724,179,179,0
"C05GY",157,274,"1200x900",800,0,600,400,"False",146,497,611,114,114,1
"C05GY",158,300,"1200x900",800,1,600,400,"True",620,693,709,16,16,0
"C05GY",159,135,"1200x900",600,1,600,400,"True",759,569,599,30,30,0
"C05GY",160,384,"1200x900",800,2,600,400,"False",821,707,518,-189,189,0
"C05GY",161,308,"1200x900",800,1,600,400,"True",437,425,447,22,22,0
"C05GY",162,60,"1200x900",600,0,600,400,"False",365,213,324,111,111,1
"C05GY",163,569,"1200x900",1000,1,600,400,"False",494,720,377,-343,343,0
"C05GY",164,447,"1200x900",1000,0,600,400,"True",71,339,354,15,15,1
"C05GY",165,3,"1200x900",600,0,600,400,"True",298,443,471,28,28,1
"C05GY",166,51,"1200x900",600,0,600,400,"True",272,181,195,14,14,1
"C05GY",167,475,"1200x900",1000,0,600,400,"True",101,715,656,-59,59,1
"C05GY",168,316,"1200x900",800,1,600,400,"False",362,319,476,157,157,0
"C05GY",169,507,"1200x900",1000,1,600,400,"True",608,583,607,24,24,1
"C05GY",170,332,"1200x900",800,1,600,400,"False",260,699,579,-120,120,0
"C05GY",171,108,"1200x900",600,1,600,400,"False",830,239,321,82,82,0
"C05GY",172,580,"1200x900",1000,2,600,400,"False",651,267,190,-77,77,0
"C05GY",173,454,"1200x900",1000,0,600,400,"True",78,687,681,-6,6,1
"C05GY",174,364,"1200x900",800,2,600,400,"False",1018,204,342,138,138,0
"C05GY",175,203,"1200x900",600,2,600,400,"True",938,603,650,47,47,0
"C05GY",176,489,"1200x900",1000,0,600,400,"True",88,604,605,1,1,1
"C05GY",177,622,"1200x900",1000,2,600,400,"False",307,683,523,-160,160,0
"C05GY",178,491,"1200x900",1000,0,600,400,"False",108,198,412,214,214,1
"C05GY",179,452,"1200x900",1000,0,600,400,"True",97,273,300,27,27,1
"C05GY",180,539,"1200x900",1000,1,600,400,"True",510,383,378,-5,5,0
"C05GY",181,156,"1200x900",600,2,600,400,"False",913,197,356,159,159,0
"C05GY",182,352,"1200x900",800,1,600,400,"False",235,717,562,-155,155,0
"C05GY",183,148,"1200x900",600,2,600,400,"False",907,330,268,-62,62,0
"C05GY",184,264,"1200x900",800,0,600,400,"False",198,660,576,-84,84,1
"C05GY",185,21,"1200x900",600,0,600,400,"True",314,383,413,30,30,1
"C05GY",186,459,"1200x900",1000,0,600,400,"True",70,645,649,4,4,1
"C05GY",187,386,"1200x900",800,2,600,400,"True",774,301,350,49,49,0
"C05GY",188,155,"1200x900",600,2,600,400,"True",940,269,259,-10,10,0
"C05GY",189,634,"1200x900",1000,2,600,400,"True",735,313,334,21,21,0
"C05GY",190,113,"1200x900",600,1,600,400,"True",897,657,615,-42,42,0
"C05GY",191,561,"1200x900",1000,1,600,400,"False",231,406,577,171,171,0
"C05GY",192,420,"1200x900",800,2,600,400,"False",519,223,344,121,121,0
"C05GY",193,166,"1200x900",600,2,600,400,"True",896,274,320,46,46,0
"C05GY",194,519,"1200x900",1000,1,600,400,"True",319,565,514,-51,51,1
"C05GY",195,463,"1200x900",1000,0,600,400,"True",115,693,656,-37,37,1
"C05GY",196,123,"1200x900",600,1,600,400,"False",761,365,268,-97,97,1
"C05GY",197,307,"1200x900",800,1,600,400,"True",716,247,273,26,26,0
"C05GY",198,250,"1200x900",800,0,600,400,"True",290,248,272,24,24,1
"C05GY",199,20,"1200x900",600,0,600,400,"True",204,545,546,1,1,1
"C05GY",200,552,"1200x900",1000,1,600,400,"False",255,412,596,184,184,0
"C05GY",201,246,"1200x900",800,0,600,400,"False",196,418,492,74,74,1
"C05GY",202,484,"1200x900",1000,0,600,400,"False",100,223,353,130,130,1
"C05GY",203,29,"1200x900",600,0,600,400,"False",385,533,451,-82,82,1
"C05GY",204,554,"1200x900",1000,1,600,400,"False",79,309,82,-227,227,1
"C05GY",205,62,"1200x900",600,0,600,400,"True",345,346,328,-18,18,1
"C05GY",206,58,"1200x900",600,0,600,400,"False",353,655,567,-88,88,1
"C05GY",207,363,"1200x900",800,2,600,400,"False",800,218,310,92,92,0
"C05GY",208,241,"1200x900",800,0,600,400,"True",129,227,174,-53,53,1
"C05GY",209,523,"1200x900",1000,1,600,400,"False",339,318,235,-83,83,0
"C05GY",210,195,"1200x900",600,2,600,400,"True",942,249,244,-5,5,0
"C05GY",211,84,"1200x900",600,1,600,400,"False",144,184,58,-126,126,0
"C05GY",212,42,"1200x900",600,0,600,400,"True",233,479,419,-60,60,0
"C05GY",213,47,"1200x900",600,0,600,400,"True",303,499,491,-8,8,1
"C05GY",214,394,"1200x900",800,2,600,400,"False",847,292,557,265,265,0
"C05GY",215,438,"1200x900",1000,0,600,400,"True",77,713,702,-11,11,1
"C05GY",216,72,"1200x900",600,0,600,400,"True",158,537,577,40,40,0
"C05GY",217,340,"1200x900",800,1,600,400,"False",226,240,477,237,237,0
"C05GY",218,455,"1200x900",1000,0,600,400,"True",107,718,710,-8,8,1
"C05GY",219,644,"1200x900",1000,2,600,400,"True",495,486,472,-14,14,0
"C05GY",220,602,"1200x900",1000,2,600,400,"False",865,452,337,-115,115,0
"C05GY",221,469,"1200x900",1000,0,600,400,"False",73,227,316,89,89,1
"C05GY",222,243,"1200x900",800,0,600,400,"True",114,332,373,41,41,1
"C05GY",223,257,"1200x900",800,0,600,400,"False",97,219,284,65,65,1
"C05GY",224,486,"1200x900",1000,0,600,400,"False",102,676,504,-172,172,1
"C05GY",225,265,"1200x900",800,0,600,400,"False",229,353,434,81,81,1
"C05GY",226,36,"1200x900",600,0,600,400,"True",128,346,413,67,67,1
"C05GY",227,228,"1200x900",800,0,600,400,"True",174,687,705,18,18,1
"C05GY",228,478,"1200x900",1000,0,600,400,"True",79,672,670,-2,2,1
"C05GY",229,27,"1200x900",600,0,600,400,"True",373,309,333,24,24,1
"C05GY",230,434,"1200x900",1000,0,600,400,"False",89,657,543,-114,114,1
"C05GY",231,287,"1200x900",800,0,600,400,"True",120,567,582,15,15,1
"C05GY",232,178,"1200x900",600,2,600,400,"False",1041,510,600,90,90,0
"C05GY",233,284,"1200x900",800,0,600,400,"True",135,293,353,60,60,1
"C05GY",234,116,"1200x900",600,1,600,400,"False",767,289,168,-121,121,0
"C05GY",235,365,"1200x900",800,2,600,400,"False",1055,305,517,212,212,0
"C05GY",236,450,"1200x900",1000,0,600,400,"True",130,204,240,36,36,1
"C05GY",237,445,"1200x900",1000,0,600,400,"True",78,302,332,30,30,1
"C05GY",238,416,"1200x900",800,2,600,400,"False",748,617,408,-209,209,0
"C05GY",239,360,"1200x900",800,1,600,400,"True",203,608,587,-21,21,0
"C05GY",240,25,"1200x900",600,0,600,400,"True",263,403,437,34,34,1
"C05GY",241,532,"1200x900",1000,1,600,400,"True",215,207,271,64,64,0
"C05GY",242,415,"1200x900",800,2,600,400,"True",823,684,593,-91,91,0
"C05GY",243,474,"1200x900",1000,0,600,400,"True",85,339,333,-6,6,1
"C05GY",244,526,"1200x900",1000,1,600,400,"True",497,710,712,2,2,0
"C05GY",245,479,"1200x900",1000,0,600,400,"True",74,705,724,19,19,1
"C05GY",246,162,"1200x900",600,2,600,400,"True",849,279,352,73,73,0
"C05GY",247,615,"1200x900",1000,2,600,400,"True",736,634,599,-35,35,0
"C05GY",248,516,"1200x900",1000,1,600,400,"False",440,559,636,77,77,0
"C05GY",249,583,"1200x900",1000,2,600,400,"True",949,284,850,566,566,1
"C05GY",250,586,"1200x900",1000,2,600,400,"True",802,262,252,-10,10,0
"C05GY",251,456,"1200x900",1000,0,600,400,"True",91,257,293,36,36,1
"C05GY",252,440,"1200x900",1000,0,600,400,"False",71,237,309,72,72,1
"C05GY",253,170,"1200x900",600,2,600,400,"False",996,468,203,-265,265,0
"C05GY",254,323,"1200x900",800,1,600,400,"False",388,348,549,201,201,0
"C05GY",255,99,"1200x900",600,1,600,400,"True",811,407,473,66,66,0
"C05GY",256,490,"1200x900",1000,0,600,400,"False",114,183,323,140,140,1
"C05GY",257,87,"1200x900",600,1,600,400,"False",231,604,480,-124,124,0
"C05GY",258,501,"1200x900",1000,0,600,400,"False",96,323,433,110,110,1
"C05GY",259,598,"1200x900",1000,2,600,400,"False",706,559,288,-271,271,0
"C05GY",260,111,"1200x900",600,1,600,400,"True",922,552,628,76,76,1
"C05GY",261,208,"1200x900",600,2,600,400,"False",946,399,563,164,164,0
"C05GY",262,173,"1200x900",600,2,600,400,"True",948,693,744,51,51,0
"C05GY",263,427,"1200x900",800,2,600,400,"False",812,380,471,91,91,0
"C05GY",264,114,"1200x900",600,1,600,400,"True",183,697,664,-33,33,0
"C05GY",265,429,"1200x900",800,2,600,400,"True",682,692,641,-51,51,0
"C05GY",266,137,"1200x900",600,1,600,400,"True",789,577,597,20,20,0
"C05GY",267,55,"1200x900",600,0,600,400,"True",211,305,339,34,34,1
"C05GY",268,512,"1200x900",1000,1,600,400,"True",139,261,208,-53,53,0
"C05GY",269,176,"1200x900",600,2,600,400,"False",1033,281,220,-61,61,0
"C05GY",270,550,"1200x900",1000,1,600,400,"True",301,459,452,-7,7,0
"C05GY",271,393,"1200x900",800,2,600,400,"False",657,620,346,-274,274,0
"C05GY",272,145,"1200x900",600,2,600,400,"False",1004,630,732,102,102,0
"C05GY",273,33,"1200x900",600,0,600,400,"True",198,533,592,59,59,1
"C05GY",274,354,"1200x900",800,1,600,400,"False",118,236,407,171,171,0
"C05GY",275,611,"1200x900",1000,2,600,400,"False",414,511,330,-181,181,0
"C05GY",276,122,"1200x900",600,1,600,400,"True",817,709,662,-47,47,0
"C05GY",277,511,"1200x900",1000,1,600,400,"False",408,390,276,-114,114,1
"C05GY",278,75,"1200x900",600,1,600,400,"False",635,558,475,-83,83,0
"C05GY",279,163,"1200x900",600,2,600,400,"True",1046,665,631,-34,34,0
"C05GY",280,277,"1200x900",800,0,600,400,"False",140,310,376,66,66,1
"C05GY",281,294,"1200x900",800,1,600,400,"False",262,287,388,101,101,0
"C05GY",282,171,"1200x900",600,2,600,400,"True",909,200,275,75,75,0
"C05GY",283,229,"1200x900",800,0,600,400,"True",117,697,725,28,28,1
"C05GY",284,339,"1200x900",800,1,600,400,"False",273,545,450,-95,95,1
"C05GY",285,584,"1200x900",1000,2,600,400,"False",731,413,315,-98,98,0
"C05GY",286,385,"1200x900",800,2,600,400,"True",740,456,413,-43,43,0
"C05GY",287,546,"1200x900",1000,1,600,400,"True",305,374,412,38,38,0
"C05GY",288,458,"1200x900",1000,0,600,400,"True",78,624,592,-32,32,1
"C05GY",289,144,"1200x900",600,1,600,400,"False",718,371,488,117,117,0
"C05GY",290,579,"1200x900",1000,2,600,400,"False",803,394,649,255,255,0
"C05GY",291,17,"1200x900",600,0,600,400,"True",402,496,546,50,50,1
"C05GY",292,150,"1200x900",600,2,600,400,"True",897,345,383,38,38,0
"C05GY",293,52,"1200x900",600,0,600,400,"True",171,188,216,28,28,0
"C05GY",294,199,"1200x900",600,2,600,400,"False",992,467,281,-186,186,0
"C05GY",295,7,"1200x900",600,0,600,400,"False",431,654,561,-93,93,1
"C05GY",296,215,"1200x900",600,2,600,400,"True",939,596,520,-76,76,0
"C05GY",297,255,"1200x900",800,0,600,400,"True",93,709,672,-37,37,1
"C05GY",298,453,"1200x900",1000,0,600,400,"False",71,393,544,151,151,1
"C05GY",299,513,"1200x900",1000,1,600,400,"False",235,602,426,-176,176,0
"C05GY",300,46,"1200x900",600,0,600,400,"True",193,355,370,15,15,1
"C05GY",301,342,"1200x900",800,1,600,400,"True",677,204,264,60,60,0
"C05GY",302,318,"1200x900",800,1,600,400,"False",788,534,663,129,129,0
"C05GY",303,124,"1200x900",600,1,600,400,"True",345,467,419,-48,48,0
"C05GY",304,95,"1200x900",600,1,600,400,"False",749,425,304,-121,121,1
"C05GY",305,120,"1200x900",600,1,600,400,"True",690,655,701,46,46,0
"C05GY",306,397,"1200x900",800,2,600,400,"False",817,692,586,-106,106,0
"C05GY",307,375,"1200x900",800,2,600,400,"True",716,384,342,-42,42,0
"C05GY",308,315,"1200x900",800,1,600,400,"False",105,211,344,133,133,0
"C05GY",309,382,"1200x900",800,2,600,400,"False",870,523,620,97,97,0
"C05GY",310,378,"1200x900",800,2,600,400,"False",1018,708,492,-216,216,0
"C05GY",311,430,"1200x900",800,2,600,400,"True",922,254,289,35,35,0
"C05GY",312,442,"1200x900",1000,0,600,400,"False",87,183,304,121,121,1
"C05GY",313,143,"1200x900",600,1,600,400,"False",479,284,389,105,105,1
"C05GY",314,6,"1200x900",600,0,600,400,"False",217,689,557,-132,132,1
"C05GY",315,106,"1200x900",600,1,600,400,"True",803,659,710,51,51,1
"C05GY",316,359,"1200x900",800,1,600,400,"True",653,241,289,48,48,0
"C05GY",317,128,"1200x900",600,1,600,400,"True",661,258,220,-38,38,1
"C05GY",318,322,"1200x900",800,1,600,400,"True",703,206,158,-48,48,1
"C05GY",319,383,"1200x900",800,2,600,400,"True",855,407,381,-26,26,0
"C05GY",320,311,"1200x900",800,1,600,400,"False",710,261,471,210,210,0
"C05GY",321,621,"1200x900",1000,2,600,400,"False",540,478,624,146,146,0
"C05GY",322,632,"1200x900",1000,2,600,400,"False",984,227,416,189,189,0
"C05GY",323,127,"1200x900",600,1,600,400,"False",309,691,476,-215,215,0
"C05GY",324,9,"1200x900",600,0,600,400,"True",509,654,600,-54,54,1
"C05GY",325,466,"1200x900",1000,0,600,400,"False",82,205,282,77,77,1
"C05GY",326,214,"1200x900",600,2,600,400,"False",1046,305,232,-73,73,0
"C05GY",327,437,"1200x900",1000,0,600,400,"False",74,667,540,-127,127,1
"C05GY",328,11,"1200x900",600,0,600,400,"True",372,670,624,-46,46,1
"C05GY",329,377,"1200x900",800,2,600,400,"True",683,388,418,30,30,0
"C05GY",330,389,"1200x900",800,2,600,400,"True",843,530,601,71,71,0
"C05GY",331,313,"1200x900",800,1,600,400,"True",588,421,479,58,58,0
"C05GY",332,412,"1200x900",800,2,600,400,"True",842,280,348,68,68,0
"C05GY",333,177,"1200x900",600,2,600,400,"False",912,236,404,168,168,0
"C05GY",334,188,"1200x900",600,2,600,400,"False",900,195,321,126,126,0
"C05GY",335,410,"1200x900",800,2,600,400,"False",916,477,231,-246,246,0
"C05GY",336,102,"1200x900",600,1,600,400,"True",861,603,545,-58,58,0
"C05GY",337,198,"1200x900",600,2,600,400,"True",976,500,499,-1,1,0
"C05GY",338,14,"1200x900",600,0,600,400,"False",399,224,347,123,123,1
"C05GY",339,355,"1200x900",800,1,600,400,"False",77,386,454,68,68,0
"C05GY",340,268,"1200x900",800,0,600,400,"True",148,400,415,15,15,1
"C05GY",341,346,"1200x900",800,1,600,400,"False",269,635,544,-91,91,0
"C05GY",342,263,"1200x900",800,0,600,400,"True",82,396,414,18,18,1
"C05GY",343,24,"1200x900",600,0,600,400,"True",430,538,541,3,3,1
"C05GY",344,336,"1200x900",800,1,600,400,"True",251,587,517,-70,70,0
"C05GY",345,181,"1200x900",600,2,600,400,"False",1018,223,362,139,139,0
"C05GY",346,276,"1200x900",800,0,600,400,"False",281,217,288,71,71,1
"C05GY",347,96,"1200x900",600,1,600,400,"False",433,458,581,123,123,0
"C05GY",348,648,"1200x900",1000,2,600,400,"True",557,394,472,78,78,0
"C05GY",349,168,"1200x900",600,2,600,400,"False",1001,439,565,126,126,0
"C05GY",350,141,"1200x900",600,1,600,400,"True",671,582,630,48,48,0
"C05GY",351,333,"1200x900",800,1,600,400,"False",521,548,723,175,175,0
"C05GY",352,211,"1200x900",600,2,600,400,"True",986,407,425,18,18,0
"C05GY",353,522,"1200x900",1000,1,600,400,"False",223,379,577,198,198,0
"C05GY",354,627,"1200x900",1000,2,600,400,"True",760,510,566,56,56,0
"C05GY",355,233,"1200x900",800,0,600,400,"True",164,700,717,17,17,1
"C05GY",356,216,"1200x900",600,2,600,400,"True",1029,286,312,26,26,0
"C05GY",357,115,"1200x900",600,1,600,400,"True",545,307,259,-48,48,0
"C05GY",358,431,"1200x900",800,2,600,400,"True",694,382,314,-68,68,0
"C05GY",359,531,"1200x900",1000,1,600,400,"True",233,362,425,63,63,0
"C05GY",360,303,"1200x900",800,1,600,400,"False",241,431,535,104,104,0
"C05GY",361,64,"1200x900",600,0,600,400,"True",102,339,402,63,63,0
"C05GY",362,15,"1200x900",600,0,600,400,"True",473,352,354,2,2,1
"C05GY",363,271,"1200x900",800,0,600,400,"True",74,360,357,-3,3,1
"C05GY",364,543,"1200x900",1000,1,600,400,"False",88,202,385,183,183,0
"C05GY",365,631,"1200x900",1000,2,600,400,"True",699,479,527,48,48,0
"C05GY",366,236,"1200x900",800,0,600,400,"True",162,350,374,24,24,1
"C05GY",367,159,"1200x900",600,2,600,400,"True",992,309,289,-20,20,0
"C05GY",368,527,"1200x900",1000,1,600,400,"True",565,601,645,44,44,0
"C05GY",369,428,"1200x900",800,2,600,400,"False",732,665,522,-143,143,0
"C05GY",370,248,"1200x900",800,0,600,400,"False",94,240,317,77,77,1
"C05GY",371,192,"1200x900",600,2,600,400,"False",1064,320,422,102,102,0
"C05GY",372,83,"1200x900",600,1,600,400,"True",763,568,591,23,23,1
"C05GY",373,625,"1200x900",1000,2,600,400,"False",279,228,330,102,102,0
"C05GY",374,327,"1200x900",800,1,600,400,"True",152,339,362,23,23,0
"C05GY",375,219,"1200x900",800,0,600,400,"True",202,502,523,21,21,1
"C05GY",376,200,"1200x900",600,2,600,400,"True",897,302,369,67,67,0
"C05GY",377,612,"1200x900",1000,2,600,400,"False",706,198,304,106,106,0
"C05GY",378,295,"1200x900",800,1,600,400,"False",471,334,226,-108,108,0
"C05GY",379,637,"1200x900",1000,2,600,400,"False",750,460,531,71,71,0
"C05GY",380,63,"1200x900",600,0,600,400,"True",311,188,210,22,22,1
"C05GY",381,481,"1200x900",1000,0,600,400,"True",80,185,151,-34,34,1
"C05GY",382,325,"1200x900",800,1,600,400,"True",105,394,359,-35,35,0
"C05GY",383,12,"1200x900",600,0,600,400,"True",365,336,342,6,6,1
"C05GY",384,71,"1200x900",600,0,600,400,"True",219,248,306,58,58,0
"C05GY",385,57,"1200x900",600,0,600,400,"True",354,508,496,-12,12,1
"C05GY",386,183,"1200x900",600,2,600,400,"True",927,289,322,33,33,0
"C05GY",387,541,"1200x900",1000,1,600,400,"True",339,478,504,26,26,0
"C05GY",388,256,"1200x900",800,0,600,400,"True",192,656,585,-71,71,1
"C05GY",389,639,"1200x900",1000,2,600,400,"True",504,456,420,-36,36,0
"C05GY",390,425,"1200x900",800,2,600,400,"True",621,438,430,-8,8,0
"C05GY",391,78,"1200x900",600,1,600,400,"True",885,684,587,-97,97,0
"C05GY",392,26,"1200x900",600,0,600,400,"True",70,712,720,8,8,0
"C05GY",393,45,"1200x900",600,0,600,400,"True",487,678,678,0,0,1
"C05GY",394,109,"1200x900",600,1,600,400,"True",691,589,561,-28,28,0
"C05GY",395,349,"1200x900",800,1,600,400,"True",402,665,694,29,29,0
"C05GY",396,591,"1200x900",1000,2,600,400,"False",698,336,492,156,156,0
"C05GY",397,44,"1200x900",600,0,600,400,"True",305,554,581,27,27,1
"C05GY",398,542,"1200x900",1000,1,600,400,"True",304,401,414,13,13,0
"C05GY",399,597,"1200x900",1000,2,600,400,"False",352,239,129,-110,110,0
"C05GY",400,577,"1200x900",1000,2,600,400,"True",455,420,385,-35,35,0
"C05GY",401,273,"1200x900",800,0,600,400,"False",180,309,200,-109,109,1
"C05GY",402,18,"1200x900",600,0,600,400,"True",400,318,300,-18,18,1
"C05GY",403,399,"1200x900",800,2,600,400,"False",603,602,424,-178,178,0
"C05GY",404,92,"1200x900",600,1,600,400,"True",624,605,656,51,51,0
"C05GY",405,23,"1200x900",600,0,600,400,"True",308,463,526,63,63,1
"C05GY",406,329,"1200x900",800,1,600,400,"False",517,239,314,75,75,0
"C05GY",407,500,"1200x900",1000,0,600,400,"True",105,700,683,-17,17,1
"C05GY",408,110,"1200x900",600,1,600,400,"False",776,550,654,104,104,1
"C05GY",409,548,"1200x900",1000,1,600,400,"False",103,278,359,81,81,0
"C05GY",410,293,"1200x900",800,1,600,400,"True",561,396,421,25,25,0
"C05GY",411,53,"1200x900",600,0,600,400,"True",177,189,250,61,61,0
"C05GY",412,283,"1200x900",800,0,600,400,"True",90,264,287,23,23,1
"C05GY",413,335,"1200x900",800,1,600,400,"True",124,360,348,-12,12,0
"C05GY",414,633,"1200x900",1000,2,600,400,"False",564,253,462,209,209,0
"C05GY",415,160,"1200x900",600,2,600,400,"True",863,606,631,25,25,0
"C05GY",416,269,"1200x900",800,0,600,400,"True",160,295,283,-12,12,1
"C05GY",417,227,"1200x900",800,0,600,400,"True",196,551,615,64,64,1
"C05GY",418,282,"1200x900",800,0,600,400,"False",109,246,333,87,87,1
"C05GY",419,280,"1200x900",800,0,600,400,"True",104,302,281,-21,21,1
"C05GY",420,321,"1200x900",800,1,600,400,"True",601,190,201,11,11,0
"C05GY",421,409,"1200x900",800,2,600,400,"False",501,659,466,-193,193,0
"C05GY",422,86,"1200x900",600,1,600,400,"True",692,388,349,-39,39,1
"C05GY",423,4,"1200x900",600,0,600,400,"True",602,200,253,53,53,1
"C05GY",424,319,"1200x900",800,1,600,400,"True",494,587,568,-19,19,1
"C05GY",425,89,"1200x900",600,1,600,400,"True",917,366,416,50,50,1
"C05GY",426,10,"1200x900",600,0,600,400,"True",400,499,465,-34,34,1
"C05GY",427,520,"1200x900",1000,1,600,400,"True",564,260,250,-10,10,0
"C05GY",428,596,"1200x900",1000,2,600,400,"True",706,513,531,18,18,0
"C05GY",429,330,"1200x900",800,1,600,400,"True",759,301,261,-40,40,1
"C05GY",430,189,"1200x900",600,2,600,400,"True",881,397,437,40,40,0
"C05GY",431,443,"1200x900",1000,0,600,400,"True",99,651,637,-14,14,1
"C05GY",432,238,"1200x900",800,0,600,400,"False",162,283,371,88,88,1
"C05GY",433,592,"1200x900",1000,2,600,400,"False",492,392,611,219,219,0
"C05GY",434,309,"1200x900",800,1,600,400,"False",186,225,418,193,193,0
"C05GY",435,68,"1200x900",600,0,600,400,"True",165,367,405,38,38,0
"C05GY",436,147,"1200x900",600,2,600,400,"True",942,418,400,-18,18,0
"C05GY",437,441,"1200x900",1000,0,600,400,"True",85,684,625,-59,59,1
"C05GY",438,480,"1200x900",1000,0,600,400,"False",100,231,329,98,98,1
"C05GY",439,290,"1200x900",800,1,600,400,"True",789,603,608,5,5,0
"C05GY",440,508,"1200x900",1000,1,600,400,"False",596,485,591,106,106,0
"C05GY",441,202,"1200x900",600,2,600,400,"True",966,460,433,-27,27,0
"C05GY",442,558,"1200x900",1000,1,600,400,"True",72,464,457,-7,7,1
"C05GY",443,593,"1200x900",1000,2,600,400,"False",246,719,516,-203,203,0
"C05GY",444,288,"1200x900",800,0,600,400,"True",180,547,606,59,59,1
"C05GY",445,226,"1200x900",800,0,600,400,"True",187,229,274,45,45,1
"C05GY",446,254,"1200x900",800,0,600,400,"True",136,583,608,25,25,1
"C05GY",447,368,"1200x900",800,2,600,400,"True",778,515,505,-10,10,0
"C05GY",448,517,"1200x900",1000,1,600,400,"False",548,182,269,87,87,0
"C05GY",449,609,"1200x900",1000,2,600,400,"True",697,627,652,25,25,0
"C05GY",450,571,"1200x900",1000,1,600,400,"True",239,522,454,-68,68,1
"C05GY",451,306,"1200x900",800,1,600,400,"False",164,524,717,193,193,0
"C05GY",452,514,"1200x900",1000,1,600,400,"True",539,690,708,18,18,0
"C05GY",453,521,"1200x900",1000,1,600,400,"False",111,303,415,112,112,1
"C05GY",454,493,"1200x900",1000,0,600,400,"True",80,582,590,8,8,1
"C05GY",455,91,"1200x900",600,1,600,400,"False",417,630,505,-125,125,1
"C05GY",456,502,"1200x900",1000,0,600,400,"True",111,639,684,45,45,1
"C05GY",457,132,"1200x900",600,1,600,400,"False",333,185,374,189,189,0
"C05GY",458,39,"1200x900",600,0,600,400,"False",210,609,487,-122,122,0
"C05GY",459,279,"1200x900",800,0,600,400,"True",252,202,139,-63,63,1
"C05GY",460,56,"1200x900",600,0,600,400,"True",148,491,423,-68,68,0
"C05GY",461,272,"1200x900",800,0,600,400,"False",200,181,244,63,63,1
"C05GY",462,372,"1200x900",800,2,600,400,"False",833,620,453,-167,167,0
"C05GY",463,204,"1200x900",600,2,600,400,"False",1053,432,322,-110,110,0
"C05GY",464,536,"1200x900",1000,1,600,400,"True",580,213,209,-4,4,0
"C05GY",465,471,"1200x900",1000,0,600,400,"False",122,200,111,-89,89,1
"C05GY",466,498,"1200x900",1000,0,600,400,"False",100,260,177,-83,83,1
"C05GY",467,65,"1200x900",600,0,600,400,"False",442,645,507,-138,138,1
"C05GY",468,234,"1200x900",800,0,600,400,"True",72,344,411,67,67,1
"C05GY",469,477,"1200x900",1000,0,600,400,"True",88,640,625,-15,15,1
"C05GY",470,161,"1200x900",600,2,600,400,"False",939,553,673,120,120,0
"C05GY",471,299,"1200x900",800,1,600,400,"False",779,274,512,238,238,0
"C05GY",472,252,"1200x900",800,0,600,400,"False",224,673,583,-90,90,1
"C05GY",473,278,"1200x900",800,0,600,400,"True",251,711,677,-34,34,1
"C05GY",474,557,"1200x900",1000,1,600,400,"False",677,505,217,-288,288,1
"C05GY",475,538,"1200x900",1000,1,600,400,"False",308,457,595,138,138,1
"C05GY",476,578,"1200x900",1000,2,600,400,"False",966,276,601,325,325,0
"C05GY",477,267,"1200x900",800,0,600,400,"True",145,665,649,-16,16,1
"C05GY",478,213,"1200x900",600,2,600,400,"True",822,275,316,41,41,0
"C05GY",479,157,"1200x900",600,2,600,400,"True",1016,323,300,-23,23,0
"C05GY",480,334,"1200x900",800,1,600,400,"True",481,665,685,20,20,0
"C05GY",481,210,"1200x900",600,2,600,400,"False",835,506,583,77,77,0
"C05GY",482,483,"1200x900",1000,0,600,400,"False",93,191,289,98,98,1
"C05GY",483,139,"1200x900",600,1,600,400,"False",192,695,282,-413,413,0
"C05GY",484,421,"1200x900",800,2,600,400,"False",898,394,289,-105,105,0
"C05GY",485,476,"1200x900",1000,0,600,400,"True",76,359,321,-38,38,1
"C05GY",486,566,"1200x900",1000,1,600,400,"False",378,472,599,127,127,1
"C05GY",487,418,"1200x900",800,2,600,400,"True",754,507,473,-34,34,0
"C05GY",488,496,"1200x900",1000,0,600,400,"True",70,639,667,28,28,1
"C05GY",489,530,"1200x900",1000,1,600,400,"True",584,405,410,5,5,1
"C05GY",490,217,"1200x900",800,0,600,400,"True",85,573,547,-26,26,1
"C05GY",491,61,"1200x900",600,0,600,400,"False",272,670,598,-72,72,1
"C05GY",492,225,"1200x900",800,0,600,400,"False",178,423,527,104,104,1
"C05GY",493,247,"1200x900",800,0,600,400,"False",160,424,344,-80,80,1
"C05GY",494,630,"1200x900",1000,2,600,400,"False",754,559,623,64,64,0
"C05GY",495,448,"1200x900",1000,0,600,400,"True",107,641,684,43,43,1
"C05GY",496,31,"1200x900",600,0,600,400,"True",365,338,354,16,16,1
"C05GY",497,408,"1200x900",800,2,600,400,"False",758,567,481,-86,86,0
"C05GY",498,218,"1200x900",800,0,600,400,"True",106,397,414,17,17,1
"C05GY",499,77,"1200x900",600,1,600,400,"False",780,525,404,-121,121,0
"C05GY",500,237,"1200x900",800,0,600,400,"True",204,481,520,39,39,1
"C05GY",501,560,"1200x900",1000,1,600,400,"True",516,693,646,-47,47,0
"C05GY",502,488,"1200x900",1000,0,600,400,"True",129,687,694,7,7,1
"C05GY",503,165,"1200x900",600,2,600,400,"False",912,554,377,-177,177,0
"C05GY",504,581,"1200x900",1000,2,600,400,"False",310,357,535,178,178,0
"C05GY",505,224,"1200x900",800,0,600,400,"True",161,474,496,22,22,1
"C05GY",506,281,"1200x900",800,0,600,400,"True",112,611,587,-24,24,1
"C05GY",507,559,"1200x900",1000,1,600,400,"True",641,244,303,59,59,0
"C05GY",508,540,"1200x900",1000,1,600,400,"False",389,568,426,-142,142,1
"C05GY",509,242,"1200x900",800,0,600,400,"True",117,448,478,30,30,1
"C05GY",510,587,"1200x900",1000,2,600,400,"False",741,686,406,-280,280,0
"C05GY",511,426,"1200x900",800,2,600,400,"True",830,263,271,8,8,0
"C05GY",512,193,"1200x900",600,2,600,400,"True",874,588,580,-8,8,0
"C05GY",513,533,"1200x900",1000,1,600,400,"False",355,483,398,-85,85,0
"C05GY",514,30,"1200x900",600,0,600,400,"True",107,353,368,15,15,0
"C05GY",515,152,"1200x900",600,2,600,400,"False",971,399,326,-73,73,0
"C05GY",516,184,"1200x900",600,2,600,400,"False",1067,441,627,186,186,0
"C05GY",517,472,"1200x900",1000,0,600,400,"False",77,685,461,-224,224,1
"C05GY",518,28,"1200x900",600,0,600,400,"True",336,410,458,48,48,1
"C05GY",519,312,"1200x900",800,1,600,400,"True",238,683,598,-85,85,0
"C05GY",520,239,"1200x900",800,0,600,400,"False",114,231,326,95,95,1
"C05GY",521,37,"1200x900",600,0,600,400,"True",258,403,373,-30,30,1
"C05GY",522,406,"1200x900",800,2,600,400,"False",971,233,313,80,80,0
"C05GY",523,505,"1200x900",1000,1,600,400,"False",191,484,363,-121,121,1
"C05GY",524,174,"1200x900",600,2,600,400,"False",998,457,327,-130,130,0
"C05GY",525,528,"1200x900",1000,1,600,400,"False",839,227,523,296,296,1
"C05GY",526,494,"1200x900",1000,0,600,400,"True",127,692,652,-40,40,1
"C05GY",527,2,"1200x900",600,0,600,400,"True",159,323,358,35,35,0
"C05GY",528,572,"1200x900",1000,1,600,400,"True",302,260,206,-54,54,0
"C05GY",529,286,"1200x900",800,0,600,400,"False",105,378,277,-101,101,1
"C05GY",530,387,"1200x900",800,2,600,400,"False",990,444,284,-160,160,0
"C05GY",531,97,"1200x900",600,1,600,400,"True",760,643,588,-55,55,1
"C05GY",532,482,"1200x900",1000,0,600,400,"True",79,686,711,25,25,1
"C05GY",533,590,"1200x900",1000,2,600,400,"False",636,278,390,112,112,0
"C05GY",534,258,"1200x900",800,0,600,400,"True",126,664,703,39,39,1
"C05GY",535,112,"1200x900",600,1,600,400,"True",681,490,505,15,15,0
"C05GY",536,126,"1200x900",600,1,600,400,"True",849,354,385,31,31,0
"C05GY",537,194,"1200x900",600,2,600,400,"False",896,236,329,93,93,0
"C05GY",538,487,"1200x900",1000,0,600,400,"True",78,670,615,-55,55,1
"C05GY",539,1,"1200x900",600,0,600,400,"True",136,502,489,-13,13,0
"C05GY",540,400,"1200x900",800,2,600,400,"True",733,297,332,35,35,0
"C05GY",541,314,"1200x900",800,1,600,400,"False",277,616,466,-150,150,1
"C05GY",542,574,"1200x900",1000,1,600,400,"True",614,194,170,-24,24,0
"C05GY",543,351,"1200x900",800,1,600,400,"False",122,581,462,-119,119,0
"C05GY",544,154,"1200x900",600,2,600,400,"False",941,454,340,-114,114,0
"C05GY",545,74,"1200x900",600,1,600,400,"False",115,358,250,-108,108,0
"C05GY",546,414,"1200x900",800,2,600,400,"False",831,592,660,68,68,0
"C05GY",547,345,"1200x900",800,1,600,400,"True",841,566,587,21,21,1
"C05GY",548,601,"1200x900",1000,2,600,400,"False",735,697,580,-117,117,0
"C05GY",549,396,"1200x900",800,2,600,400,"True",678,663,616,-47,47,0
"C05GY",550,35,"1200x900",600,0,600,400,"True",366,555,549,-6,6,1
"C05GY",551,603,"1200x900",1000,2,600,400,"True",693,280,335,55,55,0
"C05GY",552,167,"1200x900",600,2,600,400,"False",956,241,326,85,85,0
"C05GY",553,379,"1200x900",800,2,600,400,"False",994,325,560,235,235,0
"C05GY",554,628,"1200x900",1000,2,600,400,"True",768,410,439,29,29,0
"C05GY",555,497,"1200x900",1000,0,600,400,"True",106,696,651,-45,45,1
"C05GY",556,310,"1200x900",800,1,600,400,"True",559,592,576,-16,16,0
"C05GY",557,105,"1200x900",600,1,600,400,"False",527,440,634,194,194,0
"C05GY",558,134,"1200x900",600,1,600,400,"True",300,188,155,-33,33,0
"C05GY",559,404,"1200x900",800,2,600,400,"True",842,396,426,30,30,0
"C05GY",560,506,"1200x900",1000,1,600,400,"False",559,567,388,-179,179,1
"C05GY",561,320,"1200x900",800,1,600,400,"True",644,376,389,13,13,0
"C05GY",562,381,"1200x900",800,2,600,400,"True",705,408,469,61,61,0
"C05GY",563,251,"1200x900",800,0,600,400,"True",88,352,393,41,41,1
"C05GY",564,534,"1200x900",1000,1,600,400,"True",328,504,475,-29,29,1
"C05GY",565,107,"1200x900",600,1,600,400,"True",878,678,654,-24,24,0
"C05GY",566,38,"1200x900",600,0,600,400,"True",120,628,611,-17,17,1
"C05GY",567,524,"1200x900",1000,1,600,400,"False",534,470,635,165,165,0
"C05GY",568,172,"1200x900",600,2,600,400,"True",912,444,472,28,28,0
"C05GY",569,131,"1200x900",600,1,600,400,"False",531,367,478,111,111,0
"C05GY",570,549,"1200x900",1000,1,600,400,"True",657,366,348,-18,18,0
"C05GY",571,317,"1200x900",800,1,600,400,"False",185,564,648,84,84,0
"C05GY",572,547,"1200x900",1000,1,600,400,"True",369,384,342,-42,42,1
"C05GY",573,388,"1200x900",800,2,600,400,"False",930,320,481,161,161,0
"C05GY",574,623,"1200x900",1000,2,600,400,"False",636,527,376,-151,151,0
"C05GY",575,499,"1200x900",1000,0,600,400,"True",93,271,316,45,45,1
"C05GY",577,34,"1200x900",600,0,600,400,"True",361,242,264,22,22,1
"C05GY",578,104,"1200x900",600,1,600,400,"False",448,584,705,121,121,0
"C05GY",579,544,"1200x900",1000,1,600,400,"True",602,620,615,-5,5,0
"C05GY",580,565,"1200x900",1000,1,600,400,"True",451,562,549,-13,13,0
"C05GY",581,69,"1200x900",600,0,600,400,"False",322,268,363,95,95,0
"C05GY",582,599,"1200x900",1000,2,600,400,"True",316,570,503,-67,67,0
"C05GY",583,605,"1200x900",1000,2,600,400,"False",493,665,542,-123,123,0
"C05GY",584,356,"1200x900",800,1,600,400,"False",123,484,586,102,102,0
"C05GY",585,54,"1200x900",600,0,600,400,"True",474,564,533,-31,31,1
"C05GY",586,465,"1200x900",1000,0,600,400,"False",85,203,272,69,69,1
"C05GY",587,49,"1200x900",600,0,600,400,"True",109,380,357,-23,23,0
"C05GY",588,638,"1200x900",1000,2,600,400,"False",385,198,304,106,106,0
"C05GY",589,358,"1200x900",800,1,600,400,"False",263,635,447,-188,188,0
"C05GY",590,636,"1200x900",1000,2,600,400,"False",575,583,500,-83,83,0
"C05GY",591,608,"1200x900",1000,2,600,400,"False",742,250,329,79,79,0
"C05GY",592,79,"1200x900",600,1,600,400,"True",731,289,280,-9,9,0
"C05GY",593,324,"1200x900",800,1,600,400,"False",719,712,528,-184,184,1
"C05GY",594,207,"1200x900",600,2,600,400,"False",838,235,337,102,102,0
"C05GY",595,59,"1200x900",600,0,600,400,"True",391,692,712,20,20,1
"C05GY",596,117,"1200x900",600,1,600,400,"True",711,456,476,20,20,0
"C05GY",597,449,"1200x900",1000,0,600,400,"True",105,683,670,-13,13,1
"C05GY",598,398,"1200x900",800,2,600,400,"True",944,698,727,29,29,0
"C05GY",599,606,"1200x900",1000,2,600,400,"True",653,627,546,-81,81,0
"C05GY",600,182,"1200x900",600,2,600,400,"False",933,389,276,-113,113,0
"C05GY",601,589,"1200x900",1000,2,600,400,"False",856,418,649,231,231,0
"C05GY",602,617,"1200x900",1000,2,600,400,"False",294,180,325,145,145,0
"C05GY",603,73,"1200x900",600,1,600,400,"True",94,665,700,35,35,0
"C05GY",604,629,"1200x900",1000,2,600,400,"False",681,257,478,221,221,0
"C05GY",605,562,"1200x900",1000,1,600,400,"True",347,540,525,-15,15,0
"C05GY",606,435,"1200x900",1000,0,600,400,"True",119,200,164,-36,36,1
"C05GY",607,446,"1200x900",1000,0,600,400,"False",72,298,411,113,113,1
"C05GY",608,138,"1200x900",600,1,600,400,"True",844,580,613,33,33,1
"C05GY",609,515,"1200x900",1000,1,600,400,"True",307,217,255,38,38,0
"C05GY",610,270,"1200x900",800,0,600,400,"True",192,418,446,28,28,1
"C05GY",611,439,"1200x900",1000,0,600,400,"True",110,229,229,0,0,1
"C05GY",612,209,"1200x900",600,2,600,400,"True",937,637,639,2,2,0
"C05GY",613,510,"1200x900",1000,1,600,400,"True",486,338,405,67,67,1
"C05GY",614,509,"1200x900",1000,1,600,400,"True",509,434,431,-3,3,0
"C05GY",615,419,"1200x900",800,2,600,400,"True",769,351,317,-34,34,0
"C05GY",616,641,"1200x900",1000,2,600,400,"False",897,272,576,304,304,0
"C05GY",617,103,"1200x900",600,1,600,400,"True",528,320,367,47,47,1
"C05GY",618,343,"1200x900",800,1,600,400,"False",407,557,409,-148,148,0
"C05GY",619,417,"1200x900",800,2,600,400,"True",750,280,242,-38,38,0
"C05GY",620,341,"1200x900",800,1,600,400,"True",735,632,606,-26,26,1
"C05GY",621,186,"1200x900",600,2,600,400,"True",997,197,224,27,27,0
"C05GY",622,19,"1200x900",600,0,600,400,"False",286,686,622,-64,64,0
"C05GY",623,362,"1200x900",800,2,600,400,"True",819,338,343,5,5,0
"C05GY",624,485,"1200x900",1000,0,600,400,"False",121,694,591,-103,103,1
"C05GY",625,175,"1200x900",600,2,600,400,"False",1028,432,242,-190,190,0
"C05GY",626,594,"1200x900",1000,2,600,400,"False",537,637,712,75,75,0
"C05GY",627,616,"1200x900",1000,2,600,400,"True",854,357,320,-37,37,1
"C05GY",628,185,"1200x900",600,2,600,400,"True",907,212,229,17,17,0
"C05GY",629,353,"1200x900",800,1,600,400,"False",90,476,727,251,251,0
"C05GY",630,369,"1200x900",800,2,600,400,"True",903,594,643,49,49,0
"C05GY",631,337,"1200x900",800,1,600,400,"True",299,622,571,-51,51,0
"C05GY",632,212,"1200x900",600,2,600,400,"False",841,206,324,118,118,0
"C05GY",633,462,"1200x900",1000,0,600,400,"False",102,672,520,-152,152,1
"C05GY",634,473,"1200x900",1000,0,600,400,"True",75,323,367,44,44,1
"C05GY",635,613,"1200x900",1000,2,600,400,"False",690,374,143,-231,231,0
"C05GY",636,259,"1200x900",800,0,600,400,"True",156,180,133,-47,47,1
"C05GY",637,344,"1200x900",800,1,600,400,"True",589,408,415,7,7,0
"C05GY",638,289,"1200x900",800,1,600,400,"False",421,703,808,105,105,1
"C05GY",639,391,"1200x900",800,2,600,400,"False",895,521,414,-107,107,0
"C05GY",640,373,"1200x900",800,2,600,400,"False",694,326,421,95,95,0
"C05GY",641,118,"1200x900",600,1,600,400,"True",190,588,503,-85,85,0
"C05GY",642,232,"1200x900",800,0,600,400,"True",84,511,516,5,5,1
"C05GY",643,535,"1200x900",1000,1,600,400,"True",372,410,417,7,7,0
"C05GY",644,390,"1200x900",800,2,600,400,"True",982,674,669,-5,5,1
"C05GY",645,518,"1200x900",1000,1,600,400,"True",583,717,747,30,30,0
"C05GY",646,197,"1200x900",600,2,600,400,"False",903,212,462,250,250,0
"C05GY",647,525,"1200x900",1000,1,600,400,"False",123,690,595,-95,95,0
"C05GY",648,50,"1200x900",600,0,600,400,"True",75,582,629,47,47,0
"C06PK",1,247,"1200x900",800,0,600,400,"True",160,424,435,11,11,1
"C06PK",2,88,"1200x900",600,1,600,400,"True",186,554,479,-75,75,0
"C06PK",3,61,"1200x900",600,0,600,400,"False",272,670,517,-153,153,1
"C06PK",4,523,"1200x900",1000,1,600,400,"True",339,318,334,16,16,0
"C06PK",5,295,"1200x900",800,1,600,400,"True",471,334,346,12,12,0
"C06PK",6,566,"1200x900",1000,1,600,400,"False",378,472,278,-194,194,1
"C06PK",7,573,"1200x900",1000,1,600,400,"True",486,615,647,32,32,0
"C06PK",8,517,"1200x900",1000,1,600,400,"True",548,182,200,18,18,0
"C06PK",9,306,"1200x900",800,1,600,400,"False",164,524,726,202,202,0
"C06PK",10,436,"1200x900",1000,0,600,400,"True",82,617,554,-63,63,1
"C06PK",11,136,"1200x900",600,1,600,400,"True",264,205,231,26,26,0
"C06PK",12,382,"1200x900",800,2,600,400,"True",870,523,591,68,68,0
"C06PK",13,341,"1200x900",800,1,600,400,"False",735,632,500,-132,132,1
"C06PK",14,237,"1200x900",800,0,600,400,"False",204,481,587,106,106,1
"C06PK",15,490,"1200x900",1000,0,600,400,"False",114,183,266,83,83,1
"C06PK",16,469,"1200x900",1000,0,600,400,"False",73,227,383,156,156,1
"C06PK",17,364,"1200x900",800,2,600,400,"True",1018,204,185,-19,19,0
"C06PK",18,90,"1200x900",600,1,600,400,"False",560,474,309,-165,165,0
"C06PK",19,99,"1200x900",600,1,600,400,"False",811,407,491,84,84,0
"C06PK",20,376,"1200x900",800,2,600,400,"True",788,275,226,-49,49,0
"C06PK",21,197,"1200x900",600,2,600,400,"False",903,212,346,134,134,0
"C06PK",22,137,"1200x900",600,1,600,400,"True",789,577,560,-17,17,0
"C06PK",23,420,"1200x900",800,2,600,400,"True",519,223,229,6,6,0
"C06PK",24,379,"1200x900",800,2,600,400,"False",994,325,516,191,191,0
"C06PK",25,396,"1200x900",800,2,600,400,"False",678,663,501,-162,162,0
"C06PK",26,146,"1200x900",600,2,600,400,"False",989,492,147,-345,345,0
"C06PK",27,458,"1200x900",1000,0,600,400,"False",78,624,532,-92,92,1
"C06PK",28,168,"1200x900",600,2,600,400,"False",1001,439,357,-82,82,0
"C06PK",29,565,"1200x900",1000,1,600,400,"False",451,562,462,-100,100,0
"C06PK",30,62,"1200x900",600,0,600,400,"True",345,346,386,40,40,1
"C06PK",31,9,"1200x900",600,0,600,400,"True",509,654,605,-49,49,1
"C06PK",32,483,"1200x900",1000,0,600,400,"False",93,191,107,-84,84,1
"C06PK",33,443,"1200x900",1000,0,600,400,"False",99,651,508,-143,143,1
"C06PK",34,77,"1200x900",600,1,600,400,"False",780,525,278,-247,247,0
"C06PK",35,251,"1200x900",800,0,600,400,"True",88,352,317,-35,35,1
"C06PK",36,241,"1200x900",800,0,600,400,"True",129,227,215,-12,12,1
"C06PK",37,378,"1200x900",800,2,600,400,"False",1018,708,553,-155,155,0
"C06PK",38,561,"1200x900",1000,1,600,400,"False",231,406,198,-208,208,0
"C06PK",39,161,"1200x900",600,2,600,400,"True",939,553,495,-58,58,0
"C06PK",40,435,"1200x900",1000,0,600,400,"True",119,200,261,61,61,1
"C06PK",41,530,"1200x900",1000,1,600,400,"False",584,405,652,247,247,1
"C06PK",42,92,"1200x900",600,1,600,400,"True",624,605,500,-105,105,0
"C06PK",43,85,"1200x900",600,1,600,400,"False",434,347,540,193,193,0
"C06PK",44,225,"1200x900",800,0,600,400,"True",178,423,446,23,23,1
"C06PK",45,557,"1200x900",1000,1,600,400,"True",677,505,541,36,36,1
"C06PK",46,404,"1200x900",800,2,600,400,"True",842,396,360,-36,36,0
"C06PK",47,550,"1200x900",1000,1,600,400,"False",301,459,687,228,228,0
"C06PK",48,451,"1200x900",1000,0,600,400,"True",110,702,656,-46,46,1
"C06PK",49,162,"1200x900",600,2,600,400,"False",849,279,404,125,125,0
"C06PK",50,30,"1200x900",600,0,600,400,"True",107,353,303,-50,50,0
"C06PK",51,422,"1200x900",800,2,600,400,"False",712,558,367,-191,191,0
"C06PK",52,215,"1200x900",600,2,600,400,"True",939,596,568,-28,28,0
"C06PK",53,188,"1200x900",600,2,600,400,"False",900,195,395,200,200,0
"C06PK",54,331,"1200x900",800,1,600,400,"True",240,620,577,-43,43,0
"C06PK",55,388,"1200x900",800,2,600,400,"False",930,320,576,256,256,0
"C06PK",56,231,"1200x900",800,0,600,400,"False",251,718,582,-136,136,1
"C06PK",57,395,"1200x900",800,2,600,400,"True",743,334,367,33,33,0
"C06PK",59,536,"1200x900",1000,1,600,400,"False",580,213,291,78,78,0
"C06PK",60,510,"1200x900",1000,1,600,400,"True",486,338,385,47,47,1
"C06PK",61,42,"1200x900",600,0,600,400,"True",233,479,447,-32,32,0
"C06PK",62,636,"1200x900",1000,2,600,400,"False",575,583,458,-125,125,0
"C06PK",63,209,"1200x900",600,2,600,400,"True",937,637,564,-73,73,0
"C06PK",64,297,"1200x900",800,1,600,400,"True",625,244,309,65,65,0
"C06PK",65,418,"1200x900",800,2,600,400,"True",754,507,538,31,31,0
"C06PK",66,264,"1200x900",800,0,600,400,"True",198,660,683,23,23,1
"C06PK",68,29,"1200x900",600,0,600,400,"True",385,533,591,58,58,1
"C06PK",69,552,"1200x900",1000,1,600,400,"False",255,412,553,141,141,0
"C06PK",70,568,"1200x900",1000,1,600,400,"False",286,475,175,-300,300,1
"C06PK",71,372,"1200x900",800,2,600,400,"False",833,620,517,-103,103,0
"C06PK",72,36,"1200x900",600,0,600,400,"True",128,346,301,-45,45,1
"C06PK",74,254,"1200x900",800,0,600,400,"True",136,583,526,-57,57,1
"C06PK",75,170,"1200x900",600,2,600,400,"False",996,468,281,-187,187,0
"C06PK",76,73,"1200x900",600,1,600,400,"True",94,665,597,-68,68,0
"C06PK",77,23,"1200x900",600,0,600,400,"True",308,463,432,-31,31,1
"C06PK",78,155,"1200x900",600,2,600,400,"False",940,269,372,103,103,0
"C06PK",79,543,"1200x900",1000,1,600,400,"False",88,202,571,369,369,0
"C06PK",80,529,"1200x900",1000,1,600,400,"False",267,412,529,117,117,1
"C06PK",81,321,"1200x900",800,1,600,400,"False",601,190,357,167,167,0
"C06PK",82,326,"1200x900",800,1,600,400,"False",103,482,137,-345,345,0
"C06PK",83,466,"1200x900",1000,0,600,400,"True",82,205,203,-2,2,1
"C06PK",84,158,"1200x900",600,2,600,400,"False",939,300,222,-78,78,0
"C06PK",85,248,"1200x900",800,0,600,400,"False",94,240,113,-127,127,1
"C06PK",86,183,"1200x900",600,2,600,400,"False",927,289,217,-72,72,0
"C06PK",87,333,"1200x900",800,1,600,400,"False",521,548,790,242,242,0
"C06PK",88,279,"1200x900",800,0,600,400,"True",252,202,260,58,58,1
"C06PK",89,567,"1200x900",1000,1,600,400,"True",655,297,353,56,56,1
"C06PK",90,191,"1200x900",600,2,600,400,"False",962,396,321,-75,75,0
"C06PK",91,513,"1200x900",1000,1,600,400,"False",235,602,236,-366,366,0
"C06PK",92,172,"1200x900",600,2,600,400,"True",912,444,436,-8,8,0
"C06PK",93,20,"1200x900",600,0,600,400,"False",204,545,479,-66,66,1
"C06PK",94,464,"1200x900",1000,0,600,400,"True",82,222,201,-21,21,1
"C06PK",95,214,"1200x900",600,2,600,400,"False",1046,305,191,-114,114,0
"C06PK",96,56,"1200x900",600,0,600,400,"False",148,491,336,-155,155,0
"C06PK",97,82,"1200x900",600,1,600,400,"True",108,213,257,44,44,0
"C06PK",98,141,"1200x900",600,1,600,400,"False",671,582,675,93,93,0
"C06PK",99,381,"1200x900",800,2,600,400,"False",705,408,509,101,101,0
"C06PK",100,14,"1200x900",600,0,600,400,"False",399,224,367,143,143,1
"C06PK",101,223,"1200x900",800,0,600,400,"False",179,191,116,-75,75,1
"C06PK",102,496,"1200x900",1000,0,600,400,"True",70,639,607,-32,32,1
"C06PK",103,511,"1200x900",1000,1,600,400,"False",408,390,521,131,131,1
"C06PK",104,446,"1200x900",1000,0,600,400,"False",72,298,491,193,193,1
"C06PK",105,474,"1200x900",1000,0,600,400,"True",85,339,389,50,50,1
"C06PK",106,560,"1200x900",1000,1,600,400,"True",516,693,769,76,76,0
"C06PK",107,8,"1200x900",600,0,600,400,"True",156,679,666,-13,13,0
"C06PK",108,194,"1200x900",600,2,600,400,"False",896,236,663,427,427,0
"C06PK",109,414,"1200x900",800,2,600,400,"True",831,592,560,-32,32,0
"C06PK",110,206,"1200x900",600,2,600,400,"False",975,223,442,219,219,0
"C06PK",111,423,"1200x900",800,2,600,400,"False",1051,710,552,-158,158,1
"C06PK",112,497,"1200x900",1000,0,600,400,"False",106,696,578,-118,118,1
"C06PK",113,312,"1200x900",800,1,600,400,"False",238,683,513,-170,170,0
"C06PK",114,619,"1200x900",1000,2,600,400,"True",803,247,256,9,9,0
"C06PK",115,212,"1200x900",600,2,600,400,"False",841,206,527,321,321,0
"C06PK",116,232,"1200x900",800,0,600,400,"True",84,511,451,-60,60,1
"C06PK",117,249,"1200x900",800,0,600,400,"True",126,306,266,-40,40,1
"C06PK",118,553,"1200x900",1000,1,600,400,"False",116,712,223,-489,489,0
"C06PK",119,220,"1200x900",800,0,600,400,"True",108,699,752,53,53,1
"C06PK",120,200,"1200x900",600,2,600,400,"False",897,302,145,-157,157,0
"C06PK",121,624,"1200x900",1000,2,600,400,"True",693,501,449,-52,52,0
"C06PK",122,367,"1200x900",800,2,600,400,"True",613,464,450,-14,14,0
"C06PK",123,479,"1200x900",1000,0,600,400,"False",74,705,621,-84,84,1
"C06PK",124,291,"1200x900",800,1,600,400,"True",522,694,709,15,15,0
"C06PK",125,299,"1200x900",800,1,600,400,"False",779,274,547,273,273,0
"C06PK",126,180,"1200x900",600,2,600,400,"False",929,270,593,323,323,0
"C06PK",127,644,"1200x900",1000,2,600,400,"False",495,486,688,202,202,0
"C06PK",128,486,"1200x900",1000,0,600,400,"True",102,676,642,-34,34,1
"C06PK",129,109,"1200x900",600,1,600,400,"False",691,589,456,-133,133,0
"C06PK",130,276,"1200x900",800,0,600,400,"False",281,217,360,143,143,1
"C06PK",131,632,"1200x900",1000,2,600,400,"False",984,227,680,453,453,0
"C06PK",132,79,"1200x900",600,1,600,400,"False",731,289,370,81,81,0
"C06PK",133,37,"1200x900",600,0,600,400,"True",258,403,426,23,23,1
"C06PK",134,583,"1200x900",1000,2,600,400,"True",949,284,271,-13,13,1
"C06PK",135,329,"1200x900",800,1,600,400,"False",517,239,137,-102,102,0
"C06PK",136,442,"1200x900",1000,0,600,400,"True",87,183,205,22,22,1
"C06PK",137,240,"1200x900",800,0,600,400,"False",330,656,453,-203,203,1
"C06PK",138,111,"1200x900",600,1,600,400,"True",922,552,495,-57,57,1
"C06PK",139,471,"1200x900",1000,0,600,400,"True",122,200,178,-22,22,1
"C06PK",140,597,"1200x900",1000,2,600,400,"False",352,239,371,132,132,0
"C06PK",141,39,"1200x900",600,0,600,400,"False",210,609,456,-153,153,0
"C06PK",142,143,"1200x900",600,1,600,400,"False",479,284,513,229,229,1
"C06PK",143,526,"1200x900",1000,1,600,400,"False",497,710,372,-338,338,0
"C06PK",144,439,"1200x900",1000,0,600,400,"False",110,229,343,114,114,1
"C06PK",145,102,"1200x900",600,1,600,400,"True",861,603,617,14,14,0
"C06PK",146,255,"1200x900",800,0,600,400,"True",93,709,683,-26,26,1
"C06PK",147,189,"1200x900",600,2,600,400,"False",881,397,625,228,228,0
"C06PK",148,257,"1200x900",800,0,600,400,"True",97,219,278,59,59,1
"C06PK",149,370,"1200x900",800,2,600,400,"False",874,336,182,-154,154,0
"C06PK",150,178,"1200x900",600,2,600,400,"False",1041,510,661,151,151,0
"C06PK",151,528,"1200x900",1000,1,600,400,"False",839,227,586,359,359,1
"C06PK",152,419,"1200x900",800,2,600,400,"True",769,351,309,-42,42,0
"C06PK",153,535,"1200x900",1000,1,600,400,"False",372,410,286,-124,124,0
"C06PK",154,647,"1200x900",1000,2,600,400,"False",560,637,719,82,82,0
"C06PK",155,572,"1200x900",1000,1,600,400,"False",302,260,457,197,197,0
"C06PK",156,343,"1200x900",800,1,600,400,"False",407,557,500,-57,57,0
"C06PK",157,285,"1200x900",800,0,600,400,"True",237,396,417,21,21,1
"C06PK",158,612,"1200x900",1000,2,600,400,"True",706,198,255,57,57,0
"C06PK",159,562,"1200x900",1000,1,600,400,"False",347,540,421,-119,119,0
"C06PK",160,349,"1200x900",800,1,600,400,"True",402,665,621,-44,44,0
"C06PK",161,154,"1200x900",600,2,600,400,"False",941,454,346,-108,108,0
"C06PK",162,473,"1200x900",1000,0,600,400,"True",75,323,326,3,3,1
"C06PK",163,556,"1200x900",1000,1,600,400,"False",415,420,550,130,130,0
"C06PK",164,110,"1200x900",600,1,600,400,"False",776,550,619,69,69,1
"C06PK",165,196,"1200x900",600,2,600,400,"True",1030,397,400,3,3,0
"C06PK",166,468,"1200x900",1000,0,600,400,"True",121,219,172,-47,47,1
"C06PK",167,555,"1200x900",1000,1,600,400,"True",444,556,567,11,11,0
"C06PK",168,598,"1200x900",1000,2,600,400,"False",706,559,285,-274,274,0
"C06PK",169,347,"1200x900",800,1,600,400,"False",757,295,589,294,294,1
"C06PK",170,481,"1200x900",1000,0,600,400,"False",80,185,471,286,286,1
"C06PK",171,18,"1200x900",600,0,600,400,"True",400,318,272,-46,46,1
"C06PK",173,128,"1200x900",600,1,600,400,"True",661,258,318,60,60,1
"C06PK",174,606,"1200x900",1000,2,600,400,"True",653,627,622,-5,5,0
"C06PK",175,433,"1200x900",1000,0,600,400,"False",76,222,101,-121,121,1
"C06PK",176,440,"1200x900",1000,0,600,400,"False",71,237,159,-78,78,1
"C06PK",177,305,"1200x900",800,1,600,400,"False",471,716,586,-130,130,0
"C06PK",178,336,"1200x900",800,1,600,400,"False",251,587,451,-136,136,0
"C06PK",179,453,"1200x900",1000,0,600,400,"True",71,393,438,45,45,1
"C06PK",180,311,"1200x900",800,1,600,400,"False",710,261,364,103,103,0
"C06PK",181,68,"1200x900",600,0,600,400,"True",165,367,370,3,3,0
"C06PK",182,581,"1200x900",1000,2,600,400,"False",310,357,247,-110,110,0
"C06PK",185,222,"1200x900",800,0,600,400,"True",152,206,205,-1,1,1
"C06PK",186,593,"1200x900",1000,2,600,400,"False",246,719,544,-175,175,0
"C06PK",187,542,"1200x900",1000,1,600,400,"False",304,401,302,-99,99,0
"C06PK",188,235,"1200x900",800,0,600,400,"False",146,646,561,-85,85,1
"C06PK",189,397,"1200x900",800,2,600,400,"False",817,692,582,-110,110,0
"C06PK",190,482,"1200x900",1000,0,600,400,"True",79,686,669,-17,17,1
"C06PK",191,50,"1200x900",600,0,600,400,"True",75,582,548,-34,34,0
"C06PK",192,429,"1200x900",800,2,600,400,"True",682,692,661,-31,31,0
"C06PK",193,28,"1200x900",600,0,600,400,"False",336,410,496,86,86,1
"C06PK",194,273,"1200x900",800,0,600,400,"False",180,309,225,-84,84,1
"C06PK",195,1,"1200x900",600,0,600,400,"False",136,502,406,-96,96,0
"C06PK",196,315,"1200x900",800,1,600,400,"False",105,211,356,145,145,0
"C06PK",197,93,"1200x900",600,1,600,400,"False",139,540,372,-168,168,0
"C06PK",198,357,"1200x900",800,1,600,400,"False",109,594,199,-395,395,0
"C06PK",199,164,"1200x900",600,2,600,400,"True",1051,268,285,17,17,0
"C06PK",200,582,"1200x900",1000,2,600,400,"False",554,347,518,171,171,0
"C06PK",201,60,"1200x900",600,0,600,400,"True",365,213,265,52,52,1
"C06PK",202,428,"1200x900",800,2,600,400,"False",732,665,417,-248,248,0
"C06PK",203,415,"1200x900",800,2,600,400,"True",823,684,729,45,45,0
"C06PK",204,31,"1200x900",600,0,600,400,"True",365,338,352,14,14,1
"C06PK",205,609,"1200x900",1000,2,600,400,"True",697,627,600,-27,27,0
"C06PK",206,551,"1200x900",1000,1,600,400,"False",146,445,692,247,247,1
"C06PK",207,594,"1200x900",1000,2,600,400,"False",537,637,719,82,82,0
"C06PK",208,640,"1200x900",1000,2,600,400,"False",361,334,260,-74,74,0
"C06PK",209,5,"1200x900",600,0,600,400,"False",228,587,511,-76,76,0
"C06PK",210,133,"1200x900",600,1,600,400,"False",345,551,634,83,83,0
"C06PK",211,100,"1200x900",600,1,600,400,"True",453,511,507,-4,4,0
"C06PK",212,648,"1200x900",1000,2,600,400,"False",557,394,504,110,110,0
"C06PK",213,287,"1200x900",800,0,600,400,"False",120,567,494,-73,73,1
"C06PK",215,646,"1200x900",1000,2,600,400,"False",829,227,357,130,130,1
"C06PK",216,618,"1200x900",1000,2,600,400,"True",276,671,629,-42,42,0
"C06PK",217,431,"1200x900",800,2,600,400,"False",694,382,544,162,162,0
"C06PK",218,301,"1200x900",800,1,600,400,"False",162,574,422,-152,152,0
"C06PK",219,620,"1200x900",1000,2,600,400,"False",832,649,398,-251,251,0
"C06PK",220,634,"1200x900",1000,2,600,400,"True",735,313,269,-44,44,0
"C06PK",221,424,"1200x900",800,2,600,400,"False",903,545,403,-142,142,0
"C06PK",222,584,"1200x900",1000,2,600,400,"False",731,413,640,227,227,0
"C06PK",223,603,"1200x900",1000,2,600,400,"True",693,280,332,52,52,0
"C06PK",224,607,"1200x900",1000,2,600,400,"True",900,573,528,-45,45,1
"C06PK",225,46,"1200x900",600,0,600,400,"True",193,355,377,22,22,1
"C06PK",226,412,"1200x900",800,2,600,400,"False",842,280,378,98,98,0
"C06PK",227,38,"1200x900",600,0,600,400,"True",120,628,676,48,48,1
"C06PK",228,277,"1200x900",800,0,600,400,"False",140,310,130,-180,180,1
"C06PK",229,84,"1200x900",600,1,600,400,"True",144,184,175,-9,9,0
"C06PK",230,145,"1200x900",600,2,600,400,"True",1004,630,574,-56,56,0
"C06PK",231,195,"1200x900",600,2,600,400,"True",942,249,258,9,9,0
"C06PK",232,234,"1200x900",800,0,600,400,"False",72,344,269,-75,75,1
"C06PK",233,484,"1200x900",1000,0,600,400,"True",100,223,237,14,14,1
"C06PK",235,467,"1200x900",1000,0,600,400,"False",74,712,623,-89,89,1
"C06PK",236,98,"1200x900",600,1,600,400,"True",625,530,546,16,16,0
"C06PK",237,33,"1200x900",600,0,600,400,"True",198,533,499,-34,34,1
"C06PK",238,527,"1200x900",1000,1,600,400,"False",565,601,360,-241,241,0
"C06PK",239,410,"1200x900",800,2,600,400,"False",916,477,272,-205,205,0
"C06PK",240,184,"1200x900",600,2,600,400,"False",1067,441,537,96,96,0
"C06PK",241,262,"1200x900",800,0,600,400,"True",196,481,486,5,5,1
"C06PK",242,119,"1200x900",600,1,600,400,"False",168,563,349,-214,214,0
"C06PK",243,564,"1200x900",1000,1,600,400,"True",215,264,284,20,20,0
"C06PK",244,219,"1200x900",800,0,600,400,"False",202,502,418,-84,84,1
"C06PK",245,186,"1200x900",600,2,600,400,"False",997,197,311,114,114,0
"C06PK",246,298,"1200x900",800,1,600,400,"True",311,457,454,-3,3,0
"C06PK",247,43,"1200x900",600,0,600,400,"True",277,446,496,50,50,1
"C06PK",249,314,"1200x900",800,1,600,400,"False",277,616,352,-264,264,1
"C06PK",250,476,"1200x900",1000,0,600,400,"True",76,359,389,30,30,1
"C06PK",251,403,"1200x900",800,2,600,400,"False",625,704,486,-218,218,0
"C06PK",252,114,"1200x900",600,1,600,400,"True",183,697,693,-4,4,0
"C06PK",253,363,"1200x900",800,2,600,400,"False",800,218,276,58,58,0
"C06PK",254,288,"1200x900",800,0,600,400,"True",180,547,480,-67,67,1
"C06PK",255,602,"1200x900",1000,2,600,400,"False",865,452,251,-201,201,0
"C06PK",256,633,"1200x900",1000,2,600,400,"True",564,253,221,-32,32,0
"C06PK",257,421,"1200x900",800,2,600,400,"True",898,394,393,-1,1,0
"C06PK",258,269,"1200x900",800,0,600,400,"True",160,295,343,48,48,1
"C06PK",259,340,"1200x900",800,1,600,400,"False",226,240,417,177,177,0
"C06PK",260,210,"1200x900",600,2,600,400,"True",835,506,522,16,16,0
"C06PK",261,6,"1200x900",600,0,600,400,"True",217,689,641,-48,48,1
"C06PK",262,488,"1200x900",1000,0,600,400,"True",129,687,660,-27,27,1
"C06PK",263,579,"1200x900",1000,2,600,400,"False",803,394,493,99,99,0
"C06PK",264,66,"1200x900",600,0,600,400,"False",155,673,511,-162,162,0
"C06PK",265,383,"1200x900",800,2,600,400,"False",855,407,523,116,116,0
"C06PK",266,270,"1200x900",800,0,600,400,"True",192,418,380,-38,38,1
"C06PK",268,608,"1200x900",1000,2,600,400,"False",742,250,552,302,302,0
"C06PK",269,320,"1200x900",800,1,600,400,"True",644,376,392,16,16,0
"C06PK",270,375,"1200x900",800,2,600,400,"True",716,384,346,-38,38,0
"C06PK",271,97,"1200x900",600,1,600,400,"False",760,643,536,-107,107,1
"C06PK",272,360,"1200x900",800,1,600,400,"False",203,608,481,-127,127,0
"C06PK",273,549,"1200x900",1000,1,600,400,"True",657,366,373,7,7,0
"C06PK",274,201,"1200x900",600,2,600,400,"True",1005,462,534,72,72,0
"C06PK",275,293,"1200x900",800,1,600,400,"True",561,396,407,11,11,0
"C06PK",276,236,"1200x900",800,0,600,400,"True",162,350,372,22,22,1
"C06PK",277,203,"1200x900",600,2,600,400,"True",938,603,581,-22,22,0
"C06PK",278,465,"1200x900",1000,0,600,400,"True",85,203,181,-22,22,1
"C06PK",279,502,"1200x900",1000,0,600,400,"True",111,639,660,21,21,1
"C06PK",280,213,"1200x900",600,2,600,400,"False",822,275,383,108,108,0
"C06PK",281,605,"1200x900",1000,2,600,400,"False",493,665,734,69,69,0
"C06PK",282,386,"1200x900",800,2,600,400,"True",774,301,274,-27,27,0
"C06PK",283,585,"1200x900",1000,2,600,400,"False",698,688,768,80,80,1
"C06PK",284,26,"1200x900",600,0,600,400,"True",70,712,682,-30,30,0
"C06PK",285,54,"1200x900",600,0,600,400,"True",474,564,602,38,38,1
"C06PK",286,623,"1200x900",1000,2,600,400,"False",636,527,312,-215,215,0
"C06PK",287,578,"1200x900",1000,2,600,400,"True",966,276,235,-41,41,0
"C06PK",288,399,"1200x900",800,2,600,400,"False",603,602,379,-223,223,0
"C06PK",289,478,"1200x900",1000,0,600,400,"True",79,672,697,25,25,1
"C06PK",290,224,"1200x900",800,0,600,400,"False",161,474,315,-159,159,1
"C06PK",291,127,"1200x900",600,1,600,400,"False",309,691,546,-145,145,0
"C06PK",292,243,"1200x900",800,0,600,400,"True",114,332,294,-38,38,1
"C06PK",293,539,"1200x900",1000,1,600,400,"True",510,383,425,42,42,0
"C06PK",294,599,"1200x900",1000,2,600,400,"False",316,570,224,-346,346,0
"C06PK",295,352,"1200x900",800,1,600,400,"True",235,717,638,-79,79,0
"C06PK",296,51,"1200x900",600,0,600,400,"True",272,181,188,7,7,1
"C06PK",297,407,"1200x900",800,2,600,400,"True",989,340,335,-5,5,0
"C06PK",298,70,"1200x900",600,0,600,400,"True",309,703,687,-16,16,1
"C06PK",299,7,"1200x900",600,0,600,400,"True",431,654,689,35,35,1
"C06PK",300,307,"1200x900",800,1,600,400,"False",716,247,331,84,84,0
"C06PK",301,148,"1200x900",600,2,600,400,"False",907,330,208,-122,122,0
"C06PK",302,533,"1200x900",1000,1,600,400,"False",355,483,310,-173,173,0
"C06PK",303,432,"1200x900",800,2,600,400,"True",792,380,398,18,18,0
"C06PK",304,492,"1200x900",1000,0,600,400,"True",76,692,722,30,30,1
"C06PK",305,278,"1200x900",800,0,600,400,"True",251,711,686,-25,25,1
"C06PK",306,101,"1200x900",600,1,600,400,"True",541,656,692,36,36,0
"C06PK",307,151,"1200x900",600,2,600,400,"True",828,680,633,-47,47,0
"C06PK",308,156,"1200x900",600,2,600,400,"False",913,197,306,109,109,0
"C06PK",309,207,"1200x900",600,2,600,400,"False",838,235,408,173,173,0
"C06PK",310,173,"1200x900",600,2,600,400,"True",948,693,626,-67,67,0
"C06PK",311,491,"1200x900",1000,0,600,400,"True",108,198,183,-15,15,1
"C06PK",312,622,"1200x900",1000,2,600,400,"True",307,683,644,-39,39,0
"C06PK",313,406,"1200x900",800,2,600,400,"False",971,233,476,243,243,0
"C06PK",314,317,"1200x900",800,1,600,400,"False",185,564,633,69,69,0
"C06PK",315,304,"1200x900",800,1,600,400,"False",667,605,362,-243,243,0
"C06PK",316,319,"1200x900",800,1,600,400,"False",494,587,338,-249,249,1
"C06PK",317,604,"1200x900",1000,2,600,400,"True",459,593,584,-9,9,0
"C06PK",318,448,"1200x900",1000,0,600,400,"True",107,641,689,48,48,1
"C06PK",319,402,"1200x900",800,2,600,400,"False",878,234,480,246,246,0
"C06PK",320,147,"1200x900",600,2,600,400,"True",942,418,351,-67,67,0
"C06PK",321,94,"1200x900",600,1,600,400,"False",729,482,390,-92,92,0
"C06PK",322,323,"1200x900",800,1,600,400,"False",388,348,492,144,144,0
"C06PK",323,330,"1200x900",800,1,600,400,"False",759,301,224,-77,77,1
"C06PK",324,377,"1200x900",800,2,600,400,"True",683,388,389,1,1,0
"C06PK",325,515,"1200x900",1000,1,600,400,"True",307,217,253,36,36,0
"C06PK",326,16,"1200x900",600,0,600,400,"False",297,514,405,-109,109,1
"C06PK",327,78,"1200x900",600,1,600,400,"True",885,684,665,-19,19,0
"C06PK",328,163,"1200x900",600,2,600,400,"False",1046,665,446,-219,219,0
"C06PK",329,290,"1200x900",800,1,600,400,"True",789,603,552,-51,51,0
"C06PK",330,499,"1200x900",1000,0,600,400,"False",93,271,362,91,91,1
"C06PK",331,217,"1200x900",800,0,600,400,"False",85,573,498,-75,75,1
"C06PK",332,339,"1200x900",800,1,600,400,"False",273,545,300,-245,245,1
"C06PK",333,140,"1200x900",600,1,600,400,"True",700,523,524,1,1,0
"C06PK",334,296,"1200x900",800,1,600,400,"True",89,279,287,8,8,0
"C06PK",335,504,"1200x900",1000,0,600,400,"True",107,699,708,9,9,1
"C06PK",336,525,"1200x900",1000,1,600,400,"True",123,690,661,-29,29,0
"C06PK",337,393,"1200x900",800,2,600,400,"False",657,620,336,-284,284,0
"C06PK",338,613,"1200x900",1000,2,600,400,"True",690,374,434,60,60,0
"C06PK",339,509,"1200x900",1000,1,600,400,"True",509,434,388,-46,46,0
"C06PK",340,116,"1200x900",600,1,600,400,"True",767,289,246,-43,43,0
"C06PK",341,537,"1200x900",1000,1,600,400,"False",621,412,653,241,241,1
"C06PK",342,4,"1200x900",600,0,600,400,"False",602,200,277,77,77,1
"C06PK",343,221,"1200x900",800,0,600,400,"True",132,520,479,-41,41,1
"C06PK",344,192,"1200x900",600,2,600,400,"True",1064,320,217,-103,103,0
"C06PK",346,359,"1200x900",800,1,600,400,"False",653,241,406,165,165,0
"C06PK",347,355,"1200x900",800,1,600,400,"False",77,386,245,-141,141,0
"C06PK",348,266,"1200x900",800,0,600,400,"False",126,303,152,-151,151,1
"C06PK",349,259,"1200x900",800,0,600,400,"True",156,180,193,13,13,1
"C06PK",350,182,"1200x900",600,2,600,400,"False",933,389,305,-84,84,0
"C06PK",351,626,"1200x900",1000,2,600,400,"False",329,449,556,107,107,0
"C06PK",352,40,"1200x900",600,0,600,400,"True",143,513,477,-36,36,0
"C06PK",353,300,"1200x900",800,1,600,400,"True",620,693,644,-49,49,0
"C06PK",354,187,"1200x900",600,2,600,400,"True",857,639,563,-76,76,0
"C06PK",355,641,"1200x900",1000,2,600,400,"False",897,272,664,392,392,0
"C06PK",356,121,"1200x900",600,1,600,400,"True",884,364,387,23,23,0
"C06PK",357,547,"1200x900",1000,1,600,400,"False",369,384,528,144,144,1
"C06PK",358,389,"1200x900",800,2,600,400,"False",843,530,461,-69,69,0
"C06PK",359,455,"1200x900",1000,0,600,400,"True",107,718,730,12,12,1
"C06PK",360,546,"1200x900",1000,1,600,400,"False",305,374,495,121,121,0
"C06PK",361,34,"1200x900",600,0,600,400,"False",361,242,343,101,101,1
"C06PK",362,152,"1200x900",600,2,600,400,"False",971,399,244,-155,155,0
"C06PK",363,72,"1200x900",600,0,600,400,"False",158,537,450,-87,87,0
"C06PK",364,284,"1200x900",800,0,600,400,"True",135,293,355,62,62,1
"C06PK",365,522,"1200x900",1000,1,600,400,"False",223,379,597,218,218,0
"C06PK",366,477,"1200x900",1000,0,600,400,"True",88,640,692,52,52,1
"C06PK",367,390,"1200x900",800,2,600,400,"True",982,674,679,5,5,1
"C06PK",368,344,"1200x900",800,1,600,400,"True",589,408,471,63,63,0
"C06PK",369,2,"1200x900",600,0,600,400,"True",159,323,343,20,20,0
"C06PK",370,447,"1200x900",1000,0,600,400,"True",71,339,373,34,34,1
"C06PK",371,230,"1200x900",800,0,600,400,"True",99,678,614,-64,64,1
"C06PK",373,122,"1200x900",600,1,600,400,"True",817,709,690,-19,19,0
"C06PK",374,76,"1200x900",600,1,600,400,"False",647,614,672,58,58,0
"C06PK",375,244,"1200x900",800,0,600,400,"True",194,203,141,-62,62,1
"C06PK",376,438,"1200x900",1000,0,600,400,"False",77,713,503,-210,210,1
"C06PK",377,507,"1200x900",1000,1,600,400,"False",608,583,702,119,119,1
"C06PK",378,139,"1200x900",600,1,600,400,"False",192,695,396,-299,299,0
"C06PK",379,575,"1200x900",1000,1,600,400,"True",272,693,673,-20,20,0
"C06PK",380,308,"1200x900",800,1,600,400,"True",437,425,446,21,21,0
"C06PK",381,516,"1200x900",1000,1,600,400,"False",440,559,698,139,139,0
"C06PK",382,580,"1200x900",1000,2,600,400,"False",651,267,401,134,134,0
"C06PK",383,495,"1200x900",1000,0,600,400,"True",93,692,721,29,29,1
"C06PK",384,328,"1200x900",800,1,600,400,"False",104,649,546,-103,103,0
"C06PK",385,589,"1200x900",1000,2,600,400,"False",856,418,568,150,150,0
"C06PK",386,505,"1200x900",1000,1,600,400,"True",191,484,527,43,43,1
"C06PK",387,487,"1200x900",1000,0,600,400,"False",78,670,747,77,77,1
"C06PK",388,265,"1200x900",800,0,600,400,"True",229,353,399,46,46,1
"C06PK",389,275,"1200x900",800,0,600,400,"False",120,594,521,-73,73,0
"C06PK",390,258,"1200x900",800,0,600,400,"False",126,664,541,-123,123,1
"C06PK",391,138,"1200x900",600,1,600,400,"False",844,580,682,102,102,1
"C06PK",392,216,"1200x900",600,2,600,400,"True",1029,286,327,41,41,0
"C06PK",393,614,"1200x900",1000,2,600,400,"False",823,563,419,-144,144,0
"C06PK",394,227,"1200x900",800,0,600,400,"False",196,551,395,-156,156,1
"C06PK",396,353,"1200x900",800,1,600,400,"True",90,476,509,33,33,0
"C06PK",397,159,"1200x900",600,2,600,400,"True",992,309,369,60,60,0
"C06PK",398,639,"1200x900",1000,2,600,400,"False",504,456,298,-158,158,0
"C06PK",399,267,"1200x900",800,0,600,400,"True",145,665,633,-32,32,1
"C06PK",400,417,"1200x900",800,2,600,400,"False",750,280,378,98,98,0
"C06PK",401,571,"1200x900",1000,1,600,400,"True",239,522,481,-41,41,1
"C06PK",402,294,"1200x900",800,1,600,400,"True",262,287,264,-23,23,0
"C06PK",403,385,"1200x900",800,2,600,400,"True",740,456,477,21,21,0
"C06PK",404,263,"1200x900",800,0,600,400,"True",82,396,363,-33,33,1
"C06PK",405,32,"1200x900",600,0,600,400,"True",152,563,530,-33,33,1
"C06PK",406,588,"1200x900",1000,2,600,400,"True",585,350,415,65,65,0
"C06PK",407,454,"1200x900",1000,0,600,400,"False",78,687,601,-86,86,1
"C06PK",408,64,"1200x900",600,0,600,400,"True",102,339,319,-20,20,0
"C06PK",409,283,"1200x900",800,0,600,400,"True",90,264,269,5,5,1
"C06PK",410,268,"1200x900",800,0,600,400,"True",148,400,383,-17,17,1
"C06PK",411,570,"1200x900",1000,1,600,400,"False",315,352,514,162,162,0
"C06PK",412,354,"1200x900",800,1,600,400,"True",118,236,186,-50,50,0
"C06PK",413,245,"1200x900",800,0,600,400,"True",296,235,209,-26,26,1
"C06PK",414,302,"1200x900",800,1,600,400,"True",479,467,449,-18,18,1
"C06PK",415,346,"1200x900",800,1,600,400,"False",269,635,470,-165,165,0
"C06PK",416,628,"1200x900",1000,2,600,400,"True",768,410,452,42,42,0
"C06PK",417,456,"1200x900",1000,0,600,400,"True",91,257,185,-72,72,1
"C06PK",418,461,"1200x900",1000,0,600,400,"False",95,711,567,-144,144,1
"C06PK",419,71,"1200x900",600,0,600,400,"False",219,248,157,-91,91,0
"C06PK",420,512,"1200x900",1000,1,600,400,"True",139,261,287,26,26,0
"C06PK",421,316,"1200x900",800,1,600,400,"False",362,319,430,111,111,0
"C06PK",422,576,"1200x900",1000,1,600,400,"True",376,713,688,-25,25,0
"C06PK",423,157,"1200x900",600,2,600,400,"True",1016,323,315,-8,8,0
"C06PK",424,53,"1200x900",600,0,600,400,"False",177,189,252,63,63,0
"C06PK",425,642,"1200x900",1000,2,600,400,"False",776,316,463,147,147,0
"C06PK",427,463,"1200x900",1000,0,600,400,"True",115,693,656,-37,37,1
"C06PK",428,500,"1200x900",1000,0,600,400,"True",105,700,640,-60,60,1
"C06PK",429,87,"1200x900",600,1,600,400,"False",231,604,458,-146,146,0
"C06PK",430,563,"1200x900",1000,1,600,400,"True",201,696,643,-53,53,0
"C06PK",431,261,"1200x900",800,0,600,400,"True",86,713,671,-42,42,1
"C06PK",432,256,"1200x900",800,0,600,400,"True",192,656,630,-26,26,1
"C06PK",433,498,"1200x900",1000,0,600,400,"False",100,260,397,137,137,1
"C06PK",434,335,"1200x900",800,1,600,400,"False",124,360,557,197,197,0
"C06PK",435,123,"1200x900",600,1,600,400,"False",761,365,282,-83,83,1
"C06PK",436,601,"1200x900",1000,2,600,400,"False",735,697,523,-174,174,0
"C06PK",437,380,"1200x900",800,2,600,400,"True",942,228,294,66,66,0
"C06PK",438,35,"1200x900",600,0,600,400,"True",366,555,525,-30,30,1
"C06PK",439,416,"1200x900",800,2,600,400,"True",748,617,608,-9,9,0
"C06PK",440,142,"1200x900",600,1,600,400,"True",286,474,486,12,12,0
"C06PK",441,592,"1200x900",1000,2,600,400,"False",492,392,642,250,250,0
"C06PK",442,534,"1200x900",1000,1,600,400,"False",328,504,631,127,127,1
"C06PK",443,361,"1200x900",800,2,600,400,"False",931,328,427,99,99,0
"C06PK",444,41,"1200x900",600,0,600,400,"True",370,452,469,17,17,1
"C06PK",445,405,"1200x900",800,2,600,400,"False",790,307,375,68,68,0
"C06PK",446,452,"1200x900",1000,0,600,400,"True",97,273,224,-49,49,1
"C06PK",447,202,"1200x900",600,2,600,400,"True",966,460,417,-43,43,0
"C06PK",448,169,"1200x900",600,2,600,400,"False",924,290,409,119,119,0
"C06PK",450,199,"1200x900",600,2,600,400,"False",992,467,337,-130,130,0
"C06PK",451,86,"1200x900",600,1,600,400,"False",692,388,224,-164,164,1
"C06PK",452,226,"1200x900",800,0,600,400,"True",187,229,193,-36,36,1
"C06PK",453,519,"1200x900",1000,1,600,400,"False",319,565,454,-111,111,1
"C06PK",454,494,"1200x900",1000,0,600,400,"False",127,692,608,-84,84,1
"C06PK",455,324,"1200x900",800,1,600,400,"False",719,712,318,-394,394,1
"C06PK",456,342,"1200x900",800,1,600,400,"False",677,204,398,194,194,0
"C06PK",457,313,"1200x900",800,1,600,400,"True",588,421,420,-1,1,0
"C06PK",458,459,"1200x900",1000,0,600,400,"True",70,645,639,-6,6,1
"C06PK",459,135,"1200x900",600,1,600,400,"True",759,569,525,-44,44,0
"C06PK",460,107,"1200x900",600,1,600,400,"True",878,678,663,-15,15,0
"C06PK",461,493,"1200x900",1000,0,600,400,"True",80,582,617,35,35,1
"C06PK",462,554,"1200x900",1000,1,600,400,"False",79,309,237,-72,72,1
"C06PK",463,449,"1200x900",1000,0,600,400,"False",105,683,473,-210,210,1
"C06PK",464,59,"1200x900",600,0,600,400,"True",391,692,685,-7,7,1
"C06PK",465,108,"1200x900",600,1,600,400,"False",830,239,321,82,82,0
"C06PK",466,369,"1200x900",800,2,600,400,"True",903,594,629,35,35,0
"C06PK",468,441,"1200x900",1000,0,600,400,"True",85,684,670,-14,14,1
"C06PK",469,327,"1200x900",800,1,600,400,"True",152,339,415,76,76,0
"C06PK",470,228,"1200x900",800,0,600,400,"False",174,687,608,-79,79,1
"C06PK",471,616,"1200x900",1000,2,600,400,"True",854,357,345,-12,12,1
"C06PK",472,437,"1200x900",1000,0,600,400,"True",74,667,632,-35,35,1
"C06PK",473,44,"1200x900",600,0,600,400,"True",305,554,601,47,47,1
"C06PK",474,450,"1200x900",1000,0,600,400,"False",130,204,270,66,66,1
"C06PK",476,208,"1200x900",600,2,600,400,"True",946,399,372,-27,27,0
"C06PK",477,401,"1200x900",800,2,600,400,"False",821,260,449,189,189,0
"C06PK",478,520,"1200x900",1000,1,600,400,"True",564,260,250,-10,10,0
"C06PK",479,260,"1200x900",800,0,600,400,"False",103,525,414,-111,111,1
"C06PK",480,252,"1200x900",800,0,600,400,"True",224,673,639,-34,34,1
"C06PK",481,55,"1200x900",600,0,600,400,"True",211,305,336,31,31,1
"C06PK",483,52,"1200x900",600,0,600,400,"True",171,188,148,-40,40,0
"C06PK",484,325,"1200x900",800,1,600,400,"False",105,394,333,-61,61,0
"C06PK",485,538,"1200x900",1000,1,600,400,"True",308,457,444,-13,13,1
"C06PK",486,12,"1200x900",600,0,600,400,"True",365,336,331,-5,5,1
"C06PK",487,574,"1200x900",1000,1,600,400,"True",614,194,243,49,49,0
"C06PK",488,95,"1200x900",600,1,600,400,"False",749,425,341,-84,84,1
"C06PK",489,185,"1200x900",600,2,600,400,"False",907,212,404,192,192,0
"C06PK",490,309,"1200x900",800,1,600,400,"False",186,225,316,91,91,0
"C06PK",491,645,"1200x900",1000,2,600,400,"True",619,396,448,52,52,0
"C06PK",492,171,"1200x900",600,2,600,400,"True",909,200,200,0,0,0
"C06PK",493,558,"1200x900",1000,1,600,400,"False",72,464,732,268,268,1
"C06PK",494,131,"1200x900",600,1,600,400,"False",531,367,537,170,170,0
"C06PK",495,544,"1200x900",1000,1,600,400,"True",602,620,613,-7,7,0
"C06PK",496,545,"1200x900",1000,1,600,400,"True",358,562,558,-4,4,0
"C06PK",498,637,"1200x900",1000,2,600,400,"False",750,460,598,138,138,0
"C06PK",499,21,"1200x900",600,0,600,400,"True",314,383,433,50,50,1
"C06PK",500,96,"1200x900",600,1,600,400,"False",433,458,531,73,73,0
"C06PK",501,611,"1200x900",1000,2,600,400,"True",414,511,478,-33,33,0
"C06PK",502,444,"1200x900",1000,0,600,400,"True",101,714,680,-34,34,1
"C06PK",503,166,"1200x900",600,2,600,400,"False",896,274,191,-83,83,0
"C06PK",504,150,"1200x900",600,2,600,400,"True",897,345,343,-2,2,0
"C06PK",505,457,"1200x900",1000,0,600,400,"True",97,630,608,-22,22,1
"C06PK",506,144,"1200x900",600,1,600,400,"False",718,371,489,118,118,0
"C06PK",507,362,"1200x900",800,2,600,400,"True",819,338,381,43,43,0
"C06PK",508,501,"1200x900",1000,0,600,400,"False",96,323,199,-124,124,1
"C06PK",509,351,"1200x900",800,1,600,400,"False",122,581,431,-150,150,0
"C06PK",510,45,"1200x900",600,0,600,400,"False",487,678,598,-80,80,1
"C06PK",511,75,"1200x900",600,1,600,400,"True",635,558,627,69,69,0
"C06PK",512,13,"1200x900",600,0,600,400,"False",296,211,272,61,61,1
"C06PK",513,105,"1200x900",600,1,600,400,"False",527,440,525,85,85,0
"C06PK",514,80,"1200x900",600,1,600,400,"False",616,423,570,147,147,1
"C06PK",515,89,"1200x900",600,1,600,400,"True",917,366,407,41,41,1
"C06PK",516,58,"1200x900",600,0,600,400,"False",353,655,547,-108,108,1
"C06PK",517,211,"1200x900",600,2,600,400,"True",986,407,389,-18,18,0
"C06PK",518,392,"1200x900",800,2,600,400,"True",1031,618,654,36,36,0
"C06PK",519,391,"1200x900",800,2,600,400,"True",895,521,464,-57,57,0
"C06PK",520,57,"1200x900",600,0,600,400,"True",354,508,446,-62,62,1
"C06PK",521,332,"1200x900",800,1,600,400,"True",260,699,725,26,26,0
"C06PK",522,366,"1200x900",800,2,600,400,"False",931,464,373,-91,91,0
"C06PK",523,11,"1200x900",600,0,600,400,"False",372,670,586,-84,84,1
"C06PK",524,521,"1200x900",1000,1,600,400,"False",111,303,641,338,338,1
"C06PK",525,149,"1200x900",600,2,600,400,"True",890,289,329,40,40,0
"C06PK",526,625,"1200x900",1000,2,600,400,"False",279,228,566,338,338,0
"C06PK",527,117,"1200x900",600,1,600,400,"False",711,456,257,-199,199,0
"C06PK",528,356,"1200x900",800,1,600,400,"False",123,484,338,-146,146,0
"C06PK",529,610,"1200x900",1000,2,600,400,"True",702,293,323,30,30,0
"C06PK",531,130,"1200x900",600,1,600,400,"True",741,428,473,45,45,0
"C06PK",532,112,"1200x900",600,1,600,400,"False",681,490,383,-107,107,0
"C06PK",533,103,"1200x900",600,1,600,400,"False",528,320,479,159,159,1
"C06PK",534,524,"1200x900",1000,1,600,400,"True",534,470,476,6,6,0
"C06PK",535,445,"1200x900",1000,0,600,400,"True",78,302,271,-31,31,1
"C06PK",537,590,"1200x900",1000,2,600,400,"False",636,278,371,93,93,0
"C06PK",538,475,"1200x900",1000,0,600,400,"False",101,715,586,-129,129,1
"C06PK",539,15,"1200x900",600,0,600,400,"True",473,352,352,0,0,1
"C06PK",540,132,"1200x900",600,1,600,400,"True",333,185,199,14,14,0
"C06PK",541,193,"1200x900",600,2,600,400,"True",874,588,582,-6,6,0
"C06PK",542,190,"1200x900",600,2,600,400,"True",977,238,246,8,8,0
"C06PK",543,394,"1200x900",800,2,600,400,"False",847,292,403,111,111,0
"C06PK",544,125,"1200x900",600,1,600,400,"True",750,531,557,26,26,0
"C06PK",545,27,"1200x900",600,0,600,400,"True",373,309,282,-27,27,1
"C06PK",546,176,"1200x900",600,2,600,400,"True",1033,281,217,-64,64,0
"C06PK",547,508,"1200x900",1000,1,600,400,"False",596,485,568,83,83,0
"C06PK",548,272,"1200x900",800,0,600,400,"True",200,181,127,-54,54,1
"C06PK",549,153,"1200x900",600,2,600,400,"False",1037,601,695,94,94,0
"C06PK",550,348,"1200x900",800,1,600,400,"False",764,294,397,103,103,0
"C06PK",551,134,"1200x900",600,1,600,400,"True",300,188,210,22,22,0
"C06PK",552,411,"1200x900",800,2,600,400,"False",805,361,585,224,224,0
"C06PK",553,503,"1200x900",1000,0,600,400,"True",86,279,243,-36,36,1
"C06PK",554,425,"1200x900",800,2,600,400,"False",621,438,576,138,138,0
"C06PK",555,472,"1200x900",1000,0,600,400,"True",77,685,731,46,46,1
"C06PK",556,470,"1200x900",1000,0,600,400,"True",91,666,655,-11,11,1
"C06PK",557,400,"1200x900",800,2,600,400,"False",733,297,391,94,94,0
"C06PK",558,177,"1200x900",600,2,600,400,"True",912,236,221,-15,15,0
"C06PK",559,218,"1200x900",800,0,600,400,"False",106,397,214,-183,183,1
"C06PK",560,246,"1200x900",800,0,600,400,"False",196,418,345,-73,73,1
"C06PK",561,47,"1200x900",600,0,600,400,"False",303,499,421,-78,78,1
"C06PK",562,115,"1200x900",600,1,600,400,"False",545,307,168,-139,139,0
"C06PK",563,48,"1200x900",600,0,600,400,"False",323,645,530,-115,115,1
"C06PK",564,518,"1200x900",1000,1,600,400,"True",583,717,743,26,26,0
"C06PK",565,292,"1200x900",800,1,600,400,"False",88,565,756,191,191,0
"C06PK",566,398,"1200x900",800,2,600,400,"True",944,698,650,-48,48,0
"C06PK",567,532,"1200x900",1000,1,600,400,"False",215,207,435,228,228,0
"C06PK",568,104,"1200x900",600,1,600,400,"False",448,584,685,101,101,0
"C06PK",569,631,"1200x900",1000,2,600,400,"True",699,479,426,-53,53,0
"C06PK",570,408,"1200x900",800,2,600,400,"False",758,567,326,-241,241,0
"C06PK",571,181,"1200x900",600,2,600,400,"True",1018,223,277,54,54,0
"C06PK",572,303,"1200x900",800,1,600,400,"True",241,431,464,33,33,0
"C06PK",573,337,"1200x900",800,1,600,400,"False",299,622,529,-93,93,0
"C06PK",574,409,"1200x900",800,2,600,400,"False",501,659,256,-403,403,0
"C06PK",575,229,"1200x900",800,0,600,400,"False",117,697,620,-77,77,1
"C06PK",576,540,"1200x900",1000,1,600,400,"False",389,568,696,128,128,1
"C06PK",577,3,"1200x900",600,0,600,400,"False",298,443,379,-64,64,1
"C06PK",578,506,"1200x900",1000,1,600,400,"False",559,567,253,-314,314,1
"C06PK",579,596,"1200x900",1000,2,600,400,"True",706,513,526,13,13,0
"C06PK",580,318,"1200x900",800,1,600,400,"False",788,534,662,128,128,0
"C06PK",581,434,"1200x900",1000,0,600,400,"True",89,657,637,-20,20,1
"C06PK",582,124,"1200x900",600,1,600,400,"False",345,467,377,-90,90,0
"C06PK",583,179,"1200x900",600,2,600,400,"False",908,602,450,-152,152,0
"C06PK",584,274,"1200x900",800,0,600,400,"True",146,497,474,-23,23,1
"C06PK",585,334,"1200x900",800,1,600,400,"False",481,665,523,-142,142,0
"C06PK",586,175,"1200x900",600,2,600,400,"True",1028,432,408,-24,24,0
"C06PK",587,271,"1200x900",800,0,600,400,"True",74,360,382,22,22,1
"C06PK",588,22,"1200x900",600,0,600,400,"True",398,591,559,-32,32,1
"C06PK",589,69,"1200x900",600,0,600,400,"True",322,268,238,-30,30,0
"C06PK",590,460,"1200x900",1000,0,600,400,"True",155,189,157,-32,32,1
"C06PK",591,83,"1200x900",600,1,600,400,"True",763,568,570,2,2,1
"C06PK",592,387,"1200x900",800,2,600,400,"False",990,444,289,-155,155,0
"C06PK",593,374,"1200x900",800,2,600,400,"False",755,450,287,-163,163,0
"C06PK",594,282,"1200x900",800,0,600,400,"True",109,246,212,-34,34,1
"C06PK",595,238,"1200x900",800,0,600,400,"True",162,283,228,-55,55,1
"C06PK",596,91,"1200x900",600,1,600,400,"True",417,630,595,-35,35,1
"C06PK",597,426,"1200x900",800,2,600,400,"False",830,263,197,-66,66,0
"C06PK",598,413,"1200x900",800,2,600,400,"False",849,506,398,-108,108,0
"C06PK",599,253,"1200x900",800,0,600,400,"False",177,424,287,-137,137,1
"C06PK",600,49,"1200x900",600,0,600,400,"True",109,380,358,-22,22,0
"C06PK",601,600,"1200x900",1000,2,600,400,"False",765,207,444,237,237,0
"C06PK",602,617,"1200x900",1000,2,600,400,"False",294,180,494,314,314,0
"C06PK",603,322,"1200x900",800,1,600,400,"False",703,206,286,80,80,1
"C06PK",604,643,"1200x900",1000,2,600,400,"True",740,325,402,77,77,0
"C06PK",605,120,"1200x900",600,1,600,400,"False",690,655,328,-327,327,0
"C06PK",606,587,"1200x900",1000,2,600,400,"False",741,686,358,-328,328,0
"C06PK",607,205,"1200x900",600,2,600,400,"False",1021,504,607,103,103,0
"C06PK",608,233,"1200x900",800,0,600,400,"True",164,700,689,-11,11,1
"C06PK",609,118,"1200x900",600,1,600,400,"True",190,588,634,46,46,0
"C06PK",610,281,"1200x900",800,0,600,400,"True",112,611,623,12,12,1
"C06PK",611,24,"1200x900",600,0,600,400,"True",430,538,528,-10,10,1
"C06PK",612,25,"1200x900",600,0,600,400,"True",263,403,464,61,61,1
"C06PK",613,569,"1200x900",1000,1,600,400,"False",494,720,403,-317,317,0
"C06PK",614,63,"1200x900",600,0,600,400,"False",311,188,258,70,70,1
"C06PK",615,345,"1200x900",800,1,600,400,"False",841,566,750,184,184,1
"C06PK",616,368,"1200x900",800,2,600,400,"True",778,515,466,-49,49,0
"C06PK",617,548,"1200x900",1000,1,600,400,"True",103,278,252,-26,26,0
"C06PK",618,577,"1200x900",1000,2,600,400,"True",455,420,470,50,50,0
"C06PK",619,427,"1200x900",800,2,600,400,"True",812,380,397,17,17,0
"C06PK",620,129,"1200x900",600,1,600,400,"False",859,482,301,-181,181,1
"C06PK",621,514,"1200x900",1000,1,600,400,"False",539,690,605,-85,85,0
"C06PK",622,250,"1200x900",800,0,600,400,"False",290,248,382,134,134,1
"C06PK",623,358,"1200x900",800,1,600,400,"False",263,635,280,-355,355,0
"C06PK",624,489,"1200x900",1000,0,600,400,"False",88,604,539,-65,65,1
"C06PK",625,289,"1200x900",800,1,600,400,"True",421,703,654,-49,49,1
"C06PK",626,113,"1200x900",600,1,600,400,"True",897,657,688,31,31,0
"C06PK",627,365,"1200x900",800,2,600,400,"False",1055,305,472,167,167,0
"C06PK",628,591,"1200x900",1000,2,600,400,"False",698,336,434,98,98,0
"C06PK",629,559,"1200x900",1000,1,600,400,"False",641,244,445,201,201,0
"C06PK",630,373,"1200x900",800,2,600,400,"False",694,326,430,104,104,0
"C06PK",631,10,"1200x900",600,0,600,400,"True",400,499,503,4,4,1
"C06PK",632,480,"1200x900",1000,0,600,400,"False",100,231,305,74,74,1
"C06PK",633,126,"1200x900",600,1,600,400,"False",849,354,499,145,145,0
"C06PK",634,638,"1200x900",1000,2,600,400,"False",385,198,281,83,83,0
"C06PK",635,629,"1200x900",1000,2,600,400,"True",681,257,280,23,23,0
"C06PK",636,595,"1200x900",1000,2,600,400,"False",687,640,385,-255,255,0
"C06PK",637,167,"1200x900",600,2,600,400,"False",956,241,391,150,150,0
"C06PK",638,67,"1200x900",600,0,600,400,"True",289,308,242,-66,66,1
"C06PK",639,239,"1200x900",800,0,600,400,"True",114,231,211,-20,20,1
"C06PK",640,310,"1200x900",800,1,600,400,"False",559,592,506,-86,86,0
"C06PK",641,242,"1200x900",800,0,600,400,"True",117,448,499,51,51,1
"C06PK",642,160,"1200x900",600,2,600,400,"False",863,606,485,-121,121,0
"C06PK",643,586,"1200x900",1000,2,600,400,"True",802,262,296,34,34,0
"C06PK",644,17,"1200x900",600,0,600,400,"True",402,496,443,-53,53,1
"C06PK",645,531,"1200x900",1000,1,600,400,"True",233,362,401,39,39,0
"C06PK",646,630,"1200x900",1000,2,600,400,"False",754,559,315,-244,244,0
"C06PK",647,74,"1200x900",600,1,600,400,"False",115,358,229,-129,129,0
"C06PK",648,485,"1200x900",1000,0,600,400,"False",121,694,583,-111,111,1
"C07ZM",1,47,"1200x900",600,0,600,400,"False",303,499,434,-65,65,1
"C07ZM",2,264,"1200x900",800,0,600,400,"False",198,660,452,-208,208,1
"C07ZM",3,632,"1200x900",1000,2,600,400,"False",984,227,741,514,514,0
"C07ZM",4,321,"1200x900",800,1,600,400,"False",601,190,364,174,174,0
"C07ZM",5,262,"1200x900",800,0,600,400,"True",196,481,470,-11,11,1
"C07ZM",6,85,"1200x900",600,1,600,400,"False",434,347,688,341,341,0
"C07ZM",7,350,"1200x900",800,1,600,400,"False",182,566,242,-324,324,0
"C07ZM",8,449,"1200x900",1000,0,600,400,"False",105,683,509,-174,174,1
"C07ZM",9,120,"1200x900",600,1,600,400,"False",690,655,403,-252,252,0
"C07ZM",10,83,"1200x900",600,1,600,400,"True",763,568,513,-55,55,1
"C07ZM",11,20,"1200x900",600,0,600,400,"False",204,545,389,-156,156,1
"C07ZM",12,249,"1200x900",800,0,600,400,"True",126,306,244,-62,62,1
"C07ZM",13,151,"1200x900",600,2,600,400,"False",828,680,538,-142,142,0
"C07ZM",14,328,"1200x900",800,1,600,400,"True",104,649,705,56,56,0
"C07ZM",16,599,"1200x900",1000,2,600,400,"False",316,570,477,-93,93,0
"C07ZM",17,58,"1200x900",600,0,600,400,"True",353,655,621,-34,34,1
"C07ZM",18,312,"1200x900",800,1,600,400,"False",238,683,767,84,84,0
"C07ZM",19,468,"1200x900",1000,0,600,400,"True",121,219,281,62,62,1
"C07ZM",20,296,"1200x900",800,1,600,400,"False",89,279,374,95,95,0
"C07ZM",21,587,"1200x900",1000,2,600,400,"False",741,686,289,-397,397,0
"C07ZM",22,259,"1200x900",800,0,600,400,"True",156,180,207,27,27,1
"C07ZM",23,239,"1200x900",800,0,600,400,"True",114,231,283,52,52,1
"C07ZM",24,190,"1200x900",600,2,600,400,"True",977,238,239,1,1,0
"C07ZM",25,107,"1200x900",600,1,600,400,"False",878,678,505,-173,173,0
"C07ZM",26,215,"1200x900",600,2,600,400,"False",939,596,707,111,111,0
"C07ZM",27,344,"1200x900",800,1,600,400,"True",589,408,361,-47,47,0
"C07ZM",28,383,"1200x900",800,2,600,400,"False",855,407,576,169,169,0
"C07ZM",29,49,"1200x900",600,0,600,400,"False",109,380,523,143,143,0
"C07ZM",30,45,"1200x900",600,0,600,400,"False",487,678,572,-106,106,1
"C07ZM",31,457,"1200x900",1000,0,600,400,"False",97,630,431,-199,199,1
"C07ZM",32,303,"1200x900",800,1,600,400,"False",241,431,540,109,109,0
"C07ZM",33,66,"1200x900",600,0,600,400,"False",155,673,601,-72,72,0
"C07ZM",34,145,"1200x900",600,2,600,400,"True",1004,630,607,-23,23,0
"C07ZM",35,502,"1200x900",1000,0,600,400,"True",111,639,585,-54,54,1
"C07ZM",37,232,"1200x900",800,0,600,400,"True",84,511,458,-53,53,1
"C07ZM",38,5,"1200x900",600,0,600,400,"False",228,587,521,-66,66,0
"C07ZM",39,29,"1200x900",600,0,600,400,"True",385,533,570,37,37,1
"C07ZM",40,226,"1200x900",800,0,600,400,"False",187,229,330,101,101,1
"C07ZM",41,44,"1200x900",600,0,600,400,"False",305,554,473,-81,81,1
"C07ZM",42,394,"1200x900",800,2,600,400,"False",847,292,707,415,415,0
"C07ZM",43,497,"1200x900",1000,0,600,400,"False",106,696,315,-381,381,1
"C07ZM",44,41,"1200x900",600,0,600,400,"True",370,452,423,-29,29,1
"C07ZM",45,278,"1200x900",800,0,600,400,"False",251,711,535,-176,176,1
"C07ZM",46,225,"1200x900",800,0,600,400,"True",178,423,423,0,0,1
"C07ZM",47,555,"1200x900",1000,1,600,400,"True",444,556,526,-30,30,0
"C07ZM",48,519,"1200x900",1000,1,600,400,"True",319,565,621,56,56,1
"C07ZM",49,276,"1200x900",800,0,600,400,"False",281,217,354,137,137,1
"C07ZM",50,90,"1200x900",600,1,600,400,"False",560,474,359,-115,115,0
"C07ZM",51,236,"1200x900",800,0,600,400,"False",162,350,281,-69,69,1
"C07ZM",52,506,"1200x900",1000,1,600,400,"False",559,567,425,-142,142,1
"C07ZM",53,464,"1200x900",1000,0,600,400,"False",82,222,357,135,135,1
"C07ZM",54,69,"1200x900",600,0,600,400,"False",322,268,438,170,170,0
"C07ZM",55,575,"1200x900",1000,1,600,400,"False",272,693,379,-314,314,0
"C07ZM",56,102,"1200x900",600,1,600,400,"True",861,603,664,61,61,0
"C07ZM",57,462,"1200x900",1000,0,600,400,"False",102,672,582,-90,90,1
"C07ZM",58,626,"1200x900",1000,2,600,400,"False",329,449,684,235,235,0
"C07ZM",59,346,"1200x900",800,1,600,400,"True",269,635,668,33,33,0
"C07ZM",60,359,"1200x900",800,1,600,400,"False",653,241,605,364,364,0
"C07ZM",61,621,"1200x900",1000,2,600,400,"False",540,478,368,-110,110,0
"C07ZM",62,313,"1200x900",800,1,600,400,"False",588,421,259,-162,162,0
"C07ZM",63,132,"1200x900",600,1,600,400,"False",333,185,115,-70,70,0
"C07ZM",64,17,"1200x900",600,0,600,400,"False",402,496,422,-74,74,1
"C07ZM",65,335,"1200x900",800,1,600,400,"False",124,360,230,-130,130,0
"C07ZM",66,576,"1200x900",1000,1,600,400,"False",376,713,358,-355,355,0
"C07ZM",67,459,"1200x900",1000,0,600,400,"False",70,645,417,-228,228,1
"C07ZM",68,314,"1200x900",800,1,600,400,"True",277,616,622,6,6,1
"C07ZM",69,213,"1200x900",600,2,600,400,"True",822,275,239,-36,36,0
"C07ZM",70,515,"1200x900",1000,1,600,400,"True",307,217,150,-67,67,0
"C07ZM",71,131,"1200x900",600,1,600,400,"False",531,367,702,335,335,0
"C07ZM",72,343,"1200x900",800,1,600,400,"False",407,557,220,-337,337,0
"C07ZM",73,208,"1200x900",600,2,600,400,"False",946,399,591,192,192,0
"C07ZM",74,116,"1200x900",600,1,600,400,"False",767,289,227,-62,62,0
"C07ZM",75,206,"1200x900",600,2,600,400,"False",975,223,428,205,205,0
"C07ZM",76,170,"1200x900",600,2,600,400,"False",996,468,248,-220,220,0
"C07ZM",77,174,"1200x900",600,2,600,400,"False",998,457,343,-114,114,0
"C07ZM",78,553,"1200x900",1000,1,600,400,"False",116,712,168,-544,544,0
"C07ZM",79,562,"1200x900",1000,1,600,400,"False",347,540,247,-293,293,0
"C07ZM",80,378,"1200x900",800,2,600,400,"False",1018,708,832,124,124,0
"C07ZM",81,406,"1200x900",800,2,600,400,"False",971,233,449,216,216,0
"C07ZM",82,531,"1200x900",1000,1,600,400,"False",233,362,596,234,234,0
"C07ZM",83,467,"1200x900",1000,0,600,400,"False",74,712,576,-136,136,1
"C07ZM",84,357,"1200x900",800,1,600,400,"True",109,594,568,-26,26,0
"C07ZM",85,622,"1200x900",1000,2,600,400,"False",307,683,299,-384,384,0
"C07ZM",86,503,"1200x900",1000,0,600,400,"True",86,279,239,-40,40,1
"C07ZM",87,246,"1200x900",800,0,600,400,"True",196,418,402,-16,16,1
"C07ZM",88,332,"1200x900",800,1,600,400,"True",260,699,667,-32,32,0
"C07ZM",89,178,"1200x900",600,2,600,400,"False",1041,510,282,-228,228,0
"C07ZM",90,253,"1200x900",800,0,600,400,"False",177,424,343,-81,81,1
"C07ZM",91,287,"1200x900",800,0,600,400,"True",120,567,566,-1,1,1
"C07ZM",92,133,"1200x900",600,1,600,400,"False",345,551,754,203,203,0
"C07ZM",93,153,"1200x900",600,2,600,400,"False",1037,601,487,-114,114,0
"C07ZM",94,52,"1200x900",600,0,600,400,"False",171,188,322,134,134,0
"C07ZM",95,185,"1200x900",600,2,600,400,"False",907,212,508,296,296,0
"C07ZM",96,108,"1200x900",600,1,600,400,"False",830,239,170,-69,69,0
"C07ZM",97,603,"1200x900",1000,2,600,400,"False",693,280,403,123,123,0
"C07ZM",98,500,"1200x900",1000,0,600,400,"False",105,700,329,-371,371,1
"C07ZM",99,554,"1200x900",1000,1,600,400,"False",79,309,196,-113,113,1
"C07ZM",100,635,"1200x900",1000,2,600,400,"True",833,402,414,12,12,0
"C07ZM",101,492,"1200x900",1000,0,600,400,"True",76,692,638,-54,54,1
"C07ZM",102,423,"1200x900",800,2,600,400,"False",1051,710,303,-407,407,1
"C07ZM",103,204,"1200x900",600,2,600,400,"True",1053,432,429,-3,3,0
"C07ZM",104,401,"1200x900",800,2,600,400,"False",821,260,187,-73,73,0
"C07ZM",105,363,"1200x900",800,2,600,400,"False",800,218,361,143,143,0
"C07ZM",106,129,"1200x900",600,1,600,400,"False",859,482,198,-284,284,1
"C07ZM",107,251,"1200x900",800,0,600,400,"False",88,352,484,132,132,1
"C07ZM",108,619,"1200x900",1000,2,600,400,"False",803,247,666,419,419,0
"C07ZM",109,61,"1200x900",600,0,600,400,"False",272,670,558,-112,112,1
"C07ZM",110,613,"1200x900",1000,2,600,400,"False",690,374,292,-82,82,0
"C07ZM",111,235,"1200x900",800,0,600,400,"False",146,646,552,-94,94,1
"C07ZM",112,589,"1200x900",1000,2,600,400,"True",856,418,369,-49,49,0
"C07ZM",113,100,"1200x900",600,1,600,400,"False",453,511,448,-63,63,0
"C07ZM",114,356,"1200x900",800,1,600,400,"True",123,484,496,12,12,0
"C07ZM",115,212,"1200x900",600,2,600,400,"False",841,206,674,468,468,0
"C07ZM",116,98,"1200x900",600,1,600,400,"False",625,530,311,-219,219,0
"C07ZM",117,9,"1200x900",600,0,600,400,"True",509,654,636,-18,18,1
"C07ZM",118,187,"1200x900",600,2,600,400,"False",857,639,331,-308,308,0
"C07ZM",119,261,"1200x900",800,0,600,400,"False",86,713,850,137,137,1
"C07ZM",120,569,"1200x900",1000,1,600,400,"False",494,720,370,-350,350,0
"C07ZM",121,256,"1200x900",800,0,600,400,"True",192,656,635,-21,21,1
"C07ZM",122,617,"1200x900",1000,2,600,400,"False",294,180,565,385,385,0
"C07ZM",123,541,"1200x900",1000,1,600,400,"False",339,478,269,-209,209,0
"C07ZM",124,544,"1200x900",1000,1,600,400,"False",602,620,526,-94,94,0
"C07ZM",125,618,"1200x900",1000,2,600,400,"False",276,671,196,-475,475,0
"C07ZM",126,491,"1200x900",1000,0,600,400,"False",108,198,278,80,80,1
"C07ZM",127,24,"1200x900",600,0,600,400,"False",430,538,413,-125,125,1
"C07ZM",128,630,"1200x900",1000,2,600,400,"False",754,559,291,-268,268,0
"C07ZM",129,197,"1200x900",600,2,600,400,"False",903,212,410,198,198,0
"C07ZM",130,397,"1200x900",800,2,600,400,"False",817,692,809,117,117,0
"C07ZM",131,126,"1200x900",600,1,600,400,"False",849,354,434,80,80,0
"C07ZM",132,3,"1200x900",600,0,600,400,"False",298,443,367,-76,76,1
"C07ZM",133,340,"1200x900",800,1,600,400,"False",226,240,464,224,224,0
"C07ZM",134,22,"1200x900",600,0,600,400,"True",398,591,627,36,36,1
"C07ZM",135,604,"1200x900",1000,2,600,400,"False",459,593,491,-102,102,0
"C07ZM",136,511,"1200x900",1000,1,600,400,"True",408,390,438,48,48,1
"C07ZM",137,465,"1200x900",1000,0,600,400,"False",85,203,309,106,106,1
"C07ZM",138,194,"1200x900",600,2,600,400,"False",896,236,348,112,112,0
"C07ZM",139,295,"1200x900",800,1,600,400,"False",471,334,464,130,130,0
"C07ZM",140,193,"1200x900",600,2,600,400,"False",874,588,325,-263,263,0
"C07ZM",141,573,"1200x900",1000,1,600,400,"False",486,615,408,-207,207,0
"C07ZM",142,231,"1200x900",800,0,600,400,"False",251,718,478,-240,240,1
"C07ZM",143,546,"1200x900",1000,1,600,400,"True",305,374,424,50,50,0
"C07ZM",144,219,"1200x900",800,0,600,400,"True",202,502,509,7,7,1
"C07ZM",145,463,"1200x900",1000,0,600,400,"False",115,693,477,-216,216,1
"C07ZM",146,421,"1200x900",800,2,600,400,"False",898,394,291,-103,103,0
"C07ZM",147,558,"1200x900",1000,1,600,400,"False",72,464,571,107,107,1
"C07ZM",148,561,"1200x900",1000,1,600,400,"False",231,406,744,338,338,0
"C07ZM",149,427,"1200x900",800,2,600,400,"False",812,380,576,196,196,0
"C07ZM",150,4,"1200x900",600,0,600,400,"False",602,200,366,166,166,1
"C07ZM",151,627,"1200x900",1000,2,600,400,"True",760,510,517,7,7,0
"C07ZM",152,601,"1200x900",1000,2,600,400,"False",735,697,349,-348,348,0
"C07ZM",153,417,"1200x900",800,2,600,400,"True",750,280,259,-21,21,0
"C07ZM",154,369,"1200x900",800,2,600,400,"True",903,594,582,-12,12,0
"C07ZM",155,470,"1200x900",1000,0,600,400,"False",91,666,433,-233,233,1
"C07ZM",156,106,"1200x900",600,1,600,400,"True",803,659,636,-23,23,1
"C07ZM",157,507,"1200x900",1000,1,600,400,"True",608,583,606,23,23,1
"C07ZM",158,183,"1200x900",600,2,600,400,"True",927,289,358,69,69,0
"C07ZM",159,222,"1200x900",800,0,600,400,"True",152,206,213,7,7,1
"C07ZM",160,202,"1200x900",600,2,600,400,"False",966,460,617,157,157,0
"C07ZM",161,535,"1200x900",1000,1,600,400,"False",372,410,223,-187,187,0
"C07ZM",162,195,"1200x900",600,2,600,400,"False",942,249,385,136,136,0
"C07ZM",163,432,"1200x900",800,2,600,400,"False",792,380,306,-74,74,0
"C07ZM",164,411,"1200x900",800,2,600,400,"False",805,361,477,116,116,0
"C07ZM",165,376,"1200x900",800,2,600,400,"True",788,275,272,-3,3,0
"C07ZM",166,121,"1200x900",600,1,600,400,"False",884,364,553,189,189,0
"C07ZM",167,508,"1200x900",1000,1,600,400,"False",596,485,277,-208,208,0
"C07ZM",168,592,"1200x900",1000,2,600,400,"False",492,392,517,125,125,0
"C07ZM",169,620,"1200x900",1000,2,600,400,"False",832,649,536,-113,113,0
"C07ZM",171,77,"1200x900",600,1,600,400,"True",780,525,558,33,33,0
"C07ZM",172,93,"1200x900",600,1,600,400,"False",139,540,254,-286,286,0
"C07ZM",173,207,"1200x900",600,2,600,400,"False",838,235,592,357,357,0
"C07ZM",174,135,"1200x900",600,1,600,400,"False",759,569,359,-210,210,0
"C07ZM",175,352,"1200x900",800,1,600,400,"False",235,717,406,-311,311,0
"C07ZM",176,347,"1200x900",800,1,600,400,"False",757,295,516,221,221,1
"C07ZM",177,205,"1200x900",600,2,600,400,"False",1021,504,619,115,115,0
"C07ZM",178,520,"1200x900",1000,1,600,400,"True",564,260,238,-22,22,0
"C07ZM",179,74,"1200x900",600,1,600,400,"False",115,358,506,148,148,0
"C07ZM",180,354,"1200x900",800,1,600,400,"False",118,236,481,245,245,0
"C07ZM",181,513,"1200x900",1000,1,600,400,"False",235,602,277,-325,325,0
"C07ZM",182,78,"1200x900",600,1,600,400,"True",885,684,645,-39,39,0
"C07ZM",183,542,"1200x900",1000,1,600,400,"True",304,401,443,42,42,0
"C07ZM",184,375,"1200x900",800,2,600,400,"True",716,384,462,78,78,0
"C07ZM",185,577,"1200x900",1000,2,600,400,"False",455,420,583,163,163,0
"C07ZM",186,608,"1200x900",1000,2,600,400,"True",742,250,294,44,44,0
"C07ZM",187,288,"1200x900",800,0,600,400,"True",180,547,581,34,34,1
"C07ZM",188,331,"1200x900",800,1,600,400,"False",240,620,713,93,93,0
"C07ZM",189,191,"1200x900",600,2,600,400,"True",962,396,459,63,63,0
"C07ZM",190,8,"1200x900",600,0,600,400,"True",156,679,687,8,8,0
"C07ZM",191,142,"1200x900",600,1,600,400,"False",286,474,531,57,57,0
"C07ZM",192,324,"1200x900",800,1,600,400,"False",719,712,581,-131,131,1
"C07ZM",193,453,"1200x900",1000,0,600,400,"True",71,393,365,-28,28,1
"C07ZM",194,43,"1200x900",600,0,600,400,"False",277,446,544,98,98,1
"C07ZM",195,167,"1200x900",600,2,600,400,"False",956,241,375,134,134,0
"C07ZM",196,277,"1200x900",800,0,600,400,"True",140,310,267,-43,43,1
"C07ZM",197,139,"1200x900",600,1,600,400,"False",192,695,320,-375,375,0
"C07ZM",198,540,"1200x900",1000,1,600,400,"False",389,568,462,-106,106,1
"C07ZM",199,516,"1200x900",1000,1,600,400,"False",440,559,474,-85,85,0
"C07ZM",200,458,"1200x900",1000,0,600,400,"False",78,624,471,-153,153,1
"C07ZM",201,533,"1200x900",1000,1,600,400,"True",355,483,505,22,22,0
"C07ZM",202,291,"1200x900",800,1,600,400,"False",522,694,594,-100,100,0
"C07ZM",203,127,"1200x900",600,1,600,400,"False",309,691,386,-305,305,0
"C07ZM",204,327,"1200x900",800,1,600,400,"True",152,339,387,48,48,0
"C07ZM",205,73,"1200x900",600,1,600,400,"True",94,665,595,-70,70,0
"C07ZM",206,270,"1200x900",800,0,600,400,"True",192,418,450,32,32,1
"C07ZM",207,407,"1200x900",800,2,600,400,"True",989,340,539,199,199,0
"C07ZM",208,408,"1200x900",800,2,600,400,"True",758,567,626,59,59,0
"C07ZM",209,201,"1200x900",600,2,600,400,"False",1005,462,704,242,242,0
"C07ZM",210,271,"1200x900",800,0,600,400,"True",74,360,371,11,11,1
"C07ZM",211,110,"1200x900",600,1,600,400,"False",776,550,758,208,208,1
"C07ZM",212,238,"1200x900",800,0,600,400,"False",162,283,369,86,86,1
"C07ZM",213,355,"1200x900",800,1,600,400,"False",77,386,620,234,234,0
"C07ZM",214,245,"1200x900",800,0,600,400,"False",296,235,529,294,294,1
"C07ZM",215,181,"1200x900",600,2,600,400,"False",1018,223,440,217,217,0
"C07ZM",216,254,"1200x900",800,0,600,400,"False",136,583,479,-104,104,1
"C07ZM",217,40,"1200x900",600,0,600,400,"True",143,513,542,29,29,0
"C07ZM",218,384,"1200x900",800,2,600,400,"True",821,707,635,-72,72,0
"C07ZM",219,461,"1200x900",1000,0,600,400,"False",95,711,600,-111,111,1
"C07ZM",220,583,"1200x900",1000,2,600,400,"False",949,284,651,367,367,1
"C07ZM",221,84,"1200x900",600,1,600,400,"False",144,184,301,117,117,0
"C07ZM",222,582,"1200x900",1000,2,600,400,"True",554,347,380,33,33,0
"C07ZM",223,182,"1200x900",600,2,600,400,"True",933,389,447,58,58,0
"C07ZM",224,34,"1200x900",600,0,600,400,"False",361,242,160,-82,82,1
"C07ZM",225,258,"1200x900",800,0,600,400,"True",126,664,650,-14,14,1
"C07ZM",226,486,"1200x900",1000,0,600,400,"False",102,676,556,-120,120,1
"C07ZM",227,456,"1200x900",1000,0,600,400,"True",91,257,219,-38,38,1
"C07ZM",228,12,"1200x900",600,0,600,400,"False",365,336,538,202,202,1
"C07ZM",229,309,"1200x900",800,1,600,400,"False",186,225,551,326,326,0
"C07ZM",230,482,"1200x900",1000,0,600,400,"False",79,686,610,-76,76,1
"C07ZM",231,57,"1200x900",600,0,600,400,"True",354,508,479,-29,29,1
"C07ZM",232,80,"1200x900",600,1,600,400,"False",616,423,724,301,301,1
"C07ZM",233,27,"1200x900",600,0,600,400,"False",373,309,376,67,67,1
"C07ZM",234,348,"1200x900",800,1,600,400,"True",764,294,313,19,19,0
"C07ZM",235,128,"1200x900",600,1,600,400,"True",661,258,374,116,116,1
"C07ZM",236,242,"1200x900",800,0,600,400,"False",117,448,361,-87,87,1
"C07ZM",237,416,"1200x900",800,2,600,400,"False",748,617,366,-251,251,0
"C07ZM",238,55,"1200x900",600,0,600,400,"False",211,305,479,174,174,1
"C07ZM",239,137,"1200x900",600,1,600,400,"False",789,577,338,-239,239,0
"C07ZM",240,629,"1200x900",1000,2,600,400,"False",681,257,425,168,168,0
"C07ZM",241,298,"1200x900",800,1,600,400,"False",311,457,271,-186,186,0
"C07ZM",242,317,"1200x900",800,1,600,400,"False",185,564,760,196,196,0
"C07ZM",243,386,"1200x900",800,2,600,400,"True",774,301,421,120,120,0
"C07ZM",244,380,"1200x900",800,2,600,400,"False",942,228,440,212,212,0
"C07ZM",245,105,"1200x900",600,1,600,400,"False",527,440,757,317,317,0
"C07ZM",246,16,"1200x900",600,0,600,400,"False",297,514,727,213,213,1
"C07ZM",247,263,"1200x900",800,0,600,400,"True",82,396,460,64,64,1
"C07ZM",248,399,"1200x900",800,2,600,400,"True",603,602,558,-44,44,0
"C07ZM",249,532,"1200x900",1000,1,600,400,"False",215,207,433,226,226,0
"C07ZM",250,509,"1200x900",1000,1,600,400,"False",509,434,580,146,146,0
"C07ZM",251,510,"1200x900",1000,1,600,400,"True",486,338,467,129,129,1
"C07ZM",252,164,"1200x900",600,2,600,400,"True",1051,268,261,-7,7,0
"C07ZM",253,605,"1200x900",1000,2,600,400,"False",493,665,581,-84,84,0
"C07ZM",254,26,"1200x900",600,0,600,400,"False",70,712,538,-174,174,0
"C07ZM",255,381,"1200x900",800,2,600,400,"False",705,408,805,397,397,0
"C07ZM",256,14,"1200x900",600,0,600,400,"False",399,224,413,189,189,1
"C07ZM",257,358,"1200x900",800,1,600,400,"False",263,635,451,-184,184,0
"C07ZM",258,91,"1200x900",600,1,600,400,"True",417,630,559,-71,71,1
"C07ZM",259,639,"1200x900",1000,2,600,400,"False",504,456,702,246,246,0
"C07ZM",260,156,"1200x900",600,2,600,400,"False",913,197,608,411,411,0
"C07ZM",261,230,"1200x900",800,0,600,400,"True",99,678,699,21,21,1
"C07ZM",262,550,"1200x900",1000,1,600,400,"True",301,459,499,40,40,0
"C07ZM",263,171,"1200x900",600,2,600,400,"False",909,200,647,447,447,0
"C07ZM",264,149,"1200x900",600,2,600,400,"False",890,289,183,-106,106,0
"C07ZM",265,304,"1200x900",800,1,600,400,"False",667,605,519,-86,86,0
"C07ZM",266,160,"1200x900",600,2,600,400,"True",863,606,642,36,36,0
"C07ZM",267,339,"1200x900",800,1,600,400,"True",273,545,518,-27,27,1
"C07ZM",268,392,"1200x900",800,2,600,400,"True",1031,618,722,104,104,0
"C07ZM",269,436,"1200x900",1000,0,600,400,"True",82,617,518,-99,99,1
"C07ZM",270,2,"1200x900",600,0,600,400,"False",159,323,506,183,183,0
"C07ZM",271,556,"1200x900",1000,1,600,400,"False",415,420,704,284,284,0
"C07ZM",272,471,"1200x900",1000,0,600,400,"False",122,200,505,305,305,1
"C07ZM",273,642,"1200x900",1000,2,600,400,"False",776,316,786,470,470,0
"C07ZM",274,255,"1200x900",800,0,600,400,"True",93,709,626,-83,83,1
"C07ZM",275,318,"1200x900",800,1,600,400,"True",788,534,551,17,17,0
"C07ZM",276,165,"1200x900",600,2,600,400,"True",912,554,578,24,24,0
"C07ZM",277,28,"1200x900",600,0,600,400,"False",336,410,305,-105,105,1
"C07ZM",278,538,"1200x900",1000,1,600,400,"True",308,457,511,54,54,1
"C07ZM",279,119,"1200x900",600,1,600,400,"False",168,563,424,-139,139,0
"C07ZM",280,198,"1200x900",600,2,600,400,"True",976,500,474,-26,26,0
"C07ZM",281,36,"1200x900",600,0,600,400,"False",128,346,448,102,102,1
"C07ZM",282,234,"1200x900",800,0,600,400,"True",72,344,344,0,0,1
"C07ZM",283,534,"1200x900",1000,1,600,400,"False",328,504,734,230,230,1
"C07ZM",284,94,"1200x900",600,1,600,400,"True",729,482,425,-57,57,0
"C07ZM",285,88,"1200x900",600,1,600,400,"True",186,554,615,61,61,0
"C07ZM",286,405,"1200x900",800,2,600,400,"False",790,307,677,370,370,0
"C07ZM",287,563,"1200x900",1000,1,600,400,"False",201,696,272,-424,424,0
"C07ZM",288,480,"1200x900",1000,0,600,400,"False",100,231,358,127,127,1
"C07ZM",289,184,"1200x900",600,2,600,400,"False",1067,441,650,209,209,0
"C07ZM",290,590,"1200x900",1000,2,600,400,"False",636,278,589,311,311,0
"C07ZM",291,602,"1200x900",1000,2,600,400,"True",865,452,505,53,53,0
"C07ZM",292,82,"1200x900",600,1,600,400,"False",108,213,659,446,446,0
"C07ZM",293,448,"1200x900",1000,0,600,400,"False",107,641,394,-247,247,1
"C07ZM",294,260,"1200x900",800,0,600,400,"False",103,525,741,216,216,1
"C07ZM",295,353,"1200x900",800,1,600,400,"False",90,476,539,63,63,0
"C07ZM",296,221,"1200x900",800,0,600,400,"True",132,520,577,57,57,1
"C07ZM",297,285,"1200x900",800,0,600,400,"True",237,396,408,12,12,1
"C07ZM",298,146,"1200x900",600,2,600,400,"False",989,492,591,99,99,0
"C07ZM",299,113,"1200x900",600,1,600,400,"False",897,657,403,-254,254,0
"C07ZM",300,645,"1200x900",1000,2,600,400,"False",619,396,277,-119,119,0
"C07ZM",301,268,"1200x900",800,0,600,400,"True",148,400,425,25,25,1
"C07ZM",302,584,"1200x900",1000,2,600,400,"False",731,413,520,107,107,0
"C07ZM",303,65,"1200x900",600,0,600,400,"True",442,645,700,55,55,1
"C07ZM",304,305,"1200x900",800,1,600,400,"False",471,716,510,-206,206,0
"C07ZM",305,31,"1200x900",600,0,600,400,"True",365,338,357,19,19,1
"C07ZM",306,1,"1200x900",600,0,600,400,"True",136,502,517,15,15,0
"C07ZM",307,372,"1200x900",800,2,600,400,"False",833,620,378,-242,242,0
"C07ZM",308,299,"1200x900",800,1,600,400,"False",779,274,624,350,350,0
"C07ZM",309,257,"1200x900",800,0,600,400,"True",97,219,267,48,48,1
"C07ZM",310,460,"1200x900",1000,0,600,400,"True",155,189,148,-41,41,1
"C07ZM",311,495,"1200x900",1000,0,600,400,"False",93,692,488,-204,204,1
"C07ZM",312,72,"1200x900",600,0,600,400,"True",158,537,516,-21,21,0
"C07ZM",313,25,"1200x900",600,0,600,400,"True",263,403,419,16,16,1
"C07ZM",314,6,"1200x900",600,0,600,400,"False",217,689,556,-133,133,1
"C07ZM",315,476,"1200x900",1000,0,600,400,"False",76,359,497,138,138,1
"C07ZM",316,39,"1200x900",600,0,600,400,"True",210,609,584,-25,25,0
"C07ZM",317,59,"1200x900",600,0,600,400,"True",391,692,674,-18,18,1
"C07ZM",318,451,"1200x900",1000,0,600,400,"False",110,702,561,-141,141,1
"C07ZM",319,431,"1200x900",800,2,600,400,"False",694,382,452,70,70,0
"C07ZM",320,499,"1200x900",1000,0,600,400,"False",93,271,425,154,154,1
"C07ZM",321,400,"1200x900",800,2,600,400,"False",733,297,510,213,213,0
"C07ZM",322,547,"1200x900",1000,1,600,400,"False",369,384,459,75,75,1
"C07ZM",323,382,"1200x900",800,2,600,400,"True",870,523,524,1,1,0
"C07ZM",324,414,"1200x900",800,2,600,400,"False",831,592,467,-125,125,0
"C07ZM",325,103,"1200x900",600,1,600,400,"False",528,320,423,103,103,1
"C07ZM",326,180,"1200x900",600,2,600,400,"True",929,270,221,-49,49,0
"C07ZM",327,75,"1200x900",600,1,600,400,"False",635,558,352,-206,206,0
"C07ZM",328,342,"1200x900",800,1,600,400,"False",677,204,389,185,185,0
"C07ZM",329,377,"1200x900",800,2,600,400,"False",683,388,483,95,95,0
"C07ZM",330,32,"1200x900",600,0,600,400,"True",152,563,568,5,5,1
"C07ZM",331,521,"1200x900",1000,1,600,400,"False",111,303,647,344,344,1
"C07ZM",332,398,"1200x900",800,2,600,400,"False",944,698,513,-185,185,0
"C07ZM",333,10,"1200x900",600,0,600,400,"False",400,499,417,-82,82,1
"C07ZM",334,440,"1200x900",1000,0,600,400,"False",71,237,499,262,262,1
"C07ZM",335,150,"1200x900",600,2,600,400,"False",897,345,586,241,241,0
"C07ZM",336,300,"1200x900",800,1,600,400,"False",620,693,607,-86,86,0
"C07ZM",337,529,"1200x900",1000,1,600,400,"False",267,412,308,-104,104,1
"C07ZM",338,559,"1200x900",1000,1,600,400,"False",641,244,437,193,193,0
"C07ZM",339,64,"1200x900",600,0,600,400,"True",102,339,333,-6,6,0
"C07ZM",340,402,"1200x900",800,2,600,400,"False",878,234,437,203,203,0
"C07ZM",341,446,"1200x900",1000,0,600,400,"False",72,298,492,194,194,1
"C07ZM",342,115,"1200x900",600,1,600,400,"True",545,307,413,106,106,0
"C07ZM",343,410,"1200x900",800,2,600,400,"False",916,477,371,-106,106,0
"C07ZM",344,579,"1200x900",1000,2,600,400,"False",803,394,529,135,135,0
"C07ZM",345,361,"1200x900",800,2,600,400,"False",931,328,244,-84,84,0
"C07ZM",346,445,"1200x900",1000,0,600,400,"False",78,302,370,68,68,1
"C07ZM",347,469,"1200x900",1000,0,600,400,"False",73,227,319,92,92,1
"C07ZM",348,477,"1200x900",1000,0,600,400,"False",88,640,439,-201,201,1
"C07ZM",349,33,"1200x900",600,0,600,400,"True",198,533,557,24,24,1
"C07ZM",350,641,"1200x900",1000,2,600,400,"False",897,272,609,337,337,0
"C07ZM",351,450,"1200x900",1000,0,600,400,"False",130,204,324,120,120,1
"C07ZM",352,606,"1200x900",1000,2,600,400,"True",653,627,598,-29,29,0
"C07ZM",353,474,"1200x900",1000,0,600,400,"False",85,339,442,103,103,1
"C07ZM",354,330,"1200x900",800,1,600,400,"False",759,301,211,-90,90,1
"C07ZM",355,240,"1200x900",800,0,600,400,"False",330,656,442,-214,214,1
"C07ZM",356,162,"1200x900",600,2,600,400,"True",849,279,294,15,15,0
"C07ZM",357,351,"1200x900",800,1,600,400,"False",122,581,345,-236,236,0
"C07ZM",358,125,"1200x900",600,1,600,400,"True",750,531,579,48,48,0
"C07ZM",359,310,"1200x900",800,1,600,400,"True",559,592,612,20,20,0
"C07ZM",360,433,"1200x900",1000,0,600,400,"False",76,222,410,188,188,1
"C07ZM",361,293,"1200x900",800,1,600,400,"True",561,396,374,-22,22,0
"C07ZM",362,615,"1200x900",1000,2,600,400,"False",736,634,721,87,87,0
"C07ZM",363,437,"1200x900",1000,0,600,400,"False",74,667,494,-173,173,1
"C07ZM",364,297,"1200x900",800,1,600,400,"False",625,244,382,138,138,0
"C07ZM",365,644,"1200x900",1000,2,600,400,"False",495,486,754,268,268,0
"C07ZM",366,524,"1200x900",1000,1,600,400,"True",534,470,381,-89,89,0
"C07ZM",367,609,"1200x900",1000,2,600,400,"False",697,627,349,-278,278,0
"C07ZM",368,447,"1200x900",1000,0,600,400,"False",71,339,501,162,162,1
"C07ZM",369,557,"1200x900",1000,1,600,400,"False",677,505,716,211,211,1
"C07ZM",370,220,"1200x900",800,0,600,400,"False",108,699,586,-113,113,1
"C07ZM",371,633,"1200x900",1000,2,600,400,"False",564,253,698,445,445,0
"C07ZM",372,571,"1200x900",1000,1,600,400,"True",239,522,472,-50,50,1
"C07ZM",373,643,"1200x900",1000,2,600,400,"True",740,325,355,30,30,0
"C07ZM",374,326,"1200x900",800,1,600,400,"False",103,482,670,188,188,0
"C07ZM",375,387,"1200x900",800,2,600,400,"False",990,444,291,-153,153,0
"C07ZM",376,588,"1200x900",1000,2,600,400,"False",585,350,239,-111,111,0
"C07ZM",377,585,"1200x900",1000,2,600,400,"False",698,688,598,-90,90,1
"C07ZM",378,323,"1200x900",800,1,600,400,"True",388,348,394,46,46,0
"C07ZM",379,79,"1200x900",600,1,600,400,"True",731,289,291,2,2,0
"C07ZM",380,35,"1200x900",600,0,600,400,"True",366,555,514,-41,41,1
"C07ZM",381,595,"1200x900",1000,2,600,400,"False",687,640,311,-329,329,0
"C07ZM",382,566,"1200x900",1000,1,600,400,"True",378,472,503,31,31,1
"C07ZM",383,70,"1200x900",600,0,600,400,"True",309,703,639,-64,64,1
"C07ZM",384,307,"1200x900",800,1,600,400,"False",716,247,519,272,272,0
"C07ZM",385,586,"1200x900",1000,2,600,400,"False",802,262,327,65,65,0
"C07ZM",386,209,"1200x900",600,2,600,400,"False",937,637,537,-100,100,0
"C07ZM",387,425,"1200x900",800,2,600,400,"False",621,438,635,197,197,0
"C07ZM",388,452,"1200x900",1000,0,600,400,"False",97,273,496,223,223,1
"C07ZM",389,274,"1200x900",800,0,600,400,"False",146,497,647,150,150,1
"C07ZM",390,490,"1200x900",1000,0,600,400,"False",114,183,361,178,178,1
"C07ZM",391,130,"1200x900",600,1,600,400,"False",741,428,511,83,83,0
"C07ZM",392,634,"1200x900",1000,2,600,400,"False",735,313,204,-109,109,0
"C07ZM",393,7,"1200x900",600,0,600,400,"False",431,654,439,-215,215,1
"C07ZM",394,289,"1200x900",800,1,600,400,"True",421,703,643,-60,60,1
"C07ZM",395,272,"1200x900",800,0,600,400,"False",200,181,270,89,89,1
"C07ZM",396,636,"1200x900",1000,2,600,400,"False",575,583,276,-307,307,0
"C07ZM",397,294,"1200x900",800,1,600,400,"False",262,287,551,264,264,0
"C07ZM",398,648,"1200x900",1000,2,600,400,"False",557,394,254,-140,140,0
"C07ZM",399,537,"1200x900",1000,1,600,400,"False",621,412,648,236,236,1
"C07ZM",400,455,"1200x900",1000,0,600,400,"False",107,718,443,-275,275,1
"C07ZM",401,514,"1200x900",1000,1,600,400,"True",539,690,652,-38,38,0
"C07ZM",402,522,"1200x900",1000,1,600,400,"False",223,379,636,257,257,0
"C07ZM",403,565,"1200x900",1000,1,600,400,"False",451,562,200,-362,362,0
"C07ZM",404,593,"1200x900",1000,2,600,400,"False",246,719,484,-235,235,0
"C07ZM",405,594,"1200x900",1000,2,600,400,"True",537,637,593,-44,44,0
"C07ZM",406,196,"1200x900",600,2,600,400,"False",1030,397,757,360,360,0
"C07ZM",407,173,"1200x900",600,2,600,400,"False",948,693,567,-126,126,0
"C07ZM",408,430,"1200x900",800,2,600,400,"True",922,254,230,-24,24,0
"C07ZM",409,428,"1200x900",800,2,600,400,"False",732,665,544,-121,121,0
"C07ZM",410,420,"1200x900",800,2,600,400,"False",519,223,606,383,383,0
"C07ZM",411,217,"1200x900",800,0,600,400,"True",85,573,627,54,54,1
"C07ZM",412,362,"1200x900",800,2,600,400,"False",819,338,436,98,98,0
"C07ZM",413,473,"1200x900",1000,0,600,400,"False",75,323,432,109,109,1
"C07ZM",414,591,"1200x900",1000,2,600,400,"False",698,336,564,228,228,0
"C07ZM",415,203,"1200x900",600,2,600,400,"True",938,603,539,-64,64,0
"C07ZM",416,368,"1200x900",800,2,600,400,"True",778,515,558,43,43,0
"C07ZM",417,580,"1200x900",1000,2,600,400,"True",651,267,307,40,40,0
"C07ZM",418,616,"1200x900",1000,2,600,400,"False",854,357,221,-136,136,1
"C07ZM",419,373,"1200x900",800,2,600,400,"False",694,326,553,227,227,0
"C07ZM",420,38,"1200x900",600,0,600,400,"False",120,628,533,-95,95,1
"C07ZM",421,23,"1200x900",600,0,600,400,"True",308,463,464,1,1,1
"C07ZM",422,623,"1200x900",1000,2,600,400,"True",636,527,557,30,30,0
"C07ZM",423,155,"1200x900",600,2,600,400,"False",940,269,441,172,172,0
"C07ZM",424,283,"1200x900",800,0,600,400,"False",90,264,191,-73,73,1
"C07ZM",425,148,"1200x900",600,2,600,400,"True",907,330,312,-18,18,0
"C07ZM",426,523,"1200x900",1000,1,600,400,"False",339,318,237,-81,81,0
"C07ZM",427,483,"1200x900",1000,0,600,400,"False",93,191,322,131,131,1
"C07ZM",428,154,"1200x900",600,2,600,400,"False",941,454,366,-88,88,0
"C07ZM",429,379,"1200x900",800,2,600,400,"False",994,325,572,247,247,0
"C07ZM",430,360,"1200x900",800,1,600,400,"False",203,608,763,155,155,0
"C07ZM",431,224,"1200x900",800,0,600,400,"False",161,474,564,90,90,1
"C07ZM",432,123,"1200x900",600,1,600,400,"True",761,365,262,-103,103,1
"C07ZM",433,267,"1200x900",800,0,600,400,"True",145,665,694,29,29,1
"C07ZM",434,189,"1200x900",600,2,600,400,"False",881,397,524,127,127,0
"C07ZM",435,412,"1200x900",800,2,600,400,"False",842,280,477,197,197,0
"C07ZM",436,568,"1200x900",1000,1,600,400,"False",286,475,699,224,224,1
"C07ZM",437,301,"1200x900",800,1,600,400,"False",162,574,762,188,188,0
"C07ZM",438,143,"1200x900",600,1,600,400,"False",479,284,505,221,221,1
"C07ZM",439,54,"1200x900",600,0,600,400,"False",474,564,380,-184,184,1
"C07ZM",440,179,"1200x900",600,2,600,400,"True",908,602,532,-70,70,0
"C07ZM",441,404,"1200x900",800,2,600,400,"True",842,396,466,70,70,0
"C07ZM",442,578,"1200x900",1000,2,600,400,"False",966,276,411,135,135,0
"C07ZM",443,192,"1200x900",600,2,600,400,"False",1064,320,143,-177,177,0
"C07ZM",444,186,"1200x900",600,2,600,400,"False",997,197,313,116,116,0
"C07ZM",445,439,"1200x900",1000,0,600,400,"True",110,229,180,-49,49,1
"C07ZM",446,50,"1200x900",600,0,600,400,"False",75,582,518,-64,64,0
"C07ZM",447,114,"1200x900",600,1,600,400,"True",183,697,598,-99,99,0
"C07ZM",448,87,"1200x900",600,1,600,400,"True",231,604,560,-44,44,0
"C07ZM",449,158,"1200x900",600,2,600,400,"True",939,300,351,51,51,0
"C07ZM",450,409,"1200x900",800,2,600,400,"True",501,659,712,53,53,0
"C07ZM",451,612,"1200x900",1000,2,600,400,"False",706,198,356,158,158,0
"C07ZM",452,176,"1200x900",600,2,600,400,"True",1033,281,255,-26,26,0
"C07ZM",453,647,"1200x900",1000,2,600,400,"True",560,637,622,-15,15,0
"C07ZM",454,175,"1200x900",600,2,600,400,"False",1028,432,361,-71,71,0
"C07ZM",455,211,"1200x900",600,2,600,400,"False",986,407,515,108,108,0
"C07ZM",456,46,"1200x900",600,0,600,400,"True",193,355,357,2,2,1
"C07ZM",457,320,"1200x900",800,1,600,400,"True",644,376,410,34,34,0
"C07ZM",459,56,"1200x900",600,0,600,400,"True",148,491,546,55,55,0
"C07ZM",460,504,"1200x900",1000,0,600,400,"False",107,699,475,-224,224,1
"C07ZM",461,396,"1200x900",800,2,600,400,"False",678,663,369,-294,294,0
"C07ZM",462,210,"1200x900",600,2,600,400,"True",835,506,518,12,12,0
"C07ZM",463,51,"1200x900",600,0,600,400,"True",272,181,178,-3,3,1
"C07ZM",464,479,"1200x900",1000,0,600,400,"False",74,705,443,-262,262,1
"C07ZM",465,543,"1200x900",1000,1,600,400,"False",88,202,559,357,357,0
"C07ZM",466,281,"1200x900",800,0,600,400,"True",112,611,635,24,24,1
"C07ZM",467,549,"1200x900",1000,1,600,400,"False",657,366,528,162,162,0
"C07ZM",468,159,"1200x900",600,2,600,400,"True",992,309,286,-23,23,0
"C07ZM",469,315,"1200x900",800,1,600,400,"False",105,211,398,187,187,0
"C07ZM",470,273,"1200x900",800,0,600,400,"False",180,309,442,133,133,1
"C07ZM",471,161,"1200x900",600,2,600,400,"True",939,553,593,40,40,0
"C07ZM",472,81,"1200x900",600,1,600,400,"False",696,225,378,153,153,0
"C07ZM",473,37,"1200x900",600,0,600,400,"True",258,403,345,-58,58,1
"C07ZM",474,517,"1200x900",1000,1,600,400,"False",548,182,265,83,83,0
"C07ZM",475,640,"1200x900",1000,2,600,400,"True",361,334,356,22,22,0
"C07ZM",476,598,"1200x900",1000,2,600,400,"True",706,559,512,-47,47,0
"C07ZM",477,166,"1200x900",600,2,600,400,"True",896,274,302,28,28,0
"C07ZM",478,424,"1200x900",800,2,600,400,"False",903,545,448,-97,97,0
"C07ZM",479,581,"1200x900",1000,2,600,400,"False",310,357,242,-115,115,0
"C07ZM",480,374,"1200x900",800,2,600,400,"True",755,450,404,-46,46,0
"C07ZM",481,418,"1200x900",800,2,600,400,"True",754,507,525,18,18,0
"C07ZM",482,345,"1200x900",800,1,600,400,"True",841,566,600,34,34,1
"C07ZM",483,481,"1200x900",1000,0,600,400,"False",80,185,281,96,96,1
"C07ZM",484,237,"1200x900",800,0,600,400,"True",204,481,516,35,35,1
"C07ZM",485,371,"1200x900",800,2,600,400,"False",730,560,382,-178,178,0
"C07ZM",486,528,"1200x900",1000,1,600,400,"False",839,227,742,515,515,1
"C07ZM",487,247,"1200x900",800,0,600,400,"False",160,424,579,155,155,1
"C07ZM",488,489,"1200x900",1000,0,600,400,"False",88,604,448,-156,156,1
"C07ZM",489,218,"1200x900",800,0,600,400,"False",106,397,495,98,98,1
"C07ZM",490,341,"1200x900",800,1,600,400,"True",735,632,595,-37,37,1
"C07ZM",491,302,"1200x900",800,1,600,400,"False",479,467,678,211,211,1
"C07ZM",492,216,"1200x900",600,2,600,400,"False",1029,286,513,227,227,0
"C07ZM",493,614,"1200x900",1000,2,600,400,"True",823,563,554,-9,9,0
"C07ZM",494,13,"1200x900",600,0,600,400,"False",296,211,400,189,189,1
"C07ZM",495,389,"1200x900",800,2,600,400,"True",843,530,534,4,4,0
"C07ZM",496,422,"1200x900",800,2,600,400,"True",712,558,493,-65,65,0
"C07ZM",497,429,"1200x900",800,2,600,400,"True",682,692,627,-65,65,0
"C07ZM",498,279,"1200x900",800,0,600,400,"False",252,202,527,325,325,1
"C07ZM",499,138,"1200x900",600,1,600,400,"True",844,580,554,-26,26,1
"C07ZM",500,214,"1200x900",600,2,600,400,"False",1046,305,417,112,112,0
"C07ZM",501,97,"1200x900",600,1,600,400,"True",760,643,651,8,8,1
"C07ZM",502,415,"1200x900",800,2,600,400,"False",823,684,558,-126,126,0
"C07ZM",503,485,"1200x900",1000,0,600,400,"False",121,694,492,-202,202,1
"C07ZM",504,311,"1200x900",800,1,600,400,"False",710,261,597,336,336,0
"C07ZM",505,89,"1200x900",600,1,600,400,"False",917,366,606,240,240,1
"C07ZM",506,526,"1200x900",1000,1,600,400,"False",497,710,553,-157,157,0
"C07ZM",507,572,"1200x900",1000,1,600,400,"False",302,260,487,227,227,0
"C07ZM",508,388,"1200x900",800,2,600,400,"False",930,320,694,374,374,0
"C07ZM",509,308,"1200x900",800,1,600,400,"True",437,425,465,40,40,0
"C07ZM",510,172,"1200x900",600,2,600,400,"False",912,444,591,147,147,0
"C07ZM",511,275,"1200x900",800,0,600,400,"False",120,594,500,-94,94,0
"C07ZM",512,487,"1200x900",1000,0,600,400,"False",78,670,427,-243,243,1
"C07ZM",513,252,"1200x900",800,0,600,400,"True",224,673,749,76,76,1
"C07ZM",514,438,"1200x900",1000,0,600,400,"False",77,713,532,-181,181,1
"C07ZM",515,530,"1200x900",1000,1,600,400,"False",584,405,250,-155,155,1
"C07ZM",516,227,"1200x900",800,0,600,400,"True",196,551,503,-48,48,1
"C07ZM",517,284,"1200x900",800,0,600,400,"False",135,293,374,81,81,1
"C07ZM",518,290,"1200x900",800,1,600,400,"True",789,603,580,-23,23,0
"C07ZM",519,426,"1200x900",800,2,600,400,"True",830,263,270,7,7,0
"C07ZM",520,95,"1200x900",600,1,600,400,"True",749,425,357,-68,68,1
"C07ZM",521,365,"1200x900",800,2,600,400,"True",1055,305,242,-63,63,0
"C07ZM",522,248,"1200x900",800,0,600,400,"False",94,240,425,185,185,1
"C07ZM",523,233,"1200x900",800,0,600,400,"False",164,700,588,-112,112,1
"C07ZM",524,200,"1200x900",600,2,600,400,"False",897,302,646,344,344,0
"C07ZM",525,101,"1200x900",600,1,600,400,"False",541,656,449,-207,207,0
"C07ZM",526,419,"1200x900",800,2,600,400,"False",769,351,571,220,220,0
"C07ZM",527,124,"1200x900",600,1,600,400,"True",345,467,542,75,75,0
"C07ZM",528,435,"1200x900",1000,0,600,400,"False",119,200,331,131,131,1
"C07ZM",529,349,"1200x900",800,1,600,400,"False",402,665,746,81,81,0
"C07ZM",530,136,"1200x900",600,1,600,400,"True",264,205,199,-6,6,0
"C07ZM",531,15,"1200x900",600,0,600,400,"False",473,352,480,128,128,1
"C07ZM",532,223,"1200x900",800,0,600,400,"True",179,191,192,1,1,1
"C07ZM",533,548,"1200x900",1000,1,600,400,"False",103,278,631,353,353,0
"C07ZM",534,96,"1200x900",600,1,600,400,"False",433,458,324,-134,134,0
"C07ZM",535,637,"1200x900",1000,2,600,400,"True",750,460,424,-36,36,0
"C07ZM",536,169,"1200x900",600,2,600,400,"False",924,290,615,325,325,0
"C07ZM",537,319,"1200x900",800,1,600,400,"True",494,587,591,4,4,1
"C07ZM",538,570,"1200x900",1000,1,600,400,"False",315,352,577,225,225,0
"C07ZM",539,512,"1200x900",1000,1,600,400,"False",139,261,552,291,291,0
"C07ZM",540,638,"1200x900",1000,2,600,400,"False",385,198,400,202,202,0
"C07ZM",541,199,"1200x900",600,2,600,400,"True",992,467,514,47,47,0
"C07ZM",542,478,"1200x900",1000,0,600,400,"False",79,672,391,-281,281,1
"C07ZM",543,390,"1200x900",800,2,600,400,"False",982,674,522,-152,152,1
"C07ZM",544,333,"1200x900",800,1,600,400,"False",521,548,672,124,124,0
"C07ZM",545,18,"1200x900",600,0,600,400,"True",400,318,352,34,34,1
"C07ZM",546,329,"1200x900",800,1,600,400,"False",517,239,316,77,77,0
"C07ZM",547,443,"1200x900",1000,0,600,400,"False",99,651,451,-200,200,1
"C07ZM",548,600,"1200x900",1000,2,600,400,"False",765,207,436,229,229,0
"C07ZM",549,322,"1200x900",800,1,600,400,"False",703,206,482,276,276,1
"C07ZM",550,596,"1200x900",1000,2,600,400,"False",706,513,648,135,135,0
"C07ZM",551,505,"1200x900",1000,1,600,400,"False",191,484,320,-164,164,1
"C07ZM",552,472,"1200x900",1000,0,600,400,"False",77,685,543,-142,142,1
"C07ZM",553,188,"1200x900",600,2,600,400,"False",900,195,347,152,152,0
"C07ZM",554,370,"1200x900",800,2,600,400,"False",874,336,258,-78,78,0
"C07ZM",555,488,"1200x900",1000,0,600,400,"False",129,687,590,-97,97,1
"C07ZM",556,19,"1200x900",600,0,600,400,"False",286,686,606,-80,80,0
"C07ZM",557,454,"1200x900",1000,0,600,400,"False",78,687,422,-265,265,1
"C07ZM",558,42,"1200x900",600,0,600,400,"True",233,479,442,-37,37,0
"C07ZM",559,551,"1200x900",1000,1,600,400,"True",146,445,494,49,49,1
"C07ZM",560,60,"1200x900",600,0,600,400,"False",365,213,301,88,88,1
"C07ZM",561,564,"1200x900",1000,1,600,400,"True",215,264,296,32,32,0
"C07ZM",562,325,"1200x900",800,1,600,400,"False",105,394,295,-99,99,0
"C07ZM",563,611,"1200x900",1000,2,600,400,"False",414,511,398,-113,113,0
"C07ZM",564,141,"1200x900",600,1,600,400,"False",671,582,486,-96,96,0
"C07ZM",565,111,"1200x900",600,1,600,400,"True",922,552,627,75,75,1
"C07ZM",566,628,"1200x900",1000,2,600,400,"False",768,410,509,99,99,0
"C07ZM",567,385,"1200x900",800,2,600,400,"False",740,456,525,69,69,0
"C07ZM",568,337,"1200x900",800,1,600,400,"True",299,622,535,-87,87,0
"C07ZM",569,494,"1200x900",1000,0,600,400,"False",127,692,593,-99,99,1
"C07ZM",570,280,"1200x900",800,0,600,400,"False",104,302,406,104,104,1
"C07ZM",571,413,"1200x900",800,2,600,400,"False",849,506,602,96,96,0
"C07ZM",572,71,"1200x900",600,0,600,400,"False",219,248,402,154,154,0
"C07ZM",573,63,"1200x900",600,0,600,400,"True",311,188,246,58,58,1
"C07ZM",574,177,"1200x900",600,2,600,400,"True",912,236,204,-32,32,0
"C07ZM",575,466,"1200x900",1000,0,600,400,"False",82,205,307,102,102,1
"C07ZM",577,597,"1200x900",1000,2,600,400,"True",352,239,226,-13,13,0
"C07ZM",578,395,"1200x900",800,2,600,400,"True",743,334,346,12,12,0
"C07ZM",579,122,"1200x900",600,1,600,400,"False",817,709,525,-184,184,0
"C07ZM",580,86,"1200x900",600,1,600,400,"False",692,388,479,91,91,1
"C07ZM",581,168,"1200x900",600,2,600,400,"False",1001,439,545,106,106,0
"C07ZM",582,624,"1200x900",1000,2,600,400,"True",693,501,548,47,47,0
"C07ZM",583,498,"1200x900",1000,0,600,400,"False",100,260,520,260,260,1
"C07ZM",584,117,"1200x900",600,1,600,400,"True",711,456,552,96,96,0
"C07ZM",585,134,"1200x900",600,1,600,400,"True",300,188,174,-14,14,0
"C07ZM",586,646,"1200x900",1000,2,600,400,"False",829,227,403,176,176,1
"C07ZM",587,104,"1200x900",600,1,600,400,"False",448,584,676,92,92,0
"C07ZM",588,567,"1200x900",1000,1,600,400,"True",655,297,410,113,113,1
"C07ZM",589,229,"1200x900",800,0,600,400,"True",117,697,740,43,43,1
"C07ZM",590,48,"1200x900",600,0,600,400,"False",323,645,516,-129,129,1
"C07ZM",591,607,"1200x900",1000,2,600,400,"False",900,573,727,154,154,1
"C07ZM",592,228,"1200x900",800,0,600,400,"False",174,687,599,-88,88,1
"C07ZM",593,496,"1200x900",1000,0,600,400,"False",70,639,281,-358,358,1
"C07ZM",594,140,"1200x900",600,1,600,400,"False",700,523,445,-78,78,0
"C07ZM",595,243,"1200x900",800,0,600,400,"True",114,332,386,54,54,1
"C07ZM",596,434,"1200x900",1000,0,600,400,"False",89,657,517,-140,140,1
"C07ZM",597,403,"1200x900",800,2,600,400,"False",625,704,244,-460,460,0
"C07ZM",598,574,"1200x900",1000,1,600,400,"False",614,194,498,304,304,0
"C07ZM",599,545,"1200x900",1000,1,600,400,"False",358,562,442,-120,120,0
"C07ZM",600,62,"1200x900",600,0,600,400,"True",345,346,320,-26,26,1
"C07ZM",601,441,"1200x900",1000,0,600,400,"False",85,684,436,-248,248,1
"C07ZM",602,444,"1200x900",1000,0,600,400,"False",101,714,536,-178,178,1
"C07ZM",603,157,"1200x900",600,2,600,400,"False",1016,323,687,364,364,0
"C07ZM",604,163,"1200x900",600,2,600,400,"True",1046,665,602,-63,63,0
"C07ZM",605,53,"1200x900",600,0,600,400,"False",177,189,265,76,76,0
"C07ZM",606,282,"1200x900",800,0,600,400,"False",109,246,322,76,76,1
"C07ZM",607,560,"1200x900",1000,1,600,400,"False",516,693,619,-74,74,0
"C07ZM",608,475,"1200x900",1000,0,600,400,"False",101,715,494,-221,221,1
"C07ZM",609,269,"1200x900",800,0,600,400,"False",160,295,424,129,129,1
"C07ZM",610,625,"1200x900",1000,2,600,400,"True",279,228,187,-41,41,0
"C07ZM",611,92,"1200x900",600,1,600,400,"False",624,605,522,-83,83,0
"C07ZM",612,393,"1200x900",800,2,600,400,"False",657,620,370,-250,250,0
"C07ZM",613,265,"1200x900",800,0,600,400,"True",229,353,395,42,42,1
"C07ZM",614,539,"1200x900",1000,1,600,400,"True",510,383,428,45,45,0
"C07ZM",615,68,"1200x900",600,0,600,400,"True",165,367,373,6,6,0
"C07ZM",616,152,"1200x900",600,2,600,400,"False",971,399,248,-151,151,0
"C07ZM",617,11,"1200x900",600,0,600,400,"False",372,670,533,-137,137,1
"C07ZM",618,250,"1200x900",800,0,600,400,"False",290,248,436,188,188,1
"C07ZM",619,292,"1200x900",800,1,600,400,"True",88,565,552,-13,13,0
"C07ZM",620,306,"1200x900",800,1,600,400,"False",164,524,681,157,157,0
"C07ZM",621,118,"1200x900",600,1,600,400,"True",190,588,513,-75,75,0
"C07ZM",622,334,"1200x900",800,1,600,400,"False",481,665,491,-174,174,0
"C07ZM",623,21,"1200x900",600,0,600,400,"True",314,383,448,65,65,1
"C07ZM",624,552,"1200x900",1000,1,600,400,"True",255,412,428,16,16,0
"C07ZM",625,484,"1200x900",1000,0,600,400,"False",100,223,389,166,166,1
"C07ZM",626,30,"1200x900",600,0,600,400,"True",107,353,392,39,39,0
"C07ZM",627,366,"1200x900",800,2,600,400,"False",931,464,576,112,112,0
"C07ZM",628,67,"1200x900",600,0,600,400,"False",289,308,388,80,80,1
"C07ZM",629,442,"1200x900",1000,0,600,400,"False",87,183,345,162,162,1
"C07ZM",630,493,"1200x900",1000,0,600,400,"False",80,582,445,-137,137,1
"C07ZM",631,266,"1200x900",800,0,600,400,"False",126,303,379,76,76,1
"C07ZM",632,527,"1200x900",1000,1,600,400,"False",565,601,297,-304,304,0
"C07ZM",633,241,"1200x900",800,0,600,400,"True",129,227,269,42,42,1
"C07ZM",634,76,"1200x900",600,1,600,400,"False",647,614,241,-373,373,0
"C07ZM",635,525,"1200x900",1000,1,600,400,"False",123,690,597,-93,93,0
"C07ZM",636,109,"1200x900",600,1,600,400,"False",691,589,490,-99,99,0
"C07ZM",637,336,"1200x900",800,1,600,400,"True",251,587,542,-45,45,0
"C07ZM",638,367,"1200x900",800,2,600,400,"True",613,464,466,2,2,0
"C07ZM",639,501,"1200x900",1000,0,600,400,"True",96,323,364,41,41,1
"C07ZM",640,99,"1200x900",600,1,600,400,"False",811,407,532,125,125,0
"C07ZM",641,244,"1200x900",800,0,600,400,"True",194,203,138,-65,65,1
"C07ZM",642,631,"1200x900",1000,2,600,400,"False",699,479,555,76,76,0
"C07ZM",643,316,"1200x900",800,1,600,400,"False",362,319,382,63,63,0
"C07ZM",644,147,"1200x900",600,2,600,400,"False",942,418,623,205,205,0
"C07ZM",645,144,"1200x900",600,1,600,400,"True",718,371,332,-39,39,0
"C07ZM",646,610,"1200x900",1000,2,600,400,"False",702,293,214,-79,79,0
"C07ZM",647,338,"1200x900",800,1,600,400,"False",813,253,334,81,81,1
"C07ZM",648,112,"1200x900",600,1,600,400,"False",681,490,415,-75,75,0
"C08YL",1,168,"1200x900",600,2,600,400,"False",1001,439,289,-150,150,0
"C08YL",2,605,"1200x900",1000,2,600,400,"False",493,665,323,-342,342,0
"C08YL",3,533,"1200x900",1000,1,600,400,"True",355,483,542,59,59,0
"C08YL",4,506,"1200x900",1000,1,600,400,"False",559,567,399,-168,168,1
"C08YL",5,568,"1200x900",1000,1,600,400,"False",286,475,610,135,135,1
"C08YL",6,608,"1200x900",1000,2,600,400,"False",742,250,457,207,207,0
"C08YL",7,508,"1200x900",1000,1,600,400,"True",596,485,475,-10,10,0
"C08YL",8,636,"1200x900",1000,2,600,400,"True",575,583,558,-25,25,0
"C08YL",9,520,"1200x900",1000,1,600,400,"True",564,260,235,-25,25,0
"C08YL",10,104,"1200x900",600,1,600,400,"False",448,584,673,89,89,0
"C08YL",11,248,"1200x900",800,0,600,400,"False",94,240,358,118,118,1
"C08YL",12,281,"1200x900",800,0,600,400,"False",112,611,522,-89,89,1
"C08YL",13,149,"1200x900",600,2,600,400,"True",890,289,323,34,34,0
"C08YL",14,606,"1200x900",1000,2,600,400,"True",653,627,580,-47,47,0
"C08YL",15,627,"1200x900",1000,2,600,400,"False",760,510,622,112,112,0
"C08YL",16,158,"1200x900",600,2,600,400,"True",939,300,295,-5,5,0
"C08YL",17,409,"1200x900",800,2,600,400,"False",501,659,543,-116,116,0
"C08YL",18,531,"1200x900",1000,1,600,400,"True",233,362,347,-15,15,0
"C08YL",19,589,"1200x900",1000,2,600,400,"False",856,418,595,177,177,0
"C08YL",20,274,"1200x900",800,0,600,400,"False",146,497,408,-89,89,1
"C08YL",21,241,"1200x900",800,0,600,400,"False",129,227,379,152,152,1
"C08YL",22,221,"1200x900",800,0,600,400,"False",132,520,324,-196,196,1
"C08YL",23,324,"1200x900",800,1,600,400,"False",719,712,587,-125,125,1
"C08YL",24,169,"1200x900",600,2,600,400,"False",924,290,410,120,120,0
"C08YL",25,637,"1200x900",1000,2,600,400,"True",750,460,472,12,12,0
"C08YL",26,323,"1200x900",800,1,600,400,"False",388,348,556,208,208,0
"C08YL",27,230,"1200x900",800,0,600,400,"False",99,678,610,-68,68,1
"C08YL",28,565,"1200x900",1000,1,600,400,"True",451,562,578,16,16,0
"C08YL",29,148,"1200x900",600,2,600,400,"False",907,330,464,134,134,0
"C08YL",30,204,"1200x900",600,2,600,400,"False",1053,432,325,-107,107,0
"C08YL",31,432,"1200x900",800,2,600,400,"False",792,380,260,-120,120,0
"C08YL",32,298,"1200x900",800,1,600,400,"False",311,457,595,138,138,0
"C08YL",33,449,"1200x900",1000,0,600,400,"False",105,683,578,-105,105,1
"C08YL",34,295,"1200x900",800,1,600,400,"False",471,334,207,-127,127,0
"C08YL",35,128,"1200x900",600,1,600,400,"True",661,258,302,44,44,1
"C08YL",36,43,"1200x900",600,0,600,400,"True",277,446,404,-42,42,1
"C08YL",37,412,"1200x900",800,2,600,400,"True",842,280,350,70,70,0
"C08YL",38,290,"1200x900",800,1,600,400,"True",789,603,617,14,14,0
"C08YL",39,90,"1200x900",600,1,600,400,"False",560,474,377,-97,97,0
"C08YL",40,408,"1200x900",800,2,600,400,"False",758,567,358,-209,209,0
"C08YL",41,98,"1200x900",600,1,600,400,"False",625,530,451,-79,79,0
"C08YL",42,91,"1200x900",600,1,600,400,"False",417,630,182,-448,448,1
"C08YL",43,385,"1200x900",800,2,600,400,"False",740,456,360,-96,96,0
"C08YL",44,296,"1200x900",800,1,600,400,"False",89,279,402,123,123,0
"C08YL",45,113,"1200x900",600,1,600,400,"True",897,657,715,58,58,0
"C08YL",46,570,"1200x900",1000,1,600,400,"True",315,352,409,57,57,0
"C08YL",47,496,"1200x900",1000,0,600,400,"False",70,639,544,-95,95,1
"C08YL",48,378,"1200x900",800,2,600,400,"False",1018,708,421,-287,287,0
"C08YL",49,135,"1200x900",600,1,600,400,"True",759,569,543,-26,26,0
"C08YL",50,622,"1200x900",1000,2,600,400,"False",307,683,355,-328,328,0
"C08YL",51,488,"1200x900",1000,0,600,400,"True",129,687,648,-39,39,1
"C08YL",52,185,"1200x900",600,2,600,400,"False",907,212,424,212,212,0
"C08YL",53,85,"1200x900",600,1,600,400,"False",434,347,453,106,106,0
"C08YL",54,287,"1200x900",800,0,600,400,"True",120,567,550,-17,17,1
"C08YL",55,153,"1200x900",600,2,600,400,"False",1037,601,496,-105,105,0
"C08YL",56,237,"1200x900",800,0,600,400,"True",204,481,475,-6,6,1
"C08YL",57,491,"1200x900",1000,0,600,400,"False",108,198,300,102,102,1
"C08YL",59,558,"1200x900",1000,1,600,400,"False",72,464,662,198,198,1
"C08YL",60,23,"1200x900",600,0,600,400,"True",308,463,475,12,12,1
"C08YL",61,164,"1200x900",600,2,600,400,"True",1051,268,343,75,75,0
"C08YL",62,198,"1200x900",600,2,600,400,"True",976,500,497,-3,3,0
"C08YL",63,101,"1200x900",600,1,600,400,"False",541,656,458,-198,198,0
"C08YL",64,438,"1200x900",1000,0,600,400,"False",77,713,642,-71,71,1
"C08YL",65,527,"1200x900",1000,1,600,400,"False",565,601,492,-109,109,0
"C08YL",66,24,"1200x900",600,0,600,400,"False",430,538,458,-80,80,1
"C08YL",68,160,"1200x900",600,2,600,400,"True",863,606,604,-2,2,0
"C08YL",69,422,"1200x900",800,2,600,400,"False",712,558,454,-104,104,0
"C08YL",70,263,"1200x900",800,0,600,400,"True",82,396,439,43,43,1
"C08YL",71,229,"1200x900",800,0,600,400,"True",117,697,654,-43,43,1
"C08YL",72,328,"1200x900",800,1,600,400,"False",104,649,719,70,70,0
"C08YL",73,566,"1200x900",1000,1,600,400,"True",378,472,505,33,33,1
"C08YL",74,294,"1200x900",800,1,600,400,"False",262,287,523,236,236,0
"C08YL",75,2,"1200x900",600,0,600,400,"True",159,323,343,20,20,0
"C08YL",76,260,"1200x900",800,0,600,400,"True",103,525,551,26,26,1
"C08YL",77,647,"1200x900",1000,2,600,400,"False",560,637,361,-276,276,0
"C08YL",78,146,"1200x900",600,2,600,400,"False",989,492,398,-94,94,0
"C08YL",79,578,"1200x900",1000,2,600,400,"False",966,276,571,295,295,0
"C08YL",80,499,"1200x900",1000,0,600,400,"True",93,271,312,41,41,1
"C08YL",81,478,"1200x900",1000,0,600,400,"False",79,672,525,-147,147,1
"C08YL",82,538,"1200x900",1000,1,600,400,"False",308,457,296,-161,161,1
"C08YL",83,615,"1200x900",1000,2,600,400,"False",736,634,418,-216,216,0
"C08YL",84,127,"1200x900",600,1,600,400,"True",309,691,609,-82,82,0
"C08YL",85,474,"1200x900",1000,0,600,400,"True",85,339,388,49,49,1
"C08YL",86,162,"1200x900",600,2,600,400,"False",849,279,487,208,208,0
"C08YL",87,192,"1200x900",600,2,600,400,"False",1064,320,667,347,347,0
"C08YL",88,100,"1200x900",600,1,600,400,"False",453,511,206,-305,305,0
"C08YL",89,379,"1200x900",800,2,600,400,"False",994,325,484,159,159,0
"C08YL",90,112,"1200x900",600,1,600,400,"False",681,490,295,-195,195,0
"C08YL",91,58,"1200x900",600,0,600,400,"False",353,655,546,-109,109,1
"C08YL",92,1,"1200x900",600,0,600,400,"True",136,502,487,-15,15,0
"C08YL",93,9,"1200x900",600,0,600,400,"True",509,654,645,-9,9,1
"C08YL",94,561,"1200x900",1000,1,600,400,"False",231,406,582,176,176,0
"C08YL",95,238,"1200x900",800,0,600,400,"True",162,283,307,24,24,1
"C08YL",96,145,"1200x900",600,2,600,400,"False",1004,630,530,-100,100,0
"C08YL",97,553,"1200x900",1000,1,600,400,"False",116,712,361,-351,351,0
"C08YL",98,391,"1200x900",800,2,600,400,"True",895,521,547,26,26,0
"C08YL",99,386,"1200x900",800,2,600,400,"True",774,301,298,-3,3,0
"C08YL",100,213,"1200x900",600,2,600,400,"False",822,275,393,118,118,0
"C08YL",101,494,"1200x900",1000,0,600,400,"False",127,692,545,-147,147,1
"C08YL",102,362,"1200x900",800,2,600,400,"False",819,338,475,137,137,0
"C08YL",103,87,"1200x900",600,1,600,400,"True",231,604,545,-59,59,0
"C08YL",104,562,"1200x900",1000,1,600,400,"False",347,540,466,-74,74,0
"C08YL",105,74,"1200x900",600,1,600,400,"False",115,358,229,-129,129,0
"C08YL",106,593,"1200x900",1000,2,600,400,"False",246,719,556,-163,163,0
"C08YL",107,214,"1200x900",600,2,600,400,"True",1046,305,393,88,88,0
"C08YL",108,60,"1200x900",600,0,600,400,"False",365,213,280,67,67,1
"C08YL",110,451,"1200x900",1000,0,600,400,"False",110,702,445,-257,257,1
"C08YL",111,339,"1200x900",800,1,600,400,"False",273,545,443,-102,102,1
"C08YL",112,62,"1200x900",600,0,600,400,"True",345,346,299,-47,47,1
"C08YL",113,76,"1200x900",600,1,600,400,"True",647,614,656,42,42,0
"C08YL",114,252,"1200x900",800,0,600,400,"False",224,673,490,-183,183,1
"C08YL",115,514,"1200x900",1000,1,600,400,"True",539,690,711,21,21,0
"C08YL",116,259,"1200x900",800,0,600,400,"True",156,180,230,50,50,1
"C08YL",117,418,"1200x900",800,2,600,400,"True",754,507,516,9,9,0
"C08YL",118,254,"1200x900",800,0,600,400,"False",136,583,726,143,143,1
"C08YL",119,301,"1200x900",800,1,600,400,"True",162,574,550,-24,24,0
"C08YL",120,403,"1200x900",800,2,600,400,"False",625,704,310,-394,394,0
"C08YL",121,376,"1200x900",800,2,600,400,"False",788,275,463,188,188,0
"C08YL",122,303,"1200x900",800,1,600,400,"True",241,431,496,65,65,0
"C08YL",123,83,"1200x900",600,1,600,400,"False",763,568,501,-67,67,1
"C08YL",124,155,"1200x900",600,2,600,400,"False",940,269,445,176,176,0
"C08YL",125,114,"1200x900",600,1,600,400,"True",183,697,719,22,22,0
"C08YL",126,110,"1200x900",600,1,600,400,"True",776,550,525,-25,25,1
"C08YL",127,73,"1200x900",600,1,600,400,"False",94,665,744,79,79,0
"C08YL",128,233,"1200x900",800,0,600,400,"True",164,700,701,1,1,1
"C08YL",129,495,"1200x900",1000,0,600,400,"True",93,692,682,-10,10,1
"C08YL",130,612,"1200x900",1000,2,600,400,"False",706,198,515,317,317,0
"C08YL",131,244,"1200x900",800,0,600,400,"False",194,203,121,-82,82,1
"C08YL",132,642,"1200x900",1000,2,600,400,"False",776,316,589,273,273,0
"C08YL",133,369,"1200x900",800,2,600,400,"False",903,594,678,84,84,0
"C08YL",134,352,"1200x900",800,1,600,400,"True",235,717,750,33,33,0
"C08YL",135,191,"1200x900",600,2,600,400,"True",962,396,403,7,7,0
"C08YL",136,509,"1200x900",1000,1,600,400,"True",509,434,475,41,41,0
"C08YL",137,137,"1200x900",600,1,600,400,"True",789,577,575,-2,2,0
"C08YL",138,82,"1200x900",600,1,600,400,"False",108,213,145,-68,68,0
"C08YL",139,601,"1200x900",1000,2,600,400,"False",735,697,352,-345,345,0
"C08YL",140,171,"1200x900",600,2,600,400,"False",909,200,476,276,276,0
"C08YL",141,228,"1200x900",800,0,600,400,"True",174,687,718,31,31,1
"C08YL",142,556,"1200x900",1000,1,600,400,"True",415,420,374,-46,46,0
"C08YL",143,315,"1200x900",800,1,600,400,"True",105,211,209,-2,2,0
"C08YL",144,95,"1200x900",600,1,600,400,"False",749,425,591,166,166,1
"C08YL",145,187,"1200x900",600,2,600,400,"True",857,639,638,-1,1,0
"C08YL",146,502,"1200x900",1000,0,600,400,"False",111,639,549,-90,90,1
"C08YL",147,459,"1200x900",1000,0,600,400,"False",70,645,453,-192,192,1
"C08YL",148,51,"1200x900",600,0,600,400,"True",272,181,177,-4,4,1
"C08YL",149,12,"1200x900",600,0,600,400,"False",365,336,413,77,77,1
"C08YL",150,202,"1200x900",600,2,600,400,"True",966,460,477,17,17,0
"C08YL",151,37,"1200x900",600,0,600,400,"True",258,403,378,-25,25,1
"C08YL",152,207,"1200x900",600,2,600,400,"False",838,235,476,241,241,0
"C08YL",153,291,"1200x900",800,1,600,400,"False",522,694,483,-211,211,0
"C08YL",154,343,"1200x900",800,1,600,400,"False",407,557,372,-185,185,0
"C08YL",155,19,"1200x900",600,0,600,400,"True",286,686,687,1,1,0
"C08YL",156,240,"1200x900",800,0,600,400,"True",330,656,633,-23,23,1
"C08YL",157,205,"1200x900",600,2,600,400,"False",1021,504,634,130,130,0
"C08YL",158,120,"1200x900",600,1,600,400,"True",690,655,598,-57,57,0
"C08YL",159,582,"1200x900",1000,2,600,400,"False",554,347,476,129,129,0
"C08YL",160,388,"1200x900",800,2,600,400,"False",930,320,517,197,197,0
"C08YL",161,224,"1200x900",800,0,600,400,"True",161,474,443,-31,31,1
"C08YL",162,571,"1200x900",1000,1,600,400,"True",239,522,449,-73,73,1
"C08YL",163,53,"1200x900",600,0,600,400,"False",177,189,368,179,179,0
"C08YL",164,435,"1200x900",1000,0,600,400,"False",119,200,475,275,275,1
"C08YL",165,351,"1200x900",800,1,600,400,"True",122,581,591,10,10,0
"C08YL",166,154,"1200x900",600,2,600,400,"True",941,454,429,-25,25,0
"C08YL",167,273,"1200x900",800,0,600,400,"False",180,309,383,74,74,1
"C08YL",168,372,"1200x900",800,2,600,400,"False",833,620,481,-139,139,0
"C08YL",169,118,"1200x900",600,1,600,400,"True",190,588,609,21,21,0
"C08YL",170,640,"1200x900",1000,2,600,400,"True",361,334,371,37,37,0
"C08YL",171,35,"1200x900",600,0,600,400,"True",366,555,527,-28,28,1
"C08YL",172,272,"1200x900",800,0,600,400,"False",200,181,249,68,68,1
"C08YL",173,92,"1200x900",600,1,600,400,"False",624,605,671,66,66,0
"C08YL",174,387,"1200x900",800,2,600,400,"False",990,444,372,-72,72,0
"C08YL",175,626,"1200x900",1000,2,600,400,"True",329,449,440,-9,9,0
"C08YL",176,184,"1200x900",600,2,600,400,"False",1067,441,604,163,163,0
"C08YL",177,358,"1200x900",800,1,600,400,"False",263,635,310,-325,325,0
"C08YL",179,89,"1200x900",600,1,600,400,"False",917,366,466,100,100,1
"C08YL",180,417,"1200x900",800,2,600,400,"False",750,280,468,188,188,0
"C08YL",181,341,"1200x900",800,1,600,400,"True",735,632,633,1,1,1
"C08YL",182,261,"1200x900",800,0,600,400,"False",86,713,616,-97,97,1
"C08YL",183,346,"1200x900",800,1,600,400,"False",269,635,506,-129,129,0
"C08YL",184,80,"1200x900",600,1,600,400,"True",616,423,455,32,32,1
"C08YL",185,580,"1200x900",1000,2,600,400,"False",651,267,389,122,122,0
"C08YL",186,225,"1200x900",800,0,600,400,"True",178,423,374,-49,49,1
"C08YL",187,216,"1200x900",600,2,600,400,"True",1029,286,379,93,93,0
"C08YL",188,392,"1200x900",800,2,600,400,"True",1031,618,523,-95,95,0
"C08YL",189,84,"1200x900",600,1,600,400,"True",144,184,264,80,80,0
"C08YL",190,319,"1200x900",800,1,600,400,"True",494,587,622,35,35,1
"C08YL",191,45,"1200x900",600,0,600,400,"False",487,678,575,-103,103,1
"C08YL",192,165,"1200x900",600,2,600,400,"True",912,554,486,-68,68,0
"C08YL",193,522,"1200x900",1000,1,600,400,"False",223,379,528,149,149,0
"C08YL",194,79,"1200x900",600,1,600,400,"False",731,289,383,94,94,0
"C08YL",195,453,"1200x900",1000,0,600,400,"False",71,393,459,66,66,1
"C08YL",196,39,"1200x900",600,0,600,400,"True",210,609,575,-34,34,0
"C08YL",197,407,"1200x900",800,2,600,400,"True",989,340,378,38,38,0
"C08YL",198,268,"1200x900",800,0,600,400,"True",148,400,420,20,20,1
"C08YL",199,390,"1200x900",800,2,600,400,"False",982,674,513,-161,161,1
"C08YL",200,333,"1200x900",800,1,600,400,"False",521,548,459,-89,89,0
"C08YL",201,278,"1200x900",800,0,600,400,"False",251,711,552,-159,159,1
"C08YL",202,472,"1200x900",1000,0,600,400,"False",77,685,511,-174,174,1
"C08YL",203,398,"1200x900",800,2,600,400,"True",944,698,634,-64,64,0
"C08YL",204,634,"1200x900",1000,2,600,400,"False",735,313,564,251,251,0
"C08YL",205,21,"1200x900",600,0,600,400,"True",314,383,403,20,20,1
"C08YL",206,389,"1200x900",800,2,600,400,"False",843,530,461,-69,69,0
"C08YL",207,632,"1200x900",1000,2,600,400,"False",984,227,667,440,440,0
"C08YL",208,126,"1200x900",600,1,600,400,"True",849,354,417,63,63,0
"C08YL",209,325,"1200x900",800,1,600,400,"False",105,394,296,-98,98,0
"C08YL",210,336,"1200x900",800,1,600,400,"True",251,587,587,0,0,0
"C08YL",211,456,"1200x900",1000,0,600,400,"False",91,257,486,229,229,1
"C08YL",212,567,"1200x900",1000,1,600,400,"True",655,297,282,-15,15,1
"C08YL",213,461,"1200x900",1000,0,600,400,"False",95,711,524,-187,187,1
"C08YL",214,77,"1200x900",600,1,600,400,"True",780,525,465,-60,60,0
"C08YL",215,401,"1200x900",800,2,600,400,"True",821,260,279,19,19,0
"C08YL",216,437,"1200x900",1000,0,600,400,"False",74,667,506,-161,161,1
"C08YL",217,555,"1200x900",1000,1,600,400,"True",444,556,492,-64,64,0
"C08YL",218,340,"1200x900",800,1,600,400,"False",226,240,502,262,262,0
"C08YL",219,270,"1200x900",800,0,600,400,"True",192,418,451,33,33,1
"C08YL",220,318,"1200x900",800,1,600,400,"False",788,534,725,191,191,0
"C08YL",221,269,"1200x900",800,0,600,400,"False",160,295,390,95,95,1
"C08YL",222,227,"1200x900",800,0,600,400,"True",196,551,604,53,53,1
"C08YL",223,548,"1200x900",1000,1,600,400,"True",103,278,308,30,30,0
"C08YL",225,13,"1200x900",600,0,600,400,"False",296,211,348,137,137,1
"C08YL",226,38,"1200x900",600,0,600,400,"False",120,628,511,-117,117,1
"C08YL",227,374,"1200x900",800,2,600,400,"False",755,450,365,-85,85,0
"C08YL",228,569,"1200x900",1000,1,600,400,"False",494,720,411,-309,309,0
"C08YL",229,410,"1200x900",800,2,600,400,"False",916,477,332,-145,145,0
"C08YL",230,405,"1200x900",800,2,600,400,"True",790,307,346,39,39,0
"C08YL",231,88,"1200x900",600,1,600,400,"False",186,554,610,56,56,0
"C08YL",232,481,"1200x900",1000,0,600,400,"False",80,185,393,208,208,1
"C08YL",233,645,"1200x900",1000,2,600,400,"True",619,396,406,10,10,0
"C08YL",234,607,"1200x900",1000,2,600,400,"True",900,573,610,37,37,1
"C08YL",235,174,"1200x900",600,2,600,400,"True",998,457,475,18,18,0
"C08YL",236,15,"1200x900",600,0,600,400,"True",473,352,377,25,25,1
"C08YL",237,587,"1200x900",1000,2,600,400,"False",741,686,481,-205,205,0
"C08YL",238,18,"1200x900",600,0,600,400,"True",400,318,310,-8,8,1
"C08YL",240,99,"1200x900",600,1,600,400,"True",811,407,415,8,8,0
"C08YL",241,440,"1200x900",1000,0,600,400,"False",71,237,364,127,127,1
"C08YL",242,511,"1200x900",1000,1,600,400,"False",408,390,467,77,77,1
"C08YL",243,583,"1200x900",1000,2,600,400,"False",949,284,221,-63,63,1
"C08YL",244,574,"1200x900",1000,1,600,400,"False",614,194,265,71,71,0
"C08YL",245,446,"1200x900",1000,0,600,400,"False",72,298,439,141,141,1
"C08YL",246,355,"1200x900",800,1,600,400,"False",77,386,524,138,138,0
"C08YL",247,25,"1200x900",600,0,600,400,"True",263,403,410,7,7,1
"C08YL",248,630,"1200x900",1000,2,600,400,"False",754,559,628,69,69,0
"C08YL",249,539,"1200x900",1000,1,600,400,"True",510,383,412,29,29,0
"C08YL",250,167,"1200x900",600,2,600,400,"False",956,241,342,101,101,0
"C08YL",251,359,"1200x900",800,1,600,400,"False",653,241,346,105,105,0
"C08YL",252,96,"1200x900",600,1,600,400,"False",433,458,632,174,174,0
"C08YL",253,117,"1200x900",600,1,600,400,"False",711,456,177,-279,279,0
"C08YL",254,289,"1200x900",800,1,600,400,"True",421,703,692,-11,11,1
"C08YL",255,618,"1200x900",1000,2,600,400,"True",276,671,708,37,37,0
"C08YL",256,334,"1200x900",800,1,600,400,"True",481,665,637,-28,28,0
"C08YL",257,564,"1200x900",1000,1,600,400,"False",215,264,379,115,115,0
"C08YL",258,285,"1200x900",800,0,600,400,"False",237,396,470,74,74,1
"C08YL",259,67,"1200x900",600,0,600,400,"True",289,308,339,31,31,1
"C08YL",260,277,"1200x900",800,0,600,400,"False",140,310,447,137,137,1
"C08YL",261,416,"1200x900",800,2,600,400,"False",748,617,309,-308,308,0
"C08YL",262,554,"1200x900",1000,1,600,400,"False",79,309,228,-81,81,1
"C08YL",263,557,"1200x900",1000,1,600,400,"False",677,505,628,123,123,1
"C08YL",264,619,"1200x900",1000,2,600,400,"False",803,247,410,163,163,0
"C08YL",265,576,"1200x900",1000,1,600,400,"False",376,713,631,-82,82,0
"C08YL",266,220,"1200x900",800,0,600,400,"True",108,699,663,-36,36,1
"C08YL",267,242,"1200x900",800,0,600,400,"True",117,448,458,10,10,1
"C08YL",268,473,"1200x900",1000,0,600,400,"False",75,323,491,168,168,1
"C08YL",269,443,"1200x900",1000,0,600,400,"False",99,651,495,-156,156,1
"C08YL",270,134,"1200x900",600,1,600,400,"True",300,188,144,-44,44,0
"C08YL",271,338,"1200x900",800,1,600,400,"False",813,253,391,138,138,1
"C08YL",272,371,"1200x900",800,2,600,400,"False",730,560,400,-160,160,0
"C08YL",273,33,"1200x900",600,0,600,400,"True",198,533,519,-14,14,1
"C08YL",274,546,"1200x900",1000,1,600,400,"True",305,374,411,37,37,0
"C08YL",275,72,"1200x900",600,0,600,400,"True",158,537,481,-56,56,0
"C08YL",276,414,"1200x900",800,2,600,400,"False",831,592,475,-117,117,0
"C08YL",277,166,"1200x900",600,2,600,400,"True",896,274,320,46,46,0
"C08YL",278,235,"1200x900",800,0,600,400,"False",146,646,531,-115,115,1
"C08YL",279,525,"1200x900",1000,1,600,400,"False",123,690,404,-286,286,0
"C08YL",280,455,"1200x900",1000,0,600,400,"False",107,718,519,-199,199,1
"C08YL",281,7,"1200x900",600,0,600,400,"True",431,654,632,-22,22,1
"C08YL",282,139,"1200x900",600,1,600,400,"False",192,695,565,-130,130,0
"C08YL",284,305,"1200x900",800,1,600,400,"False",471,716,575,-141,141,0
"C08YL",285,26,"1200x900",600,0,600,400,"True",70,712,731,19,19,0
"C08YL",286,93,"1200x900",600,1,600,400,"False",139,540,420,-120,120,0
"C08YL",287,480,"1200x900",1000,0,600,400,"False",100,231,434,203,203,1
"C08YL",288,457,"1200x900",1000,0,600,400,"False",97,630,532,-98,98,1
"C08YL",289,316,"1200x900",800,1,600,400,"True",362,319,344,25,25,0
"C08YL",290,620,"1200x900",1000,2,600,400,"False",832,649,494,-155,155,0
"C08YL",291,309,"1200x900",800,1,600,400,"True",186,225,249,24,24,0
"C08YL",292,471,"1200x900",1000,0,600,400,"False",122,200,349,149,149,1
"C08YL",293,300,"1200x900",800,1,600,400,"False",620,693,615,-78,78,0
"C08YL",294,152,"1200x900",600,2,600,400,"False",971,399,293,-106,106,0
"C08YL",295,357,"1200x900",800,1,600,400,"True",109,594,640,46,46,0
"C08YL",296,393,"1200x900",800,2,600,400,"False",657,620,342,-278,278,0
"C08YL",297,52,"1200x900",600,0,600,400,"True",171,188,212,24,24,0
"C08YL",298,142,"1200x900",600,1,600,400,"False",286,474,587,113,113,0
"C08YL",299,526,"1200x900",1000,1,600,400,"True",497,710,714,4,4,0
"C08YL",300,181,"1200x900",600,2,600,400,"False",1018,223,328,105,105,0
"C08YL",301,444,"1200x900",1000,0,600,400,"False",101,714,547,-167,167,1
"C08YL",302,286,"1200x900",800,0,600,400,"True",105,378,376,-2,2,1
"C08YL",303,592,"1200x900",1000,2,600,400,"False",492,392,615,223,223,0
"C08YL",304,510,"1200x900",1000,1,600,400,"False",486,338,207,-131,131,1
"C08YL",305,218,"1200x900",800,0,600,400,"True",106,397,390,-7,7,1
"C08YL",306,141,"1200x900",600,1,600,400,"True",671,582,575,-7,7,0
"C08YL",307,643,"1200x900",1000,2,600,400,"False",740,325,422,97,97,0
"C08YL",308,59,"1200x900",600,0,600,400,"True",391,692,634,-58,58,1
"C08YL",309,586,"1200x900",1000,2,600,400,"False",802,262,460,198,198,0
"C08YL",310,489,"1200x900",1000,0,600,400,"False",88,604,484,-120,120,1
"C08YL",311,585,"1200x900",1000,2,600,400,"False",698,688,411,-277,277,1
"C08YL",312,121,"1200x900",600,1,600,400,"False",884,364,457,93,93,0
"C08YL",313,156,"1200x900",600,2,600,400,"True",913,197,258,61,61,0
"C08YL",314,151,"1200x900",600,2,600,400,"False",828,680,555,-125,125,0
"C08YL",315,320,"1200x900",800,1,600,400,"True",644,376,423,47,47,0
"C08YL",316,106,"1200x900",600,1,600,400,"False",803,659,563,-96,96,1
"C08YL",317,552,"1200x900",1000,1,600,400,"False",255,412,598,186,186,0
"C08YL",318,465,"1200x900",1000,0,600,400,"False",85,203,421,218,218,1
"C08YL",319,504,"1200x900",1000,0,600,400,"False",107,699,566,-133,133,1
"C08YL",320,284,"1200x900",800,0,600,400,"True",135,293,336,43,43,1
"C08YL",321,483,"1200x900",1000,0,600,400,"False",93,191,260,69,69,1
"C08YL",322,223,"1200x900",800,0,600,400,"True",179,191,237,46,46,1
"C08YL",323,199,"1200x900",600,2,600,400,"False",992,467,399,-68,68,0
"C08YL",325,603,"1200x900",1000,2,600,400,"False",693,280,420,140,140,0
"C08YL",326,125,"1200x900",600,1,600,400,"True",750,531,502,-29,29,0
"C08YL",328,517,"1200x900",1000,1,600,400,"True",548,182,234,52,52,0
"C08YL",330,577,"1200x900",1000,2,600,400,"True",455,420,443,23,23,0
"C08YL",331,448,"1200x900",1000,0,600,400,"False",107,641,570,-71,71,1
"C08YL",332,312,"1200x900",800,1,600,400,"False",238,683,451,-232,232,0
"C08YL",333,429,"1200x900",800,2,600,400,"False",682,692,428,-264,264,0
"C08YL",334,365,"1200x900",800,2,600,400,"False",1055,305,580,275,275,0
"C08YL",335,36,"1200x900",600,0,600,400,"True",128,346,321,-25,25,1
"C08YL",336,431,"1200x900",800,2,600,400,"False",694,382,229,-153,153,0
"C08YL",338,66,"1200x900",600,0,600,400,"True",155,673,674,1,1,0
"C08YL",339,161,"1200x900",600,2,600,400,"True",939,553,532,-21,21,0
"C08YL",340,206,"1200x900",600,2,600,400,"True",975,223,262,39,39,0
"C08YL",341,310,"1200x900",800,1,600,400,"False",559,592,500,-92,92,0
"C08YL",342,250,"1200x900",800,0,600,400,"False",290,248,320,72,72,1
"C08YL",343,598,"1200x900",1000,2,600,400,"False",706,559,236,-323,323,0
"C08YL",344,186,"1200x900",600,2,600,400,"False",997,197,405,208,208,0
"C08YL",345,536,"1200x900",1000,1,600,400,"True",580,213,237,24,24,0
"C08YL",346,611,"1200x900",1000,2,600,400,"True",414,511,555,44,44,0
"C08YL",347,42,"1200x900",600,0,600,400,"True",233,479,532,53,53,0
"C08YL",348,335,"1200x900",800,1,600,400,"False",124,360,514,154,154,0
"C08YL",349,65,"1200x900",600,0,600,400,"False",442,645,508,-137,137,1
"C08YL",350,350,"1200x900",800,1,600,400,"False",182,566,313,-253,253,0
"C08YL",351,463,"1200x900",1000,0,600,400,"False",115,693,482,-211,211,1
"C08YL",352,628,"1200x900",1000,2,600,400,"False",768,410,709,299,299,0
"C08YL",353,551,"1200x900",1000,1,600,400,"True",146,445,524,79,79,1
"C08YL",354,635,"1200x900",1000,2,600,400,"False",833,402,301,-101,101,0
"C08YL",355,27,"1200x900",600,0,600,400,"False",373,309,381,72,72,1
"C08YL",356,648,"1200x900",1000,2,600,400,"False",557,394,518,124,124,0
"C08YL",357,507,"1200x900",1000,1,600,400,"False",608,583,455,-128,128,1
"C08YL",358,364,"1200x900",800,2,600,400,"False",1018,204,353,149,149,0
"C08YL",359,217,"1200x900",800,0,600,400,"True",85,573,549,-24,24,1
"C08YL",360,528,"1200x900",1000,1,600,400,"False",839,227,486,259,259,1
"C08YL",361,314,"1200x900",800,1,600,400,"False",277,616,426,-190,190,1
"C08YL",362,633,"1200x900",1000,2,600,400,"True",564,253,246,-7,7,0
"C08YL",363,623,"1200x900",1000,2,600,400,"True",636,527,533,6,6,0
"C08YL",364,475,"1200x900",1000,0,600,400,"False",101,715,591,-124,124,1
"C08YL",365,131,"1200x900",600,1,600,400,"False",531,367,431,64,64,0
"C08YL",366,267,"1200x900",800,0,600,400,"True",145,665,616,-49,49,1
"C08YL",367,377,"1200x900",800,2,600,400,"True",683,388,422,34,34,0
"C08YL",368,129,"1200x900",600,1,600,400,"False",859,482,222,-260,260,1
"C08YL",369,500,"1200x900",1000,0,600,400,"False",105,700,522,-178,178,1
"C08YL",370,234,"1200x900",800,0,600,400,"True",72,344,347,3,3,1
"C08YL",371,427,"1200x900",800,2,600,400,"False",812,380,515,135,135,0
"C08YL",372,276,"1200x900",800,0,600,400,"False",281,217,298,81,81,1
"C08YL",373,411,"1200x900",800,2,600,400,"False",805,361,639,278,278,0
"C08YL",374,209,"1200x900",600,2,600,400,"True",937,637,575,-62,62,0
"C08YL",375,426,"1200x900",800,2,600,400,"False",830,263,429,166,166,0
"C08YL",376,413,"1200x900",800,2,600,400,"False",849,506,309,-197,197,0
"C08YL",377,600,"1200x900",1000,2,600,400,"False",765,207,511,304,304,0
"C08YL",378,143,"1200x900",600,1,600,400,"True",479,284,338,54,54,1
"C08YL",379,532,"1200x900",1000,1,600,400,"True",215,207,258,51,51,0
"C08YL",380,275,"1200x900",800,0,600,400,"False",120,594,512,-82,82,0
"C08YL",381,353,"1200x900",800,1,600,400,"False",90,476,616,140,140,0
"C08YL",382,256,"1200x900",800,0,600,400,"True",192,656,660,4,4,1
"C08YL",383,94,"1200x900",600,1,600,400,"True",729,482,467,-15,15,0
"C08YL",384,150,"1200x900",600,2,600,400,"True",897,345,347,2,2,0
"C08YL",385,523,"1200x900",1000,1,600,400,"False",339,318,396,78,78,0
"C08YL",386,211,"1200x900",600,2,600,400,"True",986,407,430,23,23,0
"C08YL",387,193,"1200x900",600,2,600,400,"True",874,588,634,46,46,0
"C08YL",388,215,"1200x900",600,2,600,400,"False",939,596,513,-83,83,0
"C08YL",389,280,"1200x900",800,0,600,400,"True",104,302,295,-7,7,1
"C08YL",391,380,"1200x900",800,2,600,400,"True",942,228,277,49,49,0
"C08YL",392,136,"1200x900",600,1,600,400,"True",264,205,181,-24,24,0
"C08YL",393,442,"1200x900",1000,0,600,400,"False",87,183,304,121,121,1
"C08YL",394,189,"1200x900",600,2,600,400,"False",881,397,568,171,171,0
"C08YL",395,265,"1200x900",800,0,600,400,"False",229,353,463,110,110,1
"C08YL",396,425,"1200x900",800,2,600,400,"True",621,438,492,54,54,0
"C08YL",397,591,"1200x900",1000,2,600,400,"True",698,336,374,38,38,0
"C08YL",398,200,"1200x900",600,2,600,400,"True",897,302,277,-25,25,0
"C08YL",399,130,"1200x900",600,1,600,400,"True",741,428,397,-31,31,0
"C08YL",400,222,"1200x900",800,0,600,400,"False",152,206,279,73,73,1
"C08YL",401,86,"1200x900",600,1,600,400,"True",692,388,395,7,7,1
"C08YL",402,543,"1200x900",1000,1,600,400,"False",88,202,556,354,354,0
"C08YL",403,530,"1200x900",1000,1,600,400,"True",584,405,358,-47,47,1
"C08YL",404,493,"1200x900",1000,0,600,400,"False",80,582,429,-153,153,1
"C08YL",405,111,"1200x900",600,1,600,400,"False",922,552,630,78,78,1
"C08YL",406,609,"1200x900",1000,2,600,400,"True",697,627,631,4,4,0
"C08YL",407,133,"1200x900",600,1,600,400,"True",345,551,585,34,34,0
"C08YL",408,337,"1200x900",800,1,600,400,"True",299,622,635,13,13,0
"C08YL",409,308,"1200x900",800,1,600,400,"False",437,425,532,107,107,0
"C08YL",410,41,"1200x900",600,0,600,400,"True",370,452,485,33,33,1
"C08YL",411,109,"1200x900",600,1,600,400,"False",691,589,507,-82,82,0
"C08YL",412,54,"1200x900",600,0,600,400,"True",474,564,550,-14,14,1
"C08YL",413,245,"1200x900",800,0,600,400,"False",296,235,430,195,195,1
"C08YL",414,529,"1200x900",1000,1,600,400,"False",267,412,323,-89,89,1
"C08YL",415,253,"1200x900",800,0,600,400,"True",177,424,462,38,38,1
"C08YL",416,572,"1200x900",1000,1,600,400,"True",302,260,314,54,54,0
"C08YL",417,498,"1200x900",1000,0,600,400,"True",100,260,287,27,27,1
"C08YL",418,345,"1200x900",800,1,600,400,"False",841,566,694,128,128,1
"C08YL",419,249,"1200x900",800,0,600,400,"True",126,306,369,63,63,1
"C08YL",420,78,"1200x900",600,1,600,400,"False",885,684,754,70,70,0
"C08YL",421,119,"1200x900",600,1,600,400,"True",168,563,570,7,7,0
"C08YL",422,447,"1200x900",1000,0,600,400,"False",71,339,501,162,162,1
"C08YL",423,70,"1200x900",600,0,600,400,"True",309,703,672,-31,31,1
"C08YL",424,638,"1200x900",1000,2,600,400,"False",385,198,491,293,293,0
"C08YL",425,293,"1200x900",800,1,600,400,"True",561,396,360,-36,36,0
"C08YL",426,433,"1200x900",1000,0,600,400,"False",76,222,328,106,106,1
"C08YL",427,512,"1200x900",1000,1,600,400,"False",139,261,560,299,299,0
"C08YL",428,366,"1200x900",800,2,600,400,"False",931,464,294,-170,170,0
"C08YL",429,367,"1200x900",800,2,600,400,"True",613,464,435,-29,29,0
"C08YL",430,332,"1200x900",800,1,600,400,"True",260,699,703,4,4,0
"C08YL",431,124,"1200x900",600,1,600,400,"False",345,467,366,-101,101,0
"C08YL",432,477,"1200x900",1000,0,600,400,"False",88,640,515,-125,125,1
"C08YL",433,307,"1200x900",800,1,600,400,"True",716,247,243,-4,4,0
"C08YL",434,197,"1200x900",600,2,600,400,"False",903,212,444,232,232,0
"C08YL",435,188,"1200x900",600,2,600,400,"True",900,195,205,10,10,0
"C08YL",436,331,"1200x900",800,1,600,400,"False",240,620,723,103,103,0
"C08YL",437,616,"1200x900",1000,2,600,400,"False",854,357,269,-88,88,1
"C08YL",438,544,"1200x900",1000,1,600,400,"False",602,620,437,-183,183,0
"C08YL",439,515,"1200x900",1000,1,600,400,"False",307,217,308,91,91,0
"C08YL",440,63,"1200x900",600,0,600,400,"True",311,188,185,-3,3,1
"C08YL",441,614,"1200x900",1000,2,600,400,"False",823,563,468,-95,95,0
"C08YL",442,255,"1200x900",800,0,600,400,"False",93,709,556,-153,153,1
"C08YL",443,342,"1200x900",800,1,600,400,"False",677,204,300,96,96,0
"C08YL",444,231,"1200x900",800,0,600,400,"False",251,718,554,-164,164,1
"C08YL",445,497,"1200x900",1000,0,600,400,"False",106,696,465,-231,231,1
"C08YL",446,450,"1200x900",1000,0,600,400,"False",130,204,425,221,221,1
"C08YL",447,44,"1200x900",600,0,600,400,"True",305,554,508,-46,46,1
"C08YL",448,549,"1200x900",1000,1,600,400,"True",657,366,382,16,16,0
"C08YL",449,68,"1200x900",600,0,600,400,"True",165,367,417,50,50,0
"C08YL",450,545,"1200x900",1000,1,600,400,"True",358,562,512,-50,50,0
"C08YL",451,420,"1200x900",800,2,600,400,"False",519,223,318,95,95,0
"C08YL",452,201,"1200x900",600,2,600,400,"False",1005,462,402,-60,60,0
"C08YL",453,311,"1200x900",800,1,600,400,"False",710,261,441,180,180,0
"C08YL",454,575,"1200x900",1000,1,600,400,"False",272,693,564,-129,129,0
"C08YL",455,32,"1200x900",600,0,600,400,"False",152,563,439,-124,124,1
"C08YL",456,29,"1200x900",600,0,600,400,"True",385,533,522,-11,11,1
"C08YL",457,97,"1200x900",600,1,600,400,"True",760,643,626,-17,17,1
"C08YL",458,123,"1200x900",600,1,600,400,"True",761,365,354,-11,11,1
"C08YL",459,326,"1200x900",800,1,600,400,"False",103,482,384,-98,98,0
"C08YL",460,484,"1200x900",1000,0,600,400,"False",100,223,423,200,200,1
"C08YL",461,588,"1200x900",1000,2,600,400,"True",585,350,378,28,28,0
"C08YL",462,246,"1200x900",800,0,600,400,"True",196,418,416,-2,2,1
"C08YL",463,482,"1200x900",1000,0,600,400,"False",79,686,531,-155,155,1
"C08YL",464,226,"1200x900",800,0,600,400,"True",187,229,228,-1,1,1
"C08YL",465,646,"1200x900",1000,2,600,400,"True",829,227,249,22,22,1
"C08YL",466,317,"1200x900",800,1,600,400,"False",185,564,669,105,105,0
"C08YL",467,441,"1200x900",1000,0,600,400,"False",85,684,582,-102,102,1
"C08YL",468,71,"1200x900",600,0,600,400,"False",219,248,364,116,116,0
"C08YL",469,381,"1200x900",800,2,600,400,"False",705,408,506,98,98,0
"C08YL",470,322,"1200x900",800,1,600,400,"False",703,206,393,187,187,1
"C08YL",471,182,"1200x900",600,2,600,400,"False",933,389,222,-167,167,0
"C08YL",472,264,"1200x900",800,0,600,400,"False",198,660,494,-166,166,1
"C08YL",473,542,"1200x900",1000,1,600,400,"False",304,401,247,-154,154,0
"C08YL",474,327,"1200x900",800,1,600,400,"False",152,339,232,-107,107,0
"C08YL",475,46,"1200x900",600,0,600,400,"True",193,355,331,-24,24,1
"C08YL",476,34,"1200x900",600,0,600,400,"True",361,242,244,2,2,1
"C08YL",477,105,"1200x900",600,1,600,400,"False",527,440,579,139,139,0
"C08YL",478,513,"1200x900",1000,1,600,400,"False",235,602,263,-339,339,0
"C08YL",479,10,"1200x900",600,0,600,400,"True",400,499,488,-11,11,1
"C08YL",480,541,"1200x900",1000,1,600,400,"True",339,478,507,29,29,0
"C08YL",481,180,"1200x900",600,2,600,400,"True",929,270,246,-24,24,0
"C08YL",484,116,"1200x900",600,1,600,400,"False",767,289,126,-163,163,0
"C08YL",485,69,"1200x900",600,0,600,400,"False",322,268,408,140,140,0
"C08YL",486,373,"1200x900",800,2,600,400,"False",694,326,643,317,317,0
"C08YL",487,302,"1200x900",800,1,600,400,"False",479,467,580,113,113,1
"C08YL",488,236,"1200x900",800,0,600,400,"True",162,350,321,-29,29,1
"C08YL",489,641,"1200x900",1000,2,600,400,"False",897,272,719,447,447,0
"C08YL",490,138,"1200x900",600,1,600,400,"False",844,580,391,-189,189,1
"C08YL",491,55,"1200x900",600,0,600,400,"True",211,305,273,-32,32,1
"C08YL",492,594,"1200x900",1000,2,600,400,"False",537,637,508,-129,129,0
"C08YL",493,370,"1200x900",800,2,600,400,"True",874,336,296,-40,40,0
"C08YL",494,424,"1200x900",800,2,600,400,"False",903,545,418,-127,127,0
"C08YL",495,621,"1200x900",1000,2,600,400,"False",540,478,314,-164,164,0
"C08YL",496,262,"1200x900",800,0,600,400,"False",196,481,402,-79,79,1
"C08YL",499,467,"1200x900",1000,0,600,400,"False",74,712,546,-166,166,1
"C08YL",500,170,"1200x900",600,2,600,400,"True",996,468,415,-53,53,0
"C08YL",501,399,"1200x900",800,2,600,400,"True",603,602,575,-27,27,0
"C08YL",502,172,"1200x900",600,2,600,400,"True",912,444,415,-29,29,0
"C08YL",503,210,"1200x900",600,2,600,400,"True",835,506,544,38,38,0
"C08YL",504,144,"1200x900",600,1,600,400,"True",718,371,377,6,6,0
"C08YL",505,348,"1200x900",800,1,600,400,"True",764,294,307,13,13,0
"C08YL",506,157,"1200x900",600,2,600,400,"True",1016,323,321,-2,2,0
"C08YL",507,279,"1200x900",800,0,600,400,"False",252,202,320,118,118,1
"C08YL",508,624,"1200x900",1000,2,600,400,"False",693,501,418,-83,83,0
"C08YL",509,347,"1200x900",800,1,600,400,"False",757,295,534,239,239,1
"C08YL",510,639,"1200x900",1000,2,600,400,"False",504,456,242,-214,214,0
"C08YL",511,297,"1200x900",800,1,600,400,"True",625,244,300,56,56,0
"C08YL",512,108,"1200x900",600,1,600,400,"False",830,239,325,86,86,0
"C08YL",513,492,"1200x900",1000,0,600,400,"False",76,692,445,-247,247,1
"C08YL",514,176,"1200x900",600,2,600,400,"True",1033,281,262,-19,19,0
"C08YL",515,330,"1200x900",800,1,600,400,"False",759,301,196,-105,105,1
"C08YL",516,22,"1200x900",600,0,600,400,"True",398,591,547,-44,44,1
"C08YL",517,458,"1200x900",1000,0,600,400,"True",78,624,581,-43,43,1
"C08YL",518,400,"1200x900",800,2,600,400,"True",733,297,281,-16,16,0
"C08YL",519,597,"1200x900",1000,2,600,400,"True",352,239,257,18,18,0
"C08YL",520,395,"1200x900",800,2,600,400,"True",743,334,404,70,70,0
"C08YL",521,354,"1200x900",800,1,600,400,"True",118,236,231,-5,5,0
"C08YL",522,257,"1200x900",800,0,600,400,"True",97,219,282,63,63,1
"C08YL",523,573,"1200x900",1000,1,600,400,"True",486,615,623,8,8,0
"C08YL",524,212,"1200x900",600,2,600,400,"False",841,206,436,230,230,0
"C08YL",525,584,"1200x900",1000,2,600,400,"True",731,413,387,-26,26,0
"C08YL",526,596,"1200x900",1000,2,600,400,"False",706,513,597,84,84,0
"C08YL",527,20,"1200x900",600,0,600,400,"True",204,545,573,28,28,1
"C08YL",528,3,"1200x900",600,0,600,400,"True",298,443,503,60,60,1
"C08YL",529,16,"1200x900",600,0,600,400,"True",297,514,543,29,29,1
"C08YL",530,397,"1200x900",800,2,600,400,"False",817,692,527,-165,165,0
"C08YL",531,28,"1200x900",600,0,600,400,"True",336,410,419,9,9,1
"C08YL",532,423,"1200x900",800,2,600,400,"True",1051,710,751,41,41,1
"C08YL",533,501,"1200x900",1000,0,600,400,"True",96,323,363,40,40,1
"C08YL",534,629,"1200x900",1000,2,600,400,"False",681,257,570,313,313,0
"C08YL",535,282,"1200x900",800,0,600,400,"True",109,246,265,19,19,1
"C08YL",537,563,"1200x900",1000,1,600,400,"False",201,696,621,-75,75,0
"C08YL",538,159,"1200x900",600,2,600,400,"True",992,309,344,35,35,0
"C08YL",539,644,"1200x900",1000,2,600,400,"True",495,486,453,-33,33,0
"C08YL",540,396,"1200x900",800,2,600,400,"True",678,663,657,-6,6,0
"C08YL",541,487,"1200x900",1000,0,600,400,"False",78,670,568,-102,102,1
"C08YL",542,524,"1200x900",1000,1,600,400,"False",534,470,619,149,149,0
"C08YL",543,288,"1200x900",800,0,600,400,"True",180,547,527,-20,20,1
"C08YL",544,57,"1200x900",600,0,600,400,"True",354,508,457,-51,51,1
"C08YL",545,195,"1200x900",600,2,600,400,"True",942,249,291,42,42,0
"C08YL",546,625,"1200x900",1000,2,600,400,"True",279,228,229,1,1,0
"C08YL",547,329,"1200x900",800,1,600,400,"True",517,239,265,26,26,0
"C08YL",548,5,"1200x900",600,0,600,400,"False",228,587,503,-84,84,0
"C08YL",549,140,"1200x900",600,1,600,400,"True",700,523,484,-39,39,0
"C08YL",550,30,"1200x900",600,0,600,400,"True",107,353,371,18,18,0
"C08YL",551,177,"1200x900",600,2,600,400,"True",912,236,222,-14,14,0
"C08YL",552,613,"1200x900",1000,2,600,400,"True",690,374,364,-10,10,0
"C08YL",553,258,"1200x900",800,0,600,400,"True",126,664,637,-27,27,1
"C08YL",554,436,"1200x900",1000,0,600,400,"True",82,617,572,-45,45,1
"C08YL",555,604,"1200x900",1000,2,600,400,"True",459,593,668,75,75,0
"C08YL",556,610,"1200x900",1000,2,600,400,"True",702,293,373,80,80,0
"C08YL",557,239,"1200x900",800,0,600,400,"True",114,231,283,52,52,1
"C08YL",558,49,"1200x900",600,0,600,400,"True",109,380,384,4,4,0
"C08YL",560,631,"1200x900",1000,2,600,400,"True",699,479,426,-53,53,0
"C08YL",561,419,"1200x900",800,2,600,400,"False",769,351,274,-77,77,0
"C08YL",562,406,"1200x900",800,2,600,400,"False",971,233,333,100,100,0
"C08YL",563,486,"1200x900",1000,0,600,400,"True",102,676,654,-22,22,1
"C08YL",564,183,"1200x900",600,2,600,400,"True",927,289,302,13,13,0
"C08YL",565,519,"1200x900",1000,1,600,400,"True",319,565,596,31,31,1
"C08YL",566,40,"1200x900",600,0,600,400,"True",143,513,509,-4,4,0
"C08YL",567,547,"1200x900",1000,1,600,400,"False",369,384,701,317,317,1
"C08YL",568,132,"1200x900",600,1,600,400,"True",333,185,228,43,43,0
"C08YL",569,203,"1200x900",600,2,600,400,"True",938,603,588,-15,15,0
"C08YL",570,590,"1200x900",1000,2,600,400,"True",636,278,276,-2,2,0
"C08YL",571,479,"1200x900",1000,0,600,400,"False",74,705,627,-78,78,1
"C08YL",572,194,"1200x900",600,2,600,400,"False",896,236,351,115,115,0
"C08YL",573,466,"1200x900",1000,0,600,400,"True",82,205,236,31,31,1
"C08YL",574,8,"1200x900",600,0,600,400,"True",156,679,621,-58,58,0
"C08YL",575,349,"1200x900",800,1,600,400,"True",402,665,625,-40,40,0
"C08YL",576,61,"1200x900",600,0,600,400,"True",272,670,644,-26,26,1
"C08YL",577,103,"1200x900",600,1,600,400,"True",528,320,363,43,43,1
"C08YL",578,537,"1200x900",1000,1,600,400,"False",621,412,167,-245,245,1
"C08YL",579,462,"1200x900",1000,0,600,400,"False",102,672,532,-140,140,1
"C08YL",580,617,"1200x900",1000,2,600,400,"False",294,180,298,118,118,0
"C08YL",581,17,"1200x900",600,0,600,400,"True",402,496,472,-24,24,1
"C08YL",582,518,"1200x900",1000,1,600,400,"False",583,717,638,-79,79,0
"C08YL",583,394,"1200x900",800,2,600,400,"True",847,292,316,24,24,0
"C08YL",584,247,"1200x900",800,0,600,400,"False",160,424,501,77,77,1
"C08YL",585,266,"1200x900",800,0,600,400,"False",126,303,394,91,91,1
"C08YL",586,599,"1200x900",1000,2,600,400,"True",316,570,549,-21,21,0
"C08YL",588,464,"1200x900",1000,0,600,400,"False",82,222,344,122,122,1
"C08YL",589,402,"1200x900",800,2,600,400,"False",878,234,165,-69,69,0
"C08YL",590,368,"1200x900",800,2,600,400,"False",778,515,643,128,128,0
"C08YL",591,428,"1200x900",800,2,600,400,"False",732,665,449,-216,216,0
"C08YL",592,356,"1200x900",800,1,600,400,"True",123,484,504,20,20,0
"C08YL",593,503,"1200x900",1000,0,600,400,"False",86,279,368,89,89,1
"C08YL",594,11,"1200x900",600,0,600,400,"True",372,670,644,-26,26,1
"C08YL",595,534,"1200x900",1000,1,600,400,"False",328,504,610,106,106,1
"C08YL",596,516,"1200x900",1000,1,600,400,"True",440,559,519,-40,40,0
"C08YL",597,283,"1200x900",800,0,600,400,"True",90,264,271,7,7,1
"C08YL",598,292,"1200x900",800,1,600,400,"True",88,565,614,49,49,0
"C08YL",599,454,"1200x900",1000,0,600,400,"True",78,687,642,-45,45,1
"C08YL",600,64,"1200x900",600,0,600,400,"True",102,339,374,35,35,0
"C08YL",601,163,"1200x900",600,2,600,400,"False",1046,665,733,68,68,0
"C08YL",602,81,"1200x900",600,1,600,400,"False",696,225,313,88,88,0
"C08YL",603,313,"1200x900",800,1,600,400,"True",588,421,467,46,46,0
"C08YL",604,115,"1200x900",600,1,600,400,"False",545,307,144,-163,163,0
"C08YL",605,251,"1200x900",800,0,600,400,"False",88,352,453,101,101,1
"C08YL",606,304,"1200x900",800,1,600,400,"False",667,605,246,-359,359,0
"C08YL",607,56,"1200x900",600,0,600,400,"True",148,491,448,-43,43,0
"C08YL",608,382,"1200x900",800,2,600,400,"False",870,523,617,94,94,0
"C08YL",609,469,"1200x900",1000,0,600,400,"False",73,227,354,127,127,1
"C08YL",610,485,"1200x900",1000,0,600,400,"False",121,694,418,-276,276,1
"C08YL",611,6,"1200x900",600,0,600,400,"False",217,689,573,-116,116,1
"C08YL",612,490,"1200x900",1000,0,600,400,"False",114,183,390,207,207,1
"C08YL",613,383,"1200x900",800,2,600,400,"True",855,407,348,-59,59,0
"C08YL",614,173,"1200x900",600,2,600,400,"False",948,693,533,-160,160,0
"C08YL",615,321,"1200x900",800,1,600,400,"False",601,190,312,122,122,0
"C08YL",616,505,"1200x900",1000,1,600,400,"False",191,484,335,-149,149,1
"C08YL",617,219,"1200x900",800,0,600,400,"True",202,502,544,42,42,1
"C08YL",618,107,"1200x900",600,1,600,400,"True",878,678,656,-22,22,0
"C08YL",619,243,"1200x900",800,0,600,400,"True",114,332,344,12,12,1
"C08YL",620,179,"1200x900",600,2,600,400,"True",908,602,526,-76,76,0
"C08YL",621,299,"1200x900",800,1,600,400,"False",779,274,674,400,400,0
"C08YL",622,540,"1200x900",1000,1,600,400,"False",389,568,472,-96,96,1
"C08YL",623,581,"1200x900",1000,2,600,400,"True",310,357,287,-70,70,0
"C08YL",624,434,"1200x900",1000,0,600,400,"False",89,657,585,-72,72,1
"C08YL",625,421,"1200x900",800,2,600,400,"True",898,394,356,-38,38,0
"C08YL",626,535,"1200x900",1000,1,600,400,"True",372,410,442,32,32,0
"C08YL",627,521,"1200x900",1000,1,600,400,"True",111,303,275,-28,28,1
"C08YL",628,102,"1200x900",600,1,600,400,"False",861,603,705,102,102,0
"C08YL",629,31,"1200x900",600,0,600,400,"True",365,338,363,25,25,1
"C08YL",630,271,"1200x900",800,0,600,400,"False",74,360,438,78,78,1
"C08YL",631,384,"1200x900",800,2,600,400,"False",821,707,528,-179,179,0
"C08YL",632,579,"1200x900",1000,2,600,400,"True",803,394,385,-9,9,0
"C08YL",633,306,"1200x900",800,1,600,400,"False",164,524,741,217,217,0
"C08YL",634,470,"1200x900",1000,0,600,400,"False",91,666,471,-195,195,1
"C08YL",635,559,"1200x900",1000,1,600,400,"False",641,244,328,84,84,0
"C08YL",636,122,"1200x900",600,1,600,400,"True",817,709,735,26,26,0
"C08YL",637,560,"1200x900",1000,1,600,400,"False",516,693,589,-104,104,0
"C08YL",638,439,"1200x900",1000,0,600,400,"False",110,229,368,139,139,1
"C08YL",639,460,"1200x900",1000,0,600,400,"False",155,189,349,160,160,1
"C08YL",640,415,"1200x900",800,2,600,400,"False",823,684,534,-150,150,0
"C08YL",641,48,"1200x900",600,0,600,400,"True",323,645,642,-3,3,1
"C08YL",642,476,"1200x900",1000,0,600,400,"True",76,359,399,40,40,1
"C08YL",643,232,"1200x900",800,0,600,400,"True",84,511,548,37,37,1
"C08YL",644,47,"1200x900",600,0,600,400,"True",303,499,499,0,0,1
"C08YL",645,445,"1200x900",1000,0,600,400,"True",78,302,351,49,49,1
"C08YL",646,452,"1200x900",1000,0,600,400,"True",97,273,328,55,55,1
"C08YL",647,360,"1200x900",800,1,600,400,"True",203,608,627,19,19,0
"C08YL",648,4,"1200x900",600,0,600,400,"False",602,200,288,88,88,1
"C09JH",1,272,"1200x900",800,0,600,400,"False",200,181,460,279,279,1
"C09JH",2,20,"1200x900",600,0,600,400,"False",204,545,437,-108,108,1
"C09JH",3,323,"1200x900",800,1,600,400,"False",388,348,737,389,389,0
"C09JH",4,610,"1200x900",1000,2,600,400,"False",702,293,430,137,137,0
"C09JH",5,82,"1200x900",600,1,600,400,"True",108,213,219,6,6,0
"C09JH",6,473,"1200x900",1000,0,600,400,"False",75,323,633,310,310,1
"C09JH",7,120,"1200x900",600,1,600,400,"True",690,655,700,45,45,0
"C09JH",8,209,"1200x900",600,2,600,400,"False",937,637,699,62,62,0
"C09JH",9,114,"1200x900",600,1,600,400,"True",183,697,724,27,27,0
"C09JH",10,400,"1200x900",800,2,600,400,"True",733,297,345,48,48,0
"C09JH",11,396,"1200x900",800,2,600,400,"False",678,663,563,-100,100,0
"C09JH",12,509,"1200x900",1000,1,600,400,"False",509,434,508,74,74,0
"C09JH",13,224,"1200x900",800,0,600,400,"False",161,474,553,79,79,1
"C09JH",14,505,"1200x900",1000,1,600,400,"False",191,484,245,-239,239,1
"C09JH",15,284,"1200x900",800,0,600,400,"False",135,293,363,70,70,1
"C09JH",16,645,"1200x900",1000,2,600,400,"False",619,396,490,94,94,0
"C09JH",17,266,"1200x900",800,0,600,400,"True",126,303,306,3,3,1
"C09JH",18,227,"1200x900",800,0,600,400,"False",196,551,463,-88,88,1
"C09JH",19,408,"1200x900",800,2,600,400,"False",758,567,479,-88,88,0
"C09JH",20,247,"1200x900",800,0,600,400,"True",160,424,420,-4,4,1
"C09JH",21,202,"1200x900",600,2,600,400,"True",966,460,449,-11,11,0
"C09JH",22,241,"1200x900",800,0,600,400,"False",129,227,332,105,105,1
"C09JH",23,47,"1200x900",600,0,600,400,"False",303,499,408,-91,91,1
"C09JH",24,249,"1200x900",800,0,600,400,"False",126,306,404,98,98,1
"C09JH",25,220,"1200x900",800,0,600,400,"False",108,699,614,-85,85,1
"C09JH",26,354,"1200x900",800,1,600,400,"False",118,236,50,-186,186,0
"C09JH",27,63,"1200x900",600,0,600,400,"True",311,188,201,13,13,1
"C09JH",28,647,"1200x900",1000,2,600,400,"False",560,637,442,-195,195,0
"C09JH",30,283,"1200x900",800,0,600,400,"False",90,264,186,-78,78,1
"C09JH",31,219,"1200x900",800,0,600,400,"False",202,502,676,174,174,1
"C09JH",32,290,"1200x900",800,1,600,400,"False",789,603,390,-213,213,0
"C09JH",33,579,"1200x900",1000,2,600,400,"False",803,394,525,131,131,0
"C09JH",34,586,"1200x900",1000,2,600,400,"False",802,262,662,400,400,0
"C09JH",35,589,"1200x900",1000,2,600,400,"False",856,418,585,167,167,0
"C09JH",36,134,"1200x900",600,1,600,400,"True",300,188,148,-40,40,0
"C09JH",37,422,"1200x900",800,2,600,400,"True",712,558,607,49,49,0
"C09JH",38,391,"1200x900",800,2,600,400,"False",895,521,391,-130,130,0
"C09JH",39,198,"1200x900",600,2,600,400,"False",976,500,612,112,112,0
"C09JH",40,90,"1200x900",600,1,600,400,"False",560,474,335,-139,139,0
"C09JH",41,433,"1200x900",1000,0,600,400,"False",76,222,295,73,73,1
"C09JH",42,152,"1200x900",600,2,600,400,"True",971,399,375,-24,24,0
"C09JH",43,377,"1200x900",800,2,600,400,"True",683,388,408,20,20,0
"C09JH",44,139,"1200x900",600,1,600,400,"False",192,695,573,-122,122,0
"C09JH",45,450,"1200x900",1000,0,600,400,"False",130,204,499,295,295,1
"C09JH",46,104,"1200x900",600,1,600,400,"True",448,584,584,0,0,0
"C09JH",47,6,"1200x900",600,0,600,400,"False",217,689,563,-126,126,1
"C09JH",48,361,"1200x900",800,2,600,400,"False",931,328,575,247,247,0
"C09JH",49,389,"1200x900",800,2,600,400,"True",843,530,483,-47,47,0
"C09JH",50,267,"1200x900",800,0,600,400,"True",145,665,616,-49,49,1
"C09JH",51,502,"1200x900",1000,0,600,400,"False",111,639,495,-144,144,1
"C09JH",52,123,"1200x900",600,1,600,400,"True",761,365,360,-5,5,1
"C09JH",53,195,"1200x900",600,2,600,400,"True",942,249,331,82,82,0
"C09JH",54,174,"1200x900",600,2,600,400,"False",998,457,290,-167,167,0
"C09JH",56,425,"1200x900",800,2,600,400,"True",621,438,423,-15,15,0
"C09JH",57,598,"1200x900",1000,2,600,400,"True",706,559,579,20,20,0
"C09JH",58,339,"1200x900",800,1,600,400,"False",273,545,732,187,187,1
"C09JH",59,531,"1200x900",1000,1,600,400,"True",233,362,396,34,34,0
"C09JH",60,360,"1200x900",800,1,600,400,"False",203,608,780,172,172,0
"C09JH",61,128,"1200x900",600,1,600,400,"False",661,258,348,90,90,1
"C09JH",62,96,"1200x900",600,1,600,400,"False",433,458,752,294,294,0
"C09JH",63,619,"1200x900",1000,2,600,400,"False",803,247,806,559,559,0
"C09JH",64,151,"1200x900",600,2,600,400,"True",828,680,715,35,35,0
"C09JH",65,142,"1200x900",600,1,600,400,"False",286,474,675,201,201,0
"C09JH",66,454,"1200x900",1000,0,600,400,"False",78,687,572,-115,115,1
"C09JH",67,179,"1200x900",600,2,600,400,"True",908,602,611,9,9,0
"C09JH",68,526,"1200x900",1000,1,600,400,"True",497,710,669,-41,41,0
"C09JH",69,100,"1200x900",600,1,600,400,"True",453,511,497,-14,14,0
"C09JH",70,206,"1200x900",600,2,600,400,"False",975,223,453,230,230,0
"C09JH",71,107,"1200x900",600,1,600,400,"False",878,678,544,-134,134,0
"C09JH",72,646,"1200x900",1000,2,600,400,"False",829,227,496,269,269,1
"C09JH",73,69,"1200x900",600,0,600,400,"True",322,268,327,59,59,0
"C09JH",74,154,"1200x900",600,2,600,400,"False",941,454,297,-157,157,0
"C09JH",75,78,"1200x900",600,1,600,400,"False",885,684,751,67,67,0
"C09JH",76,86,"1200x900",600,1,600,400,"False",692,388,555,167,167,1
"C09JH",77,321,"1200x900",800,1,600,400,"False",601,190,399,209,209,0
"C09JH",78,302,"1200x900",800,1,600,400,"False",479,467,698,231,231,1
"C09JH",79,490,"1200x900",1000,0,600,400,"False",114,183,391,208,208,1
"C09JH",80,294,"1200x900",800,1,600,400,"False",262,287,551,264,264,0
"C09JH",81,261,"1200x900",800,0,600,400,"True",86,713,729,16,16,1
"C09JH",82,417,"1200x900",800,2,600,400,"False",750,280,549,269,269,0
"C09JH",83,347,"1200x900",800,1,600,400,"False",757,295,639,344,344,1
"C09JH",84,276,"1200x900",800,0,600,400,"False",281,217,466,249,249,1
"C09JH",85,574,"1200x900",1000,1,600,400,"False",614,194,318,124,124,0
"C09JH",86,138,"1200x900",600,1,600,400,"True",844,580,498,-82,82,1
"C09JH",88,465,"1200x900",1000,0,600,400,"False",85,203,472,269,269,1
"C09JH",89,515,"1200x900",1000,1,600,400,"False",307,217,362,145,145,0
"C09JH",90,242,"1200x900",800,0,600,400,"False",117,448,358,-90,90,1
"C09JH",91,133,"1200x900",600,1,600,400,"False",345,551,695,144,144,0
"C09JH",92,500,"1200x900",1000,0,600,400,"False",105,700,481,-219,219,1
"C09JH",93,189,"1200x900",600,2,600,400,"True",881,397,463,66,66,0
"C09JH",94,397,"1200x900",800,2,600,400,"False",817,692,506,-186,186,0
"C09JH",95,638,"1200x900",1000,2,600,400,"False",385,198,517,319,319,0
"C09JH",96,544,"1200x900",1000,1,600,400,"False",602,620,448,-172,172,0
"C09JH",97,591,"1200x900",1000,2,600,400,"False",698,336,415,79,79,0
"C09JH",100,639,"1200x900",1000,2,600,400,"False",504,456,727,271,271,0
"C09JH",101,22,"1200x900",600,0,600,400,"True",398,591,567,-24,24,1
"C09JH",102,424,"1200x900",800,2,600,400,"False",903,545,428,-117,117,0
"C09JH",103,456,"1200x900",1000,0,600,400,"False",91,257,387,130,130,1
"C09JH",104,487,"1200x900",1000,0,600,400,"False",78,670,446,-224,224,1
"C09JH",105,595,"1200x900",1000,2,600,400,"False",687,640,447,-193,193,0
"C09JH",106,552,"1200x900",1000,1,600,400,"False",255,412,804,392,392,0
"C09JH",107,168,"1200x900",600,2,600,400,"True",1001,439,418,-21,21,0
"C09JH",108,211,"1200x900",600,2,600,400,"False",986,407,322,-85,85,0
"C09JH",109,205,"1200x900",600,2,600,400,"False",1021,504,687,183,183,0
"C09JH",110,3,"1200x900",600,0,600,400,"False",298,443,329,-114,114,1
"C09JH",112,210,"1200x900",600,2,600,400,"False",835,506,358,-148,148,0
"C09JH",113,525,"1200x900",1000,1,600,400,"False",123,690,350,-340,340,0
"C09JH",114,466,"1200x900",1000,0,600,400,"False",82,205,314,109,109,1
"C09JH",116,434,"1200x900",1000,0,600,400,"False",89,657,380,-277,277,1
"C09JH",117,507,"1200x900",1000,1,600,400,"False",608,583,415,-168,168,1
"C09JH",120,75,"1200x900",600,1,600,400,"True",635,558,577,19,19,0
"C09JH",121,328,"1200x900",800,1,600,400,"False",104,649,780,131,131,0
"C09JH",122,233,"1200x900",800,0,600,400,"True",164,700,745,45,45,1
"C09JH",123,64,"1200x900",600,0,600,400,"True",102,339,392,53,53,0
"C09JH",124,438,"1200x900",1000,0,600,400,"False",77,713,505,-208,208,1
"C09JH",125,62,"1200x900",600,0,600,400,"True",345,346,391,45,45,1
"C09JH",126,486,"1200x900",1000,0,600,400,"False",102,676,476,-200,200,1
"C09JH",128,11,"1200x900",600,0,600,400,"False",372,670,603,-67,67,1
"C09JH",129,31,"1200x900",600,0,600,400,"True",365,338,351,13,13,1
"C09JH",130,185,"1200x900",600,2,600,400,"False",907,212,302,90,90,0
"C09JH",131,549,"1200x900",1000,1,600,400,"False",657,366,446,80,80,0
"C09JH",132,167,"1200x900",600,2,600,400,"False",956,241,405,164,164,0
"C09JH",133,529,"1200x900",1000,1,600,400,"True",267,412,356,-56,56,1
"C09JH",134,144,"1200x900",600,1,600,400,"True",718,371,357,-14,14,0
"C09JH",135,199,"1200x900",600,2,600,400,"False",992,467,310,-157,157,0
"C09JH",136,15,"1200x900",600,0,600,400,"True",473,352,386,34,34,1
"C09JH",137,315,"1200x900",800,1,600,400,"False",105,211,472,261,261,0
"C09JH",138,385,"1200x900",800,2,600,400,"False",740,456,526,70,70,0
"C09JH",139,435,"1200x900",1000,0,600,400,"False",119,200,379,179,179,1
"C09JH",140,103,"1200x900",600,1,600,400,"True",528,320,380,60,60,1
"C09JH",141,73,"1200x900",600,1,600,400,"True",94,665,568,-97,97,0
"C09JH",142,176,"1200x900",600,2,600,400,"True",1033,281,374,93,93,0
"C09JH",143,121,"1200x900",600,1,600,400,"True",884,364,332,-32,32,0
"C09JH",144,218,"1200x900",800,0,600,400,"True",106,397,404,7,7,1
"C09JH",145,115,"1200x900",600,1,600,400,"True",545,307,301,-6,6,0
"C09JH",146,66,"1200x900",600,0,600,400,"True",155,673,712,39,39,0
"C09JH",147,295,"1200x900",800,1,600,400,"True",471,334,353,19,19,0
"C09JH",148,496,"1200x900",1000,0,600,400,"False",70,639,427,-212,212,1
"C09JH",149,270,"1200x900",800,0,600,400,"True",192,418,409,-9,9,1
"C09JH",150,298,"1200x900",800,1,600,400,"True",311,457,421,-36,36,0
"C09JH",152,621,"1200x900",1000,2,600,400,"True",540,478,437,-41,41,0
"C09JH",153,495,"1200x900",1000,0,600,400,"False",93,692,533,-159,159,1
"C09JH",154,441,"1200x900",1000,0,600,400,"False",85,684,527,-157,157,1
"C09JH",155,472,"1200x900",1000,0,600,400,"False",77,685,549,-136,136,1
"C09JH",156,55,"1200x900",600,0,600,400,"False",211,305,469,164,164,1
"C09JH",157,67,"1200x900",600,0,600,400,"False",289,308,393,85,85,1
"C09JH",158,448,"1200x900",1000,0,600,400,"False",107,641,495,-146,146,1
"C09JH",159,178,"1200x900",600,2,600,400,"True",1041,510,521,11,11,0
"C09JH",160,534,"1200x900",1000,1,600,400,"False",328,504,628,124,124,1
"C09JH",161,337,"1200x900",800,1,600,400,"False",299,622,689,67,67,0
"C09JH",162,160,"1200x900",600,2,600,400,"True",863,606,581,-25,25,0
"C09JH",163,329,"1200x900",800,1,600,400,"False",517,239,448,209,209,0
"C09JH",164,352,"1200x900",800,1,600,400,"False",235,717,493,-224,224,0
"C09JH",165,443,"1200x900",1000,0,600,400,"False",99,651,435,-216,216,1
"C09JH",166,143,"1200x900",600,1,600,400,"False",479,284,446,162,162,1
"C09JH",167,250,"1200x900",800,0,600,400,"False",290,248,349,101,101,1
"C09JH",168,32,"1200x900",600,0,600,400,"False",152,563,379,-184,184,1
"C09JH",169,351,"1200x900",800,1,600,400,"False",122,581,434,-147,147,0
"C09JH",170,177,"1200x900",600,2,600,400,"False",912,236,399,163,163,0
"C09JH",172,520,"1200x900",1000,1,600,400,"False",564,260,503,243,243,0
"C09JH",173,530,"1200x900",1000,1,600,400,"False",584,405,276,-129,129,1
"C09JH",174,234,"1200x900",800,0,600,400,"False",72,344,419,75,75,1
"C09JH",175,547,"1200x900",1000,1,600,400,"True",369,384,430,46,46,1
"C09JH",176,553,"1200x900",1000,1,600,400,"False",116,712,455,-257,257,0
"C09JH",177,316,"1200x900",800,1,600,400,"False",362,319,492,173,173,0
"C09JH",178,225,"1200x900",800,0,600,400,"True",178,423,394,-29,29,1
"C09JH",179,606,"1200x900",1000,2,600,400,"False",653,627,517,-110,110,0
"C09JH",180,512,"1200x900",1000,1,600,400,"False",139,261,501,240,240,0
"C09JH",181,278,"1200x900",800,0,600,400,"False",251,711,551,-160,160,1
"C09JH",182,576,"1200x900",1000,1,600,400,"True",376,713,738,25,25,0
"C09JH",183,200,"1200x900",600,2,600,400,"False",897,302,465,163,163,0
"C09JH",184,611,"1200x900",1000,2,600,400,"True",414,511,487,-24,24,0
"C09JH",185,274,"1200x900",800,0,600,400,"True",146,497,449,-48,48,1
"C09JH",186,291,"1200x900",800,1,600,400,"False",522,694,562,-132,132,0
"C09JH",187,81,"1200x900",600,1,600,400,"False",696,225,579,354,354,0
"C09JH",188,446,"1200x900",1000,0,600,400,"False",72,298,440,142,142,1
"C09JH",189,532,"1200x900",1000,1,600,400,"True",215,207,259,52,52,0
"C09JH",190,365,"1200x900",800,2,600,400,"False",1055,305,411,106,106,0
"C09JH",192,7,"1200x900",600,0,600,400,"False",431,654,566,-88,88,1
"C09JH",193,484,"1200x900",1000,0,600,400,"False",100,223,456,233,233,1
"C09JH",194,43,"1200x900",600,0,600,400,"True",277,446,440,-6,6,1
"C09JH",195,548,"1200x900",1000,1,600,400,"False",103,278,375,97,97,0
"C09JH",196,293,"1200x900",800,1,600,400,"False",561,396,482,86,86,0
"C09JH",197,344,"1200x900",800,1,600,400,"False",589,408,519,111,111,0
"C09JH",198,282,"1200x900",800,0,600,400,"False",109,246,316,70,70,1
"C09JH",199,635,"1200x900",1000,2,600,400,"True",833,402,459,57,57,0
"C09JH",200,511,"1200x900",1000,1,600,400,"True",408,390,440,50,50,1
"C09JH",201,565,"1200x900",1000,1,600,400,"False",451,562,638,76,76,0
"C09JH",202,317,"1200x900",800,1,600,400,"False",185,564,374,-190,190,0
"C09JH",203,416,"1200x900",800,2,600,400,"False",748,617,469,-148,148,0
"C09JH",204,497,"1200x900",1000,0,600,400,"False",106,696,504,-192,192,1
"C09JH",205,217,"1200x900",800,0,600,400,"False",85,573,508,-65,65,1
"C09JH",207,542,"1200x900",1000,1,600,400,"True",304,401,495,94,94,0
"C09JH",208,166,"1200x900",600,2,600,400,"False",896,274,446,172,172,0
"C09JH",209,508,"1200x900",1000,1,600,400,"True",596,485,457,-28,28,0
"C09JH",210,540,"1200x900",1000,1,600,400,"False",389,568,657,89,89,1
"C09JH",211,157,"1200x900",600,2,600,400,"False",1016,323,438,115,115,0
"C09JH",212,519,"1200x900",1000,1,600,400,"False",319,565,421,-144,144,1
"C09JH",213,573,"1200x900",1000,1,600,400,"False",486,615,465,-150,150,0
"C09JH",214,370,"1200x900",800,2,600,400,"False",874,336,519,183,183,0
"C09JH",215,541,"1200x900",1000,1,600,400,"True",339,478,455,-23,23,0
"C09JH",216,468,"1200x900",1000,0,600,400,"True",121,219,273,54,54,1
"C09JH",217,604,"1200x900",1000,2,600,400,"False",459,593,418,-175,175,0
"C09JH",218,325,"1200x900",800,1,600,400,"True",105,394,433,39,39,0
"C09JH",219,296,"1200x900",800,1,600,400,"False",89,279,455,176,176,0
"C09JH",220,158,"1200x900",600,2,600,400,"False",939,300,451,151,151,0
"C09JH",221,528,"1200x900",1000,1,600,400,"False",839,227,383,156,156,1
"C09JH",222,384,"1200x900",800,2,600,400,"False",821,707,404,-303,303,0
"C09JH",223,399,"1200x900",800,2,600,400,"False",603,602,518,-84,84,0
"C09JH",224,240,"1200x900",800,0,600,400,"False",330,656,531,-125,125,1
"C09JH",225,335,"1200x900",800,1,600,400,"False",124,360,440,80,80,0
"C09JH",226,407,"1200x900",800,2,600,400,"False",989,340,563,223,223,0
"C09JH",227,299,"1200x900",800,1,600,400,"False",779,274,480,206,206,0
"C09JH",228,194,"1200x900",600,2,600,400,"False",896,236,441,205,205,0
"C09JH",229,474,"1200x900",1000,0,600,400,"True",85,339,265,-74,74,1
"C09JH",230,25,"1200x900",600,0,600,400,"True",263,403,415,12,12,1
"C09JH",231,483,"1200x900",1000,0,600,400,"False",93,191,289,98,98,1
"C09JH",232,58,"1200x900",600,0,600,400,"False",353,655,541,-114,114,1
"C09JH",233,130,"1200x900",600,1,600,400,"True",741,428,366,-62,62,0
"C09JH",234,10,"1200x900",600,0,600,400,"False",400,499,415,-84,84,1
"C09JH",235,258,"1200x900",800,0,600,400,"False",126,664,546,-118,118,1
"C09JH",236,102,"1200x900",600,1,600,400,"True",861,603,606,3,3,0
"C09JH",237,310,"1200x900",800,1,600,400,"True",559,592,635,43,43,0
"C09JH",238,603,"1200x900",1000,2,600,400,"False",693,280,533,253,253,0
"C09JH",239,430,"1200x900",800,2,600,400,"False",922,254,504,250,250,0
"C09JH",240,640,"1200x900",1000,2,600,400,"False",361,334,415,81,81,0
"C09JH",242,362,"1200x900",800,2,600,400,"False",819,338,493,155,155,0
"C09JH",243,613,"1200x900",1000,2,600,400,"False",690,374,561,187,187,0
"C09JH",244,566,"1200x900",1000,1,600,400,"True",378,472,422,-50,50,1
"C09JH",245,155,"1200x900",600,2,600,400,"False",940,269,429,160,160,0
"C09JH",246,555,"1200x900",1000,1,600,400,"False",444,556,678,122,122,0
"C09JH",247,412,"1200x900",800,2,600,400,"False",842,280,614,334,334,0
"C09JH",248,455,"1200x900",1000,0,600,400,"False",107,718,580,-138,138,1
"C09JH",249,34,"1200x900",600,0,600,400,"False",361,242,140,-102,102,1
"C09JH",250,632,"1200x900",1000,2,600,400,"False",984,227,446,219,219,0
"C09JH",252,622,"1200x900",1000,2,600,400,"False",307,683,474,-209,209,0
"C09JH",253,288,"1200x900",800,0,600,400,"True",180,547,593,46,46,1
"C09JH",254,614,"1200x900",1000,2,600,400,"False",823,563,418,-145,145,0
"C09JH",255,257,"1200x900",800,0,600,400,"True",97,219,258,39,39,1
"C09JH",256,535,"1200x900",1000,1,600,400,"False",372,410,684,274,274,0
"C09JH",257,203,"1200x900",600,2,600,400,"True",938,603,569,-34,34,0
"C09JH",258,71,"1200x900",600,0,600,400,"True",219,248,266,18,18,0
"C09JH",259,462,"1200x900",1000,0,600,400,"False",102,672,433,-239,239,1
"C09JH",260,494,"1200x900",1000,0,600,400,"False",127,692,576,-116,116,1
"C09JH",261,506,"1200x900",1000,1,600,400,"False",559,567,437,-130,130,1
"C09JH",262,569,"1200x900",1000,1,600,400,"False",494,720,525,-195,195,0
"C09JH",263,415,"1200x900",800,2,600,400,"True",823,684,627,-57,57,0
"C09JH",264,42,"1200x900",600,0,600,400,"False",233,479,636,157,157,0
"C09JH",265,594,"1200x900",1000,2,600,400,"False",537,637,528,-109,109,0
"C09JH",266,38,"1200x900",600,0,600,400,"True",120,628,633,5,5,1
"C09JH",267,59,"1200x900",600,0,600,400,"True",391,692,655,-37,37,1
"C09JH",268,429,"1200x900",800,2,600,400,"True",682,692,644,-48,48,0
"C09JH",269,453,"1200x900",1000,0,600,400,"False",71,393,555,162,162,1
"C09JH",270,452,"1200x900",1000,0,600,400,"False",97,273,491,218,218,1
"C09JH",271,571,"1200x900",1000,1,600,400,"False",239,522,667,145,145,1
"C09JH",272,108,"1200x900",600,1,600,400,"False",830,239,457,218,218,0
"C09JH",273,471,"1200x900",1000,0,600,400,"False",122,200,361,161,161,1
"C09JH",274,413,"1200x900",800,2,600,400,"True",849,506,542,36,36,0
"C09JH",275,458,"1200x900",1000,0,600,400,"True",78,624,687,63,63,1
"C09JH",276,21,"1200x900",600,0,600,400,"False",314,383,457,74,74,1
"C09JH",277,216,"1200x900",600,2,600,400,"False",1029,286,494,208,208,0
"C09JH",278,277,"1200x900",800,0,600,400,"True",140,310,366,56,56,1
"C09JH",279,356,"1200x900",800,1,600,400,"False",123,484,547,63,63,0
"C09JH",280,390,"1200x900",800,2,600,400,"False",982,674,475,-199,199,1
"C09JH",281,563,"1200x900",1000,1,600,400,"True",201,696,715,19,19,0
"C09JH",282,16,"1200x900",600,0,600,400,"False",297,514,668,154,154,1
"C09JH",283,393,"1200x900",800,2,600,400,"True",657,620,629,9,9,0
"C09JH",284,449,"1200x900",1000,0,600,400,"False",105,683,598,-85,85,1
"C09JH",285,436,"1200x900",1000,0,600,400,"True",82,617,635,18,18,1
"C09JH",286,551,"1200x900",1000,1,600,400,"False",146,445,663,218,218,1
"C09JH",288,409,"1200x900",800,2,600,400,"True",501,659,595,-64,64,0
"C09JH",289,570,"1200x900",1000,1,600,400,"False",315,352,613,261,261,0
"C09JH",290,147,"1200x900",600,2,600,400,"True",942,418,449,31,31,0
"C09JH",291,374,"1200x900",800,2,600,400,"True",755,450,509,59,59,0
"C09JH",292,624,"1200x900",1000,2,600,400,"True",693,501,494,-7,7,0
"C09JH",293,136,"1200x900",600,1,600,400,"False",264,205,460,255,255,0
"C09JH",294,478,"1200x900",1000,0,600,400,"False",79,672,470,-202,202,1
"C09JH",295,19,"1200x900",600,0,600,400,"False",286,686,622,-64,64,0
"C09JH",296,27,"1200x900",600,0,600,400,"False",373,309,373,64,64,1
"C09JH",297,37,"1200x900",600,0,600,400,"True",258,403,444,41,41,1
"C09JH",298,153,"1200x900",600,2,600,400,"False",1037,601,452,-149,149,0
"C09JH",299,13,"1200x900",600,0,600,400,"False",296,211,366,155,155,1
"C09JH",301,48,"1200x900",600,0,600,400,"False",323,645,511,-134,134,1
"C09JH",302,533,"1200x900",1000,1,600,400,"False",355,483,664,181,181,0
"C09JH",303,355,"1200x900",800,1,600,400,"False",77,386,631,245,245,0
"C09JH",304,162,"1200x900",600,2,600,400,"False",849,279,441,162,162,0
"C09JH",305,305,"1200x900",800,1,600,400,"False",471,716,517,-199,199,0
"C09JH",306,398,"1200x900",800,2,600,400,"False",944,698,530,-168,168,0
"C09JH",307,303,"1200x900",800,1,600,400,"False",241,431,323,-108,108,0
"C09JH",308,406,"1200x900",800,2,600,400,"False",971,233,379,146,146,0
"C09JH",309,644,"1200x900",1000,2,600,400,"False",495,486,338,-148,148,0
"C09JH",310,57,"1200x900",600,0,600,400,"True",354,508,534,26,26,1
"C09JH",311,517,"1200x900",1000,1,600,400,"False",548,182,258,76,76,0
"C09JH",312,243,"1200x900",800,0,600,400,"True",114,332,303,-29,29,1
"C09JH",313,593,"1200x900",1000,2,600,400,"False",246,719,579,-140,140,0
"C09JH",314,41,"1200x900",600,0,600,400,"True",370,452,455,3,3,1
"C09JH",315,193,"1200x900",600,2,600,400,"True",874,588,540,-48,48,0
"C09JH",316,131,"1200x900",600,1,600,400,"False",531,367,539,172,172,0
"C09JH",317,564,"1200x900",1000,1,600,400,"True",215,264,330,66,66,0
"C09JH",318,371,"1200x900",800,2,600,400,"True",730,560,519,-41,41,0
"C09JH",319,357,"1200x900",800,1,600,400,"True",109,594,547,-47,47,0
"C09JH",320,618,"1200x900",1000,2,600,400,"False",276,671,564,-107,107,0
"C09JH",321,45,"1200x900",600,0,600,400,"False",487,678,586,-92,92,1
"C09JH",322,91,"1200x900",600,1,600,400,"False",417,630,546,-84,84,1
"C09JH",323,110,"1200x900",600,1,600,400,"True",776,550,560,10,10,1
"C09JH",324,561,"1200x900",1000,1,600,400,"False",231,406,579,173,173,0
"C09JH",325,386,"1200x900",800,2,600,400,"False",774,301,425,124,124,0
"C09JH",326,504,"1200x900",1000,0,600,400,"False",107,699,583,-116,116,1
"C09JH",327,137,"1200x900",600,1,600,400,"True",789,577,510,-67,67,0
"C09JH",328,1,"1200x900",600,0,600,400,"True",136,502,496,-6,6,0
"C09JH",329,201,"1200x900",600,2,600,400,"True",1005,462,436,-26,26,0
"C09JH",330,567,"1200x900",1000,1,600,400,"True",655,297,373,76,76,1
"C09JH",331,353,"1200x900",800,1,600,400,"True",90,476,430,-46,46,0
"C09JH",332,623,"1200x900",1000,2,600,400,"True",636,527,524,-3,3,0
"C09JH",333,522,"1200x900",1000,1,600,400,"False",223,379,488,109,109,0
"C09JH",334,405,"1200x900",800,2,600,400,"False",790,307,458,151,151,0
"C09JH",335,228,"1200x900",800,0,600,400,"True",174,687,633,-54,54,1
"C09JH",336,23,"1200x900",600,0,600,400,"False",308,463,544,81,81,1
"C09JH",337,345,"1200x900",800,1,600,400,"False",841,566,415,-151,151,1
"C09JH",338,592,"1200x900",1000,2,600,400,"False",492,392,513,121,121,0
"C09JH",340,381,"1200x900",800,2,600,400,"True",705,408,425,17,17,0
"C09JH",341,392,"1200x900",800,2,600,400,"False",1031,618,433,-185,185,0
"C09JH",342,164,"1200x900",600,2,600,400,"False",1051,268,396,128,128,0
"C09JH",343,286,"1200x900",800,0,600,400,"True",105,378,366,-12,12,1
"C09JH",344,587,"1200x900",1000,2,600,400,"False",741,686,382,-304,304,0
"C09JH",345,281,"1200x900",800,0,600,400,"False",112,611,514,-97,97,1
"C09JH",346,601,"1200x900",1000,2,600,400,"False",735,697,503,-194,194,0
"C09JH",347,30,"1200x900",600,0,600,400,"False",107,353,428,75,75,0
"C09JH",348,394,"1200x900",800,2,600,400,"False",847,292,427,135,135,0
"C09JH",349,304,"1200x900",800,1,600,400,"False",667,605,459,-146,146,0
"C09JH",350,52,"1200x900",600,0,600,400,"True",171,188,235,47,47,0
"C09JH",351,145,"1200x900",600,2,600,400,"False",1004,630,456,-174,174,0
"C09JH",352,204,"1200x900",600,2,600,400,"True",1053,432,400,-32,32,0
"C09JH",353,636,"1200x900",1000,2,600,400,"False",575,583,658,75,75,0
"C09JH",354,297,"1200x900",800,1,600,400,"False",625,244,420,176,176,0
"C09JH",355,273,"1200x900",800,0,600,400,"False",180,309,384,75,75,1
"C09JH",356,197,"1200x900",600,2,600,400,"False",903,212,402,190,190,0
"C09JH",357,575,"1200x900",1000,1,600,400,"False",272,693,460,-233,233,0
"C09JH",358,163,"1200x900",600,2,600,400,"False",1046,665,536,-129,129,0
"C09JH",359,585,"1200x900",1000,2,600,400,"False",698,688,539,-149,149,1
"C09JH",360,113,"1200x900",600,1,600,400,"False",897,657,477,-180,180,0
"C09JH",361,190,"1200x900",600,2,600,400,"False",977,238,470,232,232,0
"C09JH",362,98,"1200x900",600,1,600,400,"True",625,530,518,-12,12,0
"C09JH",363,275,"1200x900",800,0,600,400,"True",120,594,561,-33,33,0
"C09JH",365,559,"1200x900",1000,1,600,400,"True",641,244,213,-31,31,0
"C09JH",366,260,"1200x900",800,0,600,400,"False",103,525,343,-182,182,1
"C09JH",367,93,"1200x900",600,1,600,400,"False",139,540,362,-178,178,0
"C09JH",368,49,"1200x900",600,0,600,400,"True",109,380,386,6,6,0
"C09JH",370,637,"1200x900",1000,2,600,400,"True",750,460,376,-84,84,0
"C09JH",371,320,"1200x900",800,1,600,400,"False",644,376,453,77,77,0
"C09JH",372,368,"1200x900",800,2,600,400,"False",778,515,413,-102,102,0
"C09JH",373,68,"1200x900",600,0,600,400,"True",165,367,321,-46,46,0
"C09JH",374,402,"1200x900",800,2,600,400,"False",878,234,344,110,110,0
"C09JH",376,311,"1200x900",800,1,600,400,"False",710,261,357,96,96,0
"C09JH",377,129,"1200x900",600,1,600,400,"False",859,482,301,-181,181,1
"C09JH",378,590,"1200x900",1000,2,600,400,"False",636,278,409,131,131,0
"C09JH",379,280,"1200x900",800,0,600,400,"True",104,302,353,51,51,1
"C09JH",380,518,"1200x900",1000,1,600,400,"False",583,717,374,-343,343,0
"C09JH",381,309,"1200x900",800,1,600,400,"False",186,225,341,116,116,0
"C09JH",382,410,"1200x900",800,2,600,400,"False",916,477,377,-100,100,0
"C09JH",383,35,"1200x900",600,0,600,400,"True",366,555,524,-31,31,1
"C09JH",384,364,"1200x900",800,2,600,400,"False",1018,204,487,283,283,0
"C09JH",385,244,"1200x900",800,0,600,400,"True",194,203,161,-42,42,1
"C09JH",386,477,"1200x900",1000,0,600,400,"False",88,640,369,-271,271,1
"C09JH",387,289,"1200x900",800,1,600,400,"False",421,703,580,-123,123,1
"C09JH",389,383,"1200x900",800,2,600,400,"False",855,407,564,157,157,0
"C09JH",390,255,"1200x900",800,0,600,400,"False",93,709,621,-88,88,1
"C09JH",391,536,"1200x900",1000,1,600,400,"True",580,213,254,41,41,0
"C09JH",392,70,"1200x900",600,0,600,400,"True",309,703,711,8,8,1
"C09JH",393,169,"1200x900",600,2,600,400,"False",924,290,405,115,115,0
"C09JH",394,226,"1200x900",800,0,600,400,"False",187,229,308,79,79,1
"C09JH",395,301,"1200x900",800,1,600,400,"False",162,574,441,-133,133,0
"C09JH",396,404,"1200x900",800,2,600,400,"True",842,396,428,32,32,0
"C09JH",397,112,"1200x900",600,1,600,400,"False",681,490,404,-86,86,0
"C09JH",398,626,"1200x900",1000,2,600,400,"True",329,449,462,13,13,0
"C09JH",399,447,"1200x900",1000,0,600,400,"True",71,339,391,52,52,1
"C09JH",400,600,"1200x900",1000,2,600,400,"False",765,207,362,155,155,0
"C09JH",401,363,"1200x900",800,2,600,400,"False",800,218,403,185,185,0
"C09JH",402,5,"1200x900",600,0,600,400,"False",228,587,519,-68,68,0
"C09JH",403,87,"1200x900",600,1,600,400,"False",231,604,451,-153,153,0
"C09JH",404,648,"1200x900",1000,2,600,400,"False",557,394,514,120,120,0
"C09JH",405,223,"1200x900",800,0,600,400,"True",179,191,130,-61,61,1
"C09JH",406,340,"1200x900",800,1,600,400,"False",226,240,489,249,249,0
"C09JH",407,125,"1200x900",600,1,600,400,"True",750,531,470,-61,61,0
"C09JH",408,126,"1200x900",600,1,600,400,"True",849,354,338,-16,16,0
"C09JH",409,369,"1200x900",800,2,600,400,"False",903,594,313,-281,281,0
"C09JH",410,156,"1200x900",600,2,600,400,"False",913,197,324,127,127,0
"C09JH",411,77,"1200x900",600,1,600,400,"True",780,525,509,-16,16,0
"C09JH",412,83,"1200x900",600,1,600,400,"False",763,568,480,-88,88,1
"C09JH",413,602,"1200x900",1000,2,600,400,"True",865,452,450,-2,2,0
"C09JH",414,175,"1200x900",600,2,600,400,"True",1028,432,433,1,1,0
"C09JH",415,378,"1200x900",800,2,600,400,"False",1018,708,423,-285,285,0
"C09JH",416,358,"1200x900",800,1,600,400,"False",263,635,390,-245,245,0
"C09JH",417,348,"1200x900",800,1,600,400,"False",764,294,373,79,79,0
"C09JH",418,382,"1200x900",800,2,600,400,"False",870,523,355,-168,168,0
"C09JH",419,254,"1200x900",800,0,600,400,"False",136,583,495,-88,88,1
"C09JH",420,427,"1200x900",800,2,600,400,"True",812,380,410,30,30,0
"C09JH",421,479,"1200x900",1000,0,600,400,"False",74,705,516,-189,189,1
"C09JH",422,620,"1200x900",1000,2,600,400,"False",832,649,464,-185,185,0
"C09JH",423,423,"1200x900",800,2,600,400,"False",1051,710,408,-302,302,1
"C09JH",425,313,"1200x900",800,1,600,400,"False",588,421,490,69,69,0
"C09JH",426,118,"1200x900",600,1,600,400,"False",190,588,420,-168,168,0
"C09JH",427,127,"1200x900",600,1,600,400,"False",309,691,532,-159,159,0
"C09JH",428,92,"1200x900",600,1,600,400,"True",624,605,575,-30,30,0
"C09JH",429,359,"1200x900",800,1,600,400,"False",653,241,564,323,323,0
"C09JH",430,442,"1200x900",1000,0,600,400,"False",87,183,397,214,214,1
"C09JH",431,482,"1200x900",1000,0,600,400,"False",79,686,505,-181,181,1
"C09JH",432,379,"1200x900",800,2,600,400,"False",994,325,481,156,156,0
"C09JH",433,196,"1200x900",600,2,600,400,"True",1030,397,409,12,12,0
"C09JH",434,539,"1200x900",1000,1,600,400,"True",510,383,318,-65,65,0
"C09JH",435,546,"1200x900",1000,1,600,400,"True",305,374,345,-29,29,0
"C09JH",436,8,"1200x900",600,0,600,400,"False",156,679,553,-126,126,0
"C09JH",437,414,"1200x900",800,2,600,400,"True",831,592,569,-23,23,0
"C09JH",438,572,"1200x900",1000,1,600,400,"False",302,260,557,297,297,0
"C09JH",439,148,"1200x900",600,2,600,400,"False",907,330,489,159,159,0
"C09JH",440,279,"1200x900",800,0,600,400,"False",252,202,287,85,85,1
"C09JH",441,208,"1200x900",600,2,600,400,"True",946,399,435,36,36,0
"C09JH",443,140,"1200x900",600,1,600,400,"True",700,523,512,-11,11,0
"C09JH",444,231,"1200x900",800,0,600,400,"False",251,718,602,-116,116,1
"C09JH",445,463,"1200x900",1000,0,600,400,"False",115,693,615,-78,78,1
"C09JH",446,188,"1200x900",600,2,600,400,"False",900,195,498,303,303,0
"C09JH",447,333,"1200x900",800,1,600,400,"False",521,548,440,-108,108,0
"C09JH",448,343,"1200x900",800,1,600,400,"False",407,557,448,-109,109,0
"C09JH",449,245,"1200x900",800,0,600,400,"False",296,235,438,203,203,1
"C09JH",450,599,"1200x900",1000,2,600,400,"False",316,570,376,-194,194,0
"C09JH",451,122,"1200x900",600,1,600,400,"False",817,709,497,-212,212,0
"C09JH",452,287,"1200x900",800,0,600,400,"True",120,567,593,26,26,1
"C09JH",453,246,"1200x900",800,0,600,400,"False",196,418,493,75,75,1
"C09JH",454,141,"1200x900",600,1,600,400,"True",671,582,519,-63,63,0
"C09JH",455,341,"1200x900",800,1,600,400,"False",735,632,541,-91,91,1
"C09JH",456,481,"1200x900",1000,0,600,400,"False",80,185,349,164,164,1
"C09JH",457,229,"1200x900",800,0,600,400,"True",117,697,745,48,48,1
"C09JH",458,642,"1200x900",1000,2,600,400,"False",776,316,726,410,410,0
"C09JH",459,476,"1200x900",1000,0,600,400,"False",76,359,564,205,205,1
"C09JH",460,119,"1200x900",600,1,600,400,"False",168,563,667,104,104,0
"C09JH",461,230,"1200x900",800,0,600,400,"True",99,678,636,-42,42,1
"C09JH",463,513,"1200x900",1000,1,600,400,"False",235,602,517,-85,85,0
"C09JH",464,457,"1200x900",1000,0,600,400,"True",97,630,597,-33,33,1
"C09JH",466,111,"1200x900",600,1,600,400,"True",922,552,556,4,4,1
"C09JH",467,489,"1200x900",1000,0,600,400,"True",88,604,551,-53,53,1
"C09JH",468,581,"1200x900",1000,2,600,400,"False",310,357,543,186,186,0
"C09JH",469,150,"1200x900",600,2,600,400,"False",897,345,512,167,167,0
"C09JH",470,26,"1200x900",600,0,600,400,"False",70,712,620,-92,92,0
"C09JH",471,401,"1200x900",800,2,600,400,"False",821,260,595,335,335,0
"C09JH",472,222,"1200x900",800,0,600,400,"False",152,206,274,68,68,1
"C09JH",473,597,"1200x900",1000,2,600,400,"False",352,239,371,132,132,0
"C09JH",474,461,"1200x900",1000,0,600,400,"False",95,711,477,-234,234,1
"C09JH",475,117,"1200x900",600,1,600,400,"False",711,456,360,-96,96,0
"C09JH",476,543,"1200x900",1000,1,600,400,"False",88,202,486,284,284,0
"C09JH",477,308,"1200x900",800,1,600,400,"True",437,425,451,26,26,0
"C09JH",479,338,"1200x900",800,1,600,400,"False",813,253,498,245,245,1
"C09JH",480,159,"1200x900",600,2,600,400,"False",992,309,466,157,157,0
"C09JH",481,259,"1200x900",800,0,600,400,"False",156,180,279,99,99,1
"C09JH",482,475,"1200x900",1000,0,600,400,"False",101,715,436,-279,279,1
"C09JH",483,184,"1200x900",600,2,600,400,"True",1067,441,473,32,32,0
"C09JH",484,14,"1200x900",600,0,600,400,"False",399,224,365,141,141,1
"C09JH",485,588,"1200x900",1000,2,600,400,"True",585,350,432,82,82,0
"C09JH",486,97,"1200x900",600,1,600,400,"False",760,643,411,-232,232,1
"C09JH",487,72,"1200x900",600,0,600,400,"True",158,537,544,7,7,0
"C09JH",488,375,"1200x900",800,2,600,400,"True",716,384,454,70,70,0
"C09JH",489,292,"1200x900",800,1,600,400,"True",88,565,523,-42,42,0
"C09JH",490,314,"1200x900",800,1,600,400,"True",277,616,611,-5,5,1
"C09JH",491,105,"1200x900",600,1,600,400,"False",527,440,617,177,177,0
"C09JH",492,214,"1200x900",600,2,600,400,"False",1046,305,460,155,155,0
"C09JH",493,346,"1200x900",800,1,600,400,"True",269,635,688,53,53,0
"C09JH",494,300,"1200x900",800,1,600,400,"False",620,693,572,-121,121,0
"C09JH",495,17,"1200x900",600,0,600,400,"True",402,496,564,68,68,1
"C09JH",496,537,"1200x900",1000,1,600,400,"False",621,412,573,161,161,1
"C09JH",497,420,"1200x900",800,2,600,400,"False",519,223,468,245,245,0
"C09JH",498,498,"1200x900",1000,0,600,400,"False",100,260,338,78,78,1
"C09JH",499,336,"1200x900",800,1,600,400,"False",251,587,421,-166,166,0
"C09JH",500,492,"1200x900",1000,0,600,400,"False",76,692,587,-105,105,1
"C09JH",501,617,"1200x900",1000,2,600,400,"False",294,180,418,238,238,0
"C09JH",502,238,"1200x900",800,0,600,400,"True",162,283,320,37,37,1
"C09JH",503,60,"1200x900",600,0,600,400,"True",365,213,209,-4,4,1
"C09JH",504,469,"1200x900",1000,0,600,400,"True",73,227,247,20,20,1
"C09JH",505,440,"1200x900",1000,0,600,400,"True",71,237,241,4,4,1
"C09JH",506,149,"1200x900",600,2,600,400,"True",890,289,291,2,2,0
"C09JH",507,488,"1200x900",1000,0,600,400,"False",129,687,549,-138,138,1
"C09JH",508,428,"1200x900",800,2,600,400,"False",732,665,565,-100,100,0
"C09JH",509,373,"1200x900",800,2,600,400,"True",694,326,392,66,66,0
"C09JH",510,2,"1200x900",600,0,600,400,"True",159,323,332,9,9,0
"C09JH",512,318,"1200x900",800,1,600,400,"True",788,534,435,-99,99,0
"C09JH",513,349,"1200x900",800,1,600,400,"False",402,665,431,-234,234,0
"C09JH",514,499,"1200x900",1000,0,600,400,"False",93,271,435,164,164,1
"C09JH",515,431,"1200x900",800,2,600,400,"False",694,382,465,83,83,0
"C09JH",517,330,"1200x900",800,1,600,400,"False",759,301,433,132,132,1
"C09JH",518,445,"1200x900",1000,0,600,400,"False",78,302,388,86,86,1
"C09JH",519,554,"1200x900",1000,1,600,400,"True",79,309,366,57,57,1
"C09JH",520,560,"1200x900",1000,1,600,400,"False",516,693,520,-173,173,0
"C09JH",521,28,"1200x900",600,0,600,400,"True",336,410,435,25,25,1
"C09JH",522,367,"1200x900",800,2,600,400,"True",613,464,451,-13,13,0
"C09JH",523,65,"1200x900",600,0,600,400,"False",442,645,525,-120,120,1
"C09JH",524,514,"1200x900",1000,1,600,400,"False",539,690,594,-96,96,0
"C09JH",525,263,"1200x900",800,0,600,400,"False",82,396,517,121,121,1
"C09JH",526,221,"1200x900",800,0,600,400,"True",132,520,554,34,34,1
"C09JH",527,501,"1200x900",1000,0,600,400,"False",96,323,499,176,176,1
"C09JH",528,256,"1200x900",800,0,600,400,"False",192,656,516,-140,140,1
"C09JH",529,403,"1200x900",800,2,600,400,"False",625,704,536,-168,168,0
"C09JH",530,307,"1200x900",800,1,600,400,"False",716,247,432,185,185,0
"C09JH",531,79,"1200x900",600,1,600,400,"False",731,289,492,203,203,0
"C09JH",532,577,"1200x900",1000,2,600,400,"True",455,420,424,4,4,0
"C09JH",534,248,"1200x900",800,0,600,400,"True",94,240,221,-19,19,1
"C09JH",535,84,"1200x900",600,1,600,400,"False",144,184,291,107,107,0
"C09JH",536,170,"1200x900",600,2,600,400,"False",996,468,310,-158,158,0
"C09JH",538,627,"1200x900",1000,2,600,400,"False",760,510,340,-170,170,0
"C09JH",539,625,"1200x900",1000,2,600,400,"False",279,228,352,124,124,0
"C09JH",541,342,"1200x900",800,1,600,400,"False",677,204,417,213,213,0
"C09JH",542,4,"1200x900",600,0,600,400,"False",602,200,306,106,106,1
"C09JH",543,101,"1200x900",600,1,600,400,"False",541,656,394,-262,262,0
"C09JH",545,24,"1200x900",600,0,600,400,"False",430,538,447,-91,91,1
"C09JH",546,562,"1200x900",1000,1,600,400,"True",347,540,523,-17,17,0
"C09JH",547,50,"1200x900",600,0,600,400,"True",75,582,611,29,29,0
"C09JH",548,29,"1200x900",600,0,600,400,"True",385,533,592,59,59,1
"C09JH",549,524,"1200x900",1000,1,600,400,"True",534,470,504,34,34,0
"C09JH",550,212,"1200x900",600,2,600,400,"False",841,206,530,324,324,0
"C09JH",551,421,"1200x900",800,2,600,400,"True",898,394,464,70,70,0
"C09JH",552,264,"1200x900",800,0,600,400,"False",198,660,519,-141,141,1
"C09JH",553,161,"1200x900",600,2,600,400,"True",939,553,498,-55,55,0
"C09JH",554,171,"1200x900",600,2,600,400,"False",909,200,470,270,270,0
"C09JH",555,459,"1200x900",1000,0,600,400,"False",70,645,515,-130,130,1
"C09JH",556,135,"1200x900",600,1,600,400,"True",759,569,564,-5,5,0
"C09JH",557,94,"1200x900",600,1,600,400,"False",729,482,553,71,71,0
"C09JH",558,332,"1200x900",800,1,600,400,"False",260,699,524,-175,175,0
"C09JH",559,516,"1200x900",1000,1,600,400,"True",440,559,579,20,20,0
"C09JH",560,580,"1200x900",1000,2,600,400,"False",651,267,539,272,272,0
"C09JH",561,538,"1200x900",1000,1,600,400,"True",308,457,506,49,49,1
"C09JH",562,265,"1200x900",800,0,600,400,"False",229,353,464,111,111,1
"C09JH",563,33,"1200x900",600,0,600,400,"True",198,533,522,-11,11,1
"C09JH",564,213,"1200x900",600,2,600,400,"False",822,275,416,141,141,0
"C09JH",565,319,"1200x900",800,1,600,400,"False",494,587,412,-175,175,1
"C09JH",566,605,"1200x900",1000,2,600,400,"False",493,665,487,-178,178,0
"C09JH",567,88,"1200x900",600,1,600,400,"False",186,554,439,-115,115,0
"C09JH",568,109,"1200x900",600,1,600,400,"True",691,589,598,9,9,0
"C09JH",569,596,"1200x900",1000,2,600,400,"True",706,513,559,46,46,0
"C09JH",570,583,"1200x900",1000,2,600,400,"False",949,284,492,208,208,1
"C09JH",571,629,"1200x900",1000,2,600,400,"False",681,257,465,208,208,0
"C09JH",572,612,"1200x900",1000,2,600,400,"False",706,198,562,364,364,0
"C09JH",573,95,"1200x900",600,1,600,400,"False",749,425,587,162,162,1
"C09JH",574,470,"1200x900",1000,0,600,400,"False",91,666,529,-137,137,1
"C09JH",575,269,"1200x900",800,0,600,400,"False",160,295,379,84,84,1
"C09JH",576,439,"1200x900",1000,0,600,400,"False",110,229,301,72,72,1
"C09JH",577,239,"1200x900",800,0,600,400,"False",114,231,295,64,64,1
"C09JH",578,172,"1200x900",600,2,600,400,"True",912,444,414,-30,30,0
"C09JH",579,584,"1200x900",1000,2,600,400,"True",731,413,453,40,40,0
"C09JH",580,165,"1200x900",600,2,600,400,"True",912,554,494,-60,60,0
"C09JH",581,631,"1200x900",1000,2,600,400,"False",699,479,552,73,73,0
"C09JH",582,426,"1200x900",800,2,600,400,"False",830,263,516,253,253,0
"C09JH",583,173,"1200x900",600,2,600,400,"False",948,693,452,-241,241,0
"C09JH",584,124,"1200x900",600,1,600,400,"True",345,467,502,35,35,0
"C09JH",585,236,"1200x900",800,0,600,400,"True",162,350,324,-26,26,1
"C09JH",586,493,"1200x900",1000,0,600,400,"False",80,582,376,-206,206,1
"C09JH",587,366,"1200x900",800,2,600,400,"True",931,464,409,-55,55,0
"C09JH",588,432,"1200x900",800,2,600,400,"True",792,380,424,44,44,0
"C09JH",589,54,"1200x900",600,0,600,400,"False",474,564,470,-94,94,1
"C09JH",591,334,"1200x900",800,1,600,400,"False",481,665,591,-74,74,0
"C09JH",592,616,"1200x900",1000,2,600,400,"False",854,357,540,183,183,1
"C09JH",593,322,"1200x900",800,1,600,400,"False",703,206,575,369,369,1
"C09JH",594,9,"1200x900",600,0,600,400,"False",509,654,562,-92,92,1
"C09JH",595,550,"1200x900",1000,1,600,400,"True",301,459,496,37,37,0
"C09JH",596,464,"1200x900",1000,0,600,400,"False",82,222,396,174,174,1
"C09JH",598,480,"1200x900",1000,0,600,400,"False",100,231,312,81,81,1
"C09JH",599,557,"1200x900",1000,1,600,400,"True",677,505,539,34,34,1
"C09JH",600,44,"1200x900",600,0,600,400,"True",305,554,499,-55,55,1
"C09JH",601,418,"1200x900",800,2,600,400,"True",754,507,455,-52,52,0
"C09JH",602,582,"1200x900",1000,2,600,400,"False",554,347,499,152,152,0
"C09JH",603,331,"1200x900",800,1,600,400,"False",240,620,396,-224,224,0
"C09JH",604,18,"1200x900",600,0,600,400,"False",400,318,391,73,73,1
"C09JH",605,376,"1200x900",800,2,600,400,"False",788,275,452,177,177,0
"C09JH",606,521,"1200x900",1000,1,600,400,"True",111,303,331,28,28,1
"C09JH",607,630,"1200x900",1000,2,600,400,"False",754,559,472,-87,87,0
"C09JH",608,306,"1200x900",800,1,600,400,"True",164,524,507,-17,17,0
"C09JH",609,523,"1200x900",1000,1,600,400,"False",339,318,547,229,229,0
"C09JH",610,350,"1200x900",800,1,600,400,"False",182,566,423,-143,143,0
"C09JH",611,99,"1200x900",600,1,600,400,"True",811,407,366,-41,41,0
"C09JH",612,451,"1200x900",1000,0,600,400,"False",110,702,546,-156,156,1
"C09JH",613,12,"1200x900",600,0,600,400,"False",365,336,401,65,65,1
"C09JH",614,183,"1200x900",600,2,600,400,"False",927,289,466,177,177,0
"C09JH",615,262,"1200x900",800,0,600,400,"False",196,481,397,-84,84,1
"C09JH",616,116,"1200x900",600,1,600,400,"False",767,289,476,187,187,0
"C09JH",617,568,"1200x900",1000,1,600,400,"False",286,475,341,-134,134,1
"C09JH",618,467,"1200x900",1000,0,600,400,"False",74,712,573,-139,139,1
"C09JH",619,312,"1200x900",800,1,600,400,"True",238,683,618,-65,65,0
"C09JH",620,235,"1200x900",800,0,600,400,"True",146,646,670,24,24,1
"C09JH",621,271,"1200x900",800,0,600,400,"False",74,360,451,91,91,1
"C09JH",622,53,"1200x900",600,0,600,400,"True",177,189,161,-28,28,0
"C09JH",623,186,"1200x900",600,2,600,400,"False",997,197,446,249,249,0
"C09JH",624,372,"1200x900",800,2,600,400,"False",833,620,515,-105,105,0
"C09JH",625,380,"1200x900",800,2,600,400,"False",942,228,495,267,267,0
"C09JH",626,46,"1200x900",600,0,600,400,"True",193,355,391,36,36,1
"C09JH",627,106,"1200x900",600,1,600,400,"False",803,659,487,-172,172,1
"C09JH",628,36,"1200x900",600,0,600,400,"True",128,346,340,-6,6,1
"C09JH",629,485,"1200x900",1000,0,600,400,"False",121,694,467,-227,227,1
"C09JH",630,74,"1200x900",600,1,600,400,"False",115,358,522,164,164,0
"C09JH",631,51,"1200x900",600,0,600,400,"True",272,181,180,-1,1,1
"C09JH",632,76,"1200x900",600,1,600,400,"True",647,614,560,-54,54,0
"C09JH",633,527,"1200x900",1000,1,600,400,"False",565,601,736,135,135,0
"C09JH",634,40,"1200x900",600,0,600,400,"True",143,513,518,5,5,0
"C09JH",635,251,"1200x900",800,0,600,400,"True",88,352,406,54,54,1
"C09JH",636,207,"1200x900",600,2,600,400,"False",838,235,380,145,145,0
"C09JH",637,61,"1200x900",600,0,600,400,"False",272,670,572,-98,98,1
"C09JH",638,510,"1200x900",1000,1,600,400,"True",486,338,419,81,81,1
"C09JH",639,56,"1200x900",600,0,600,400,"False",148,491,387,-104,104,0
"C09JH",640,191,"1200x900",600,2,600,400,"True",962,396,437,41,41,0
"C09JH",641,39,"1200x900",600,0,600,400,"False",210,609,444,-165,165,0
"C09JH",642,187,"1200x900",600,2,600,400,"False",857,639,471,-168,168,0
"C09JH",643,215,"1200x900",600,2,600,400,"True",939,596,528,-68,68,0
"C09JH",644,326,"1200x900",800,1,600,400,"True",103,482,510,28,28,0
"C09JH",645,419,"1200x900",800,2,600,400,"False",769,351,529,178,178,0
"C09JH",646,503,"1200x900",1000,0,600,400,"False",86,279,397,118,118,1
"C09JH",647,253,"1200x900",800,0,600,400,"True",177,424,368,-56,56,1
"C09JH",648,460,"1200x900",1000,0,600,400,"False",155,189,401,212,212,1
"C10QT",1,495,"1200x900",1000,0,600,400,"False",93,692,434,-258,258,1
"C10QT",2,130,"1200x900",600,1,600,400,"True",741,428,459,31,31,0
"C10QT",3,40,"1200x900",600,0,600,400,"True",143,513,490,-23,23,0
"C10QT",4,134,"1200x900",600,1,600,400,"True",300,188,251,63,63,0
"C10QT",5,275,"1200x900",800,0,600,400,"False",120,594,524,-70,70,0
"C10QT",6,329,"1200x900",800,1,600,400,"False",517,239,320,81,81,0
"C10QT",7,630,"1200x900",1000,2,600,400,"True",754,559,601,42,42,0
"C10QT",8,408,"1200x900",800,2,600,400,"True",758,567,546,-21,21,0
"C10QT",9,575,"1200x900",1000,1,600,400,"True",272,693,680,-13,13,0
"C10QT",10,165,"1200x900",600,2,600,400,"False",912,554,745,191,191,0
"C10QT",11,628,"1200x900",1000,2,600,400,"False",768,410,492,82,82,0
"C10QT",12,273,"1200x900",800,0,600,400,"False",180,309,204,-105,105,1
"C10QT",13,377,"1200x900",800,2,600,400,"False",683,388,527,139,139,0
"C10QT",14,481,"1200x900",1000,0,600,400,"False",80,185,375,190,190,1
"C10QT",15,483,"1200x900",1000,0,600,400,"False",93,191,253,62,62,1
"C10QT",16,435,"1200x900",1000,0,600,400,"False",119,200,285,85,85,1
"C10QT",17,475,"1200x900",1000,0,600,400,"True",101,715,670,-45,45,1
"C10QT",18,333,"1200x900",800,1,600,400,"True",521,548,510,-38,38,0
"C10QT",19,349,"1200x900",800,1,600,400,"False",402,665,831,166,166,0
"C10QT",20,305,"1200x900",800,1,600,400,"True",471,716,765,49,49,0
"C10QT",21,219,"1200x900",800,0,600,400,"True",202,502,523,21,21,1
"C10QT",23,286,"1200x900",800,0,600,400,"True",105,378,337,-41,41,1
"C10QT",24,25,"1200x900",600,0,600,400,"True",263,403,399,-4,4,1
"C10QT",25,11,"1200x900",600,0,600,400,"True",372,670,632,-38,38,1
"C10QT",26,200,"1200x900",600,2,600,400,"False",897,302,50,-252,252,0
"C10QT",27,611,"1200x900",1000,2,600,400,"True",414,511,463,-48,48,0
"C10QT",28,518,"1200x900",1000,1,600,400,"True",583,717,755,38,38,0
"C10QT",29,215,"1200x900",600,2,600,400,"False",939,596,679,83,83,0
"C10QT",30,335,"1200x900",800,1,600,400,"False",124,360,442,82,82,0
"C10QT",31,247,"1200x900",800,0,600,400,"True",160,424,429,5,5,1
"C10QT",32,106,"1200x900",600,1,600,400,"True",803,659,659,0,0,1
"C10QT",33,457,"1200x900",1000,0,600,400,"False",97,630,534,-96,96,1
"C10QT",34,469,"1200x900",1000,0,600,400,"True",73,227,198,-29,29,1
"C10QT",35,192,"1200x900",600,2,600,400,"False",1064,320,850,530,530,0
"C10QT",36,302,"1200x900",800,1,600,400,"True",479,467,485,18,18,1
"C10QT",37,55,"1200x900",600,0,600,400,"True",211,305,241,-64,64,1
"C10QT",38,226,"1200x900",800,0,600,400,"True",187,229,273,44,44,1
"C10QT",39,129,"1200x900",600,1,600,400,"False",859,482,280,-202,202,1
"C10QT",40,389,"1200x900",800,2,600,400,"True",843,530,510,-20,20,0
"C10QT",41,58,"1200x900",600,0,600,400,"False",353,655,521,-134,134,1
"C10QT",42,532,"1200x900",1000,1,600,400,"False",215,207,291,84,84,0
"C10QT",43,86,"1200x900",600,1,600,400,"True",692,388,381,-7,7,1
"C10QT",44,561,"1200x900",1000,1,600,400,"False",231,406,646,240,240,0
"C10QT",45,24,"1200x900",600,0,600,400,"True",430,538,479,-59,59,1
"C10QT",46,221,"1200x900",800,0,600,400,"True",132,520,459,-61,61,1
"C10QT",47,569,"1200x900",1000,1,600,400,"False",494,720,336,-384,384,0
"C10QT",48,516,"1200x900",1000,1,600,400,"True",440,559,617,58,58,0
"C10QT",49,385,"1200x900",800,2,600,400,"True",740,456,514,58,58,0
"C10QT",50,10,"1200x900",600,0,600,400,"True",400,499,476,-23,23,1
"C10QT",51,568,"1200x900",1000,1,600,400,"False",286,475,683,208,208,1
"C10QT",52,443,"1200x900",1000,0,600,400,"True",99,651,701,50,50,1
"C10QT",53,339,"1200x900",800,1,600,400,"True",273,545,487,-58,58,1
"C10QT",55,125,"1200x900",600,1,600,400,"True",750,531,571,40,40,0
"C10QT",56,283,"1200x900",800,0,600,400,"True",90,264,234,-30,30,1
"C10QT",57,256,"1200x900",800,0,600,400,"True",192,656,626,-30,30,1
"C10QT",58,293,"1200x900",800,1,600,400,"True",561,396,432,36,36,0
"C10QT",59,547,"1200x900",1000,1,600,400,"False",369,384,279,-105,105,1
"C10QT",60,555,"1200x900",1000,1,600,400,"False",444,556,402,-154,154,0
"C10QT",61,364,"1200x900",800,2,600,400,"False",1018,204,404,200,200,0
"C10QT",62,51,"1200x900",600,0,600,400,"True",272,181,145,-36,36,1
"C10QT",63,269,"1200x900",800,0,600,400,"True",160,295,323,28,28,1
"C10QT",64,318,"1200x900",800,1,600,400,"True",788,534,591,57,57,0
"C10QT",65,644,"1200x900",1000,2,600,400,"True",495,486,436,-50,50,0
"C10QT",66,209,"1200x900",600,2,600,400,"False",937,637,465,-172,172,0
"C10QT",67,207,"1200x900",600,2,600,400,"False",838,235,426,191,191,0
"C10QT",68,311,"1200x900",800,1,600,400,"False",710,261,671,410,410,0
"C10QT",69,614,"1200x900",1000,2,600,400,"False",823,563,660,97,97,0
"C10QT",70,240,"1200x900",800,0,600,400,"False",330,656,563,-93,93,1
"C10QT",71,152,"1200x900",600,2,600,400,"False",971,399,470,71,71,0
"C10QT",72,392,"1200x900",800,2,600,400,"True",1031,618,517,-101,101,0
"C10QT",73,629,"1200x900",1000,2,600,400,"False",681,257,383,126,126,0
"C10QT",74,332,"1200x900",800,1,600,400,"True",260,699,670,-29,29,0
"C10QT",75,157,"1200x900",600,2,600,400,"True",1016,323,347,24,24,0
"C10QT",76,320,"1200x900",800,1,600,400,"True",644,376,406,30,30,0
"C10QT",77,404,"1200x900",800,2,600,400,"True",842,396,346,-50,50,0
"C10QT",78,480,"1200x900",1000,0,600,400,"True",100,231,292,61,61,1
"C10QT",79,114,"1200x900",600,1,600,400,"True",183,697,705,8,8,0
"C10QT",80,601,"1200x900",1000,2,600,400,"False",735,697,303,-394,394,0
"C10QT",81,458,"1200x900",1000,0,600,400,"False",78,624,560,-64,64,1
"C10QT",82,249,"1200x900",800,0,600,400,"True",126,306,306,0,0,1
"C10QT",83,217,"1200x900",800,0,600,400,"True",85,573,534,-39,39,1
"C10QT",84,167,"1200x900",600,2,600,400,"True",956,241,247,6,6,0
"C10QT",85,393,"1200x900",800,2,600,400,"False",657,620,400,-220,220,0
"C10QT",86,400,"1200x900",800,2,600,400,"False",733,297,229,-68,68,0
"C10QT",87,402,"1200x900",800,2,600,400,"True",878,234,242,8,8,0
"C10QT",88,84,"1200x900",600,1,600,400,"True",144,184,148,-36,36,0
"C10QT",89,110,"1200x900",600,1,600,400,"False",776,550,659,109,109,1
"C10QT",90,478,"1200x900",1000,0,600,400,"True",79,672,639,-33,33,1
"C10QT",91,284,"1200x900",800,0,600,400,"True",135,293,275,-18,18,1
"C10QT",92,583,"1200x900",1000,2,600,400,"True",949,284,238,-46,46,1
"C10QT",93,517,"1200x900",1000,1,600,400,"False",548,182,258,76,76,0
"C10QT",94,96,"1200x900",600,1,600,400,"False",433,458,518,60,60,0
"C10QT",95,122,"1200x900",600,1,600,400,"False",817,709,625,-84,84,0
"C10QT",96,91,"1200x900",600,1,600,400,"False",417,630,516,-114,114,1
"C10QT",97,38,"1200x900",600,0,600,400,"False",120,628,544,-84,84,1
"C10QT",98,264,"1200x900",800,0,600,400,"True",198,660,619,-41,41,1
"C10QT",99,465,"1200x900",1000,0,600,400,"True",85,203,230,27,27,1
"C10QT",100,279,"1200x900",800,0,600,400,"False",252,202,273,71,71,1
"C10QT",101,453,"1200x900",1000,0,600,400,"False",71,393,269,-124,124,1
"C10QT",102,218,"1200x900",800,0,600,400,"False",106,397,322,-75,75,1
"C10QT",103,160,"1200x900",600,2,600,400,"False",863,606,699,93,93,0
"C10QT",104,28,"1200x900",600,0,600,400,"True",336,410,456,46,46,1
"C10QT",105,30,"1200x900",600,0,600,400,"True",107,353,397,44,44,0
"C10QT",106,451,"1200x900",1000,0,600,400,"False",110,702,625,-77,77,1
"C10QT",107,374,"1200x900",800,2,600,400,"False",755,450,618,168,168,0
"C10QT",108,397,"1200x900",800,2,600,400,"True",817,692,681,-11,11,0
"C10QT",109,276,"1200x900",800,0,600,400,"False",281,217,330,113,113,1
"C10QT",110,594,"1200x900",1000,2,600,400,"True",537,637,598,-39,39,0
"C10QT",111,646,"1200x900",1000,2,600,400,"False",829,227,379,152,152,1
"C10QT",112,595,"1200x900",1000,2,600,400,"False",687,640,288,-352,352,0
"C10QT",113,56,"1200x900",600,0,600,400,"True",148,491,442,-49,49,0
"C10QT",114,422,"1200x900",800,2,600,400,"False",712,558,409,-149,149,0
"C10QT",115,41,"1200x900",600,0,600,400,"True",370,452,434,-18,18,1
"C10QT",116,272,"1200x900",800,0,600,400,"False",200,181,247,66,66,1
"C10QT",117,232,"1200x900",800,0,600,400,"True",84,511,463,-48,48,1
"C10QT",119,261,"1200x900",800,0,600,400,"False",86,713,623,-90,90,1
"C10QT",120,416,"1200x900",800,2,600,400,"False",748,617,190,-427,427,0
"C10QT",121,80,"1200x900",600,1,600,400,"False",616,423,666,243,243,1
"C10QT",122,438,"1200x900",1000,0,600,400,"True",77,713,687,-26,26,1
"C10QT",123,222,"1200x900",800,0,600,400,"True",152,206,169,-37,37,1
"C10QT",125,135,"1200x900",600,1,600,400,"False",759,569,395,-174,174,0
"C10QT",126,616,"1200x900",1000,2,600,400,"False",854,357,257,-100,100,1
"C10QT",128,538,"1200x900",1000,1,600,400,"True",308,457,386,-71,71,1
"C10QT",129,307,"1200x900",800,1,600,400,"False",716,247,324,77,77,0
"C10QT",130,489,"1200x900",1000,0,600,400,"True",88,604,664,60,60,1
"C10QT",131,220,"1200x900",800,0,600,400,"True",108,699,678,-21,21,1
"C10QT",132,47,"1200x900",600,0,600,400,"True",303,499,476,-23,23,1
"C10QT",133,203,"1200x900",600,2,600,400,"False",938,603,678,75,75,0
"C10QT",134,473,"1200x900",1000,0,600,400,"False",75,323,227,-96,96,1
"C10QT",135,419,"1200x900",800,2,600,400,"False",769,351,277,-74,74,0
"C10QT",136,141,"1200x900",600,1,600,400,"False",671,582,677,95,95,0
"C10QT",137,161,"1200x900",600,2,600,400,"True",939,553,523,-30,30,0
"C10QT",138,78,"1200x900",600,1,600,400,"False",885,684,757,73,73,0
"C10QT",139,183,"1200x900",600,2,600,400,"True",927,289,258,-31,31,0
"C10QT",140,534,"1200x900",1000,1,600,400,"True",328,504,480,-24,24,1
"C10QT",141,522,"1200x900",1000,1,600,400,"False",223,379,535,156,156,0
"C10QT",142,520,"1200x900",1000,1,600,400,"True",564,260,257,-3,3,0
"C10QT",143,363,"1200x900",800,2,600,400,"False",800,218,394,176,176,0
"C10QT",144,497,"1200x900",1000,0,600,400,"False",106,696,619,-77,77,1
"C10QT",145,57,"1200x900",600,0,600,400,"True",354,508,476,-32,32,1
"C10QT",146,236,"1200x900",800,0,600,400,"True",162,350,307,-43,43,1
"C10QT",147,294,"1200x900",800,1,600,400,"False",262,287,612,325,325,0
"C10QT",148,126,"1200x900",600,1,600,400,"True",849,354,400,46,46,0
"C10QT",149,597,"1200x900",1000,2,600,400,"False",352,239,146,-93,93,0
"C10QT",150,250,"1200x900",800,0,600,400,"True",290,248,201,-47,47,1
"C10QT",151,43,"1200x900",600,0,600,400,"True",277,446,481,35,35,1
"C10QT",152,545,"1200x900",1000,1,600,400,"False",358,562,460,-102,102,0
"C10QT",153,45,"1200x900",600,0,600,400,"True",487,678,631,-47,47,1
"C10QT",154,172,"1200x900",600,2,600,400,"True",912,444,525,81,81,0
"C10QT",155,413,"1200x900",800,2,600,400,"True",849,506,557,51,51,0
"C10QT",156,239,"1200x900",800,0,600,400,"True",114,231,253,22,22,1
"C10QT",157,596,"1200x900",1000,2,600,400,"False",706,513,355,-158,158,0
"C10QT",158,557,"1200x900",1000,1,600,400,"False",677,505,636,131,131,1
"C10QT",159,194,"1200x900",600,2,600,400,"False",896,236,321,85,85,0
"C10QT",160,128,"1200x900",600,1,600,400,"True",661,258,320,62,62,1
"C10QT",161,296,"1200x900",800,1,600,400,"True",89,279,282,3,3,0
"C10QT",162,633,"1200x900",1000,2,600,400,"False",564,253,408,155,155,0
"C10QT",163,22,"1200x900",600,0,600,400,"True",398,591,559,-32,32,1
"C10QT",165,281,"1200x900",800,0,600,400,"True",112,611,562,-49,49,1
"C10QT",166,151,"1200x900",600,2,600,400,"True",828,680,663,-17,17,0
"C10QT",167,399,"1200x900",800,2,600,400,"False",603,602,405,-197,197,0
"C10QT",168,466,"1200x900",1000,0,600,400,"False",82,205,291,86,86,1
"C10QT",169,331,"1200x900",800,1,600,400,"False",240,620,763,143,143,0
"C10QT",170,562,"1200x900",1000,1,600,400,"True",347,540,471,-69,69,0
"C10QT",171,317,"1200x900",800,1,600,400,"False",185,564,637,73,73,0
"C10QT",172,498,"1200x900",1000,0,600,400,"True",100,260,230,-30,30,1
"C10QT",173,113,"1200x900",600,1,600,400,"False",897,657,525,-132,132,0
"C10QT",174,62,"1200x900",600,0,600,400,"True",345,346,356,10,10,1
"C10QT",176,463,"1200x900",1000,0,600,400,"True",115,693,642,-51,51,1
"C10QT",177,100,"1200x900",600,1,600,400,"False",453,511,322,-189,189,0
"C10QT",178,316,"1200x900",800,1,600,400,"False",362,319,464,145,145,0
"C10QT",179,602,"1200x900",1000,2,600,400,"True",865,452,474,22,22,0
"C10QT",180,566,"1200x900",1000,1,600,400,"False",378,472,298,-174,174,1
"C10QT",181,586,"1200x900",1000,2,600,400,"False",802,262,406,144,144,0
"C10QT",182,81,"1200x900",600,1,600,400,"False",696,225,297,72,72,0
"C10QT",183,567,"1200x900",1000,1,600,400,"True",655,297,293,-4,4,1
"C10QT",185,511,"1200x900",1000,1,600,400,"False",408,390,504,114,114,1
"C10QT",186,617,"1200x900",1000,2,600,400,"False",294,180,468,288,288,0
"C10QT",187,376,"1200x900",800,2,600,400,"False",788,275,450,175,175,0
"C10QT",188,328,"1200x900",800,1,600,400,"False",104,649,529,-120,120,0
"C10QT",189,450,"1200x900",1000,0,600,400,"True",130,204,236,32,32,1
"C10QT",190,340,"1200x900",800,1,600,400,"False",226,240,404,164,164,0
"C10QT",191,118,"1200x900",600,1,600,400,"False",190,588,505,-83,83,0
"C10QT",192,556,"1200x900",1000,1,600,400,"True",415,420,461,41,41,0
"C10QT",193,309,"1200x900",800,1,600,400,"False",186,225,530,305,305,0
"C10QT",194,540,"1200x900",1000,1,600,400,"False",389,568,492,-76,76,1
"C10QT",195,541,"1200x900",1000,1,600,400,"True",339,478,509,31,31,0
"C10QT",196,398,"1200x900",800,2,600,400,"False",944,698,599,-99,99,0
"C10QT",197,18,"1200x900",600,0,600,400,"True",400,318,350,32,32,1
"C10QT",198,421,"1200x900",800,2,600,400,"False",898,394,228,-166,166,0
"C10QT",199,214,"1200x900",600,2,600,400,"True",1046,305,340,35,35,0
"C10QT",200,436,"1200x900",1000,0,600,400,"True",82,617,639,22,22,1
"C10QT",201,570,"1200x900",1000,1,600,400,"True",315,352,399,47,47,0
"C10QT",202,418,"1200x900",800,2,600,400,"False",754,507,376,-131,131,0
"C10QT",203,257,"1200x900",800,0,600,400,"True",97,219,262,43,43,1
"C10QT",204,367,"1200x900",800,2,600,400,"False",613,464,334,-130,130,0
"C10QT",205,227,"1200x900",800,0,600,400,"False",196,551,468,-83,83,1
"C10QT",206,8,"1200x900",600,0,600,400,"True",156,679,668,-11,11,0
"C10QT",207,598,"1200x900",1000,2,600,400,"True",706,559,512,-47,47,0
"C10QT",209,406,"1200x900",800,2,600,400,"False",971,233,537,304,304,0
"C10QT",210,558,"1200x900",1000,1,600,400,"True",72,464,531,67,67,1
"C10QT",211,323,"1200x900",800,1,600,400,"False",388,348,543,195,195,0
"C10QT",212,360,"1200x900",800,1,600,400,"False",203,608,677,69,69,0
"C10QT",213,17,"1200x900",600,0,600,400,"False",402,496,573,77,77,1
"C10QT",214,44,"1200x900",600,0,600,400,"True",305,554,539,-15,15,1
"C10QT",215,42,"1200x900",600,0,600,400,"True",233,479,500,21,21,0
"C10QT",216,101,"1200x900",600,1,600,400,"True",541,656,587,-69,69,0
"C10QT",217,308,"1200x900",800,1,600,400,"False",437,425,500,75,75,0
"C10QT",218,245,"1200x900",800,0,600,400,"True",296,235,293,58,58,1
"C10QT",219,554,"1200x900",1000,1,600,400,"False",79,309,201,-108,108,1
"C10QT",220,623,"1200x900",1000,2,600,400,"True",636,527,472,-55,55,0
"C10QT",221,514,"1200x900",1000,1,600,400,"True",539,690,644,-46,46,0
"C10QT",222,189,"1200x900",600,2,600,400,"False",881,397,323,-74,74,0
"C10QT",223,563,"1200x900",1000,1,600,400,"False",201,696,611,-85,85,0
"C10QT",224,171,"1200x900",600,2,600,400,"False",909,200,387,187,187,0
"C10QT",225,359,"1200x900",800,1,600,400,"False",653,241,412,171,171,0
"C10QT",226,433,"1200x900",1000,0,600,400,"True",76,222,201,-21,21,1
"C10QT",227,430,"1200x900",800,2,600,400,"True",922,254,203,-51,51,0
"C10QT",228,287,"1200x900",800,0,600,400,"False",120,567,421,-146,146,1
"C10QT",229,111,"1200x900",600,1,600,400,"False",922,552,475,-77,77,1
"C10QT",230,344,"1200x900",800,1,600,400,"True",589,408,437,29,29,0
"C10QT",231,234,"1200x900",800,0,600,400,"True",72,344,332,-12,12,1
"C10QT",232,584,"1200x900",1000,2,600,400,"True",731,413,424,11,11,0
"C10QT",233,395,"1200x900",800,2,600,400,"True",743,334,342,8,8,0
"C10QT",234,243,"1200x900",800,0,600,400,"True",114,332,367,35,35,1
"C10QT",235,180,"1200x900",600,2,600,400,"True",929,270,309,39,39,0
"C10QT",236,502,"1200x900",1000,0,600,400,"False",111,639,525,-114,114,1
"C10QT",237,233,"1200x900",800,0,600,400,"True",164,700,700,0,0,1
"C10QT",238,182,"1200x900",600,2,600,400,"False",933,389,497,108,108,0
"C10QT",239,254,"1200x900",800,0,600,400,"True",136,583,585,2,2,1
"C10QT",240,1,"1200x900",600,0,600,400,"True",136,502,506,4,4,0
"C10QT",241,48,"1200x900",600,0,600,400,"True",323,645,663,18,18,1
"C10QT",242,115,"1200x900",600,1,600,400,"True",545,307,299,-8,8,0
"C10QT",243,290,"1200x900",800,1,600,400,"True",789,603,543,-60,60,0
"C10QT",244,195,"1200x900",600,2,600,400,"True",942,249,300,51,51,0
"C10QT",245,414,"1200x900",800,2,600,400,"True",831,592,579,-13,13,0
"C10QT",246,337,"1200x900",800,1,600,400,"False",299,622,450,-172,172,0
"C10QT",247,208,"1200x900",600,2,600,400,"False",946,399,526,127,127,0
"C10QT",248,535,"1200x900",1000,1,600,400,"False",372,410,318,-92,92,0
"C10QT",249,178,"1200x900",600,2,600,400,"False",1041,510,678,168,168,0
"C10QT",250,76,"1200x900",600,1,600,400,"True",647,614,633,19,19,0
"C10QT",251,169,"1200x900",600,2,600,400,"True",924,290,376,86,86,0
"C10QT",252,9,"1200x900",600,0,600,400,"True",509,654,707,53,53,1
"C10QT",253,3,"1200x900",600,0,600,400,"False",298,443,558,115,115,1
"C10QT",254,347,"1200x900",800,1,600,400,"False",757,295,629,334,334,1
"C10QT",255,27,"1200x900",600,0,600,400,"True",373,309,304,-5,5,1
"C10QT",256,246,"1200x900",800,0,600,400,"True",196,418,414,-4,4,1
"C10QT",257,321,"1200x900",800,1,600,400,"False",601,190,307,117,117,0
"C10QT",258,289,"1200x900",800,1,600,400,"True",421,703,662,-41,41,1
"C10QT",259,198,"1200x900",600,2,600,400,"True",976,500,584,84,84,0
"C10QT",260,631,"1200x900",1000,2,600,400,"True",699,479,399,-80,80,0
"C10QT",261,292,"1200x900",800,1,600,400,"True",88,565,576,11,11,0
"C10QT",262,577,"1200x900",1000,2,600,400,"False",455,420,345,-75,75,0
"C10QT",263,571,"1200x900",1000,1,600,400,"False",239,522,393,-129,129,1
"C10QT",264,324,"1200x900",800,1,600,400,"False",719,712,319,-393,393,1
"C10QT",265,297,"1200x900",800,1,600,400,"False",625,244,318,74,74,0
"C10QT",266,295,"1200x900",800,1,600,400,"False",471,334,252,-82,82,0
"C10QT",267,590,"1200x900",1000,2,600,400,"False",636,278,479,201,201,0
"C10QT",268,441,"1200x900",1000,0,600,400,"False",85,684,580,-104,104,1
"C10QT",269,588,"1200x900",1000,2,600,400,"False",585,350,242,-108,108,0
"C10QT",270,315,"1200x900",800,1,600,400,"True",105,211,226,15,15,0
"C10QT",271,235,"1200x900",800,0,600,400,"False",146,646,546,-100,100,1
"C10QT",272,102,"1200x900",600,1,600,400,"True",861,603,552,-51,51,0
"C10QT",273,641,"1200x900",1000,2,600,400,"False",897,272,478,206,206,0
"C10QT",274,163,"1200x900",600,2,600,400,"True",1046,665,600,-65,65,0
"C10QT",275,634,"1200x900",1000,2,600,400,"True",735,313,315,2,2,0
"C10QT",276,12,"1200x900",600,0,600,400,"True",365,336,350,14,14,1
"C10QT",277,139,"1200x900",600,1,600,400,"False",192,695,485,-210,210,0
"C10QT",278,265,"1200x900",800,0,600,400,"False",229,353,427,74,74,1
"C10QT",279,446,"1200x900",1000,0,600,400,"True",72,298,304,6,6,1
"C10QT",280,267,"1200x900",800,0,600,400,"True",145,665,685,20,20,1
"C10QT",281,95,"1200x900",600,1,600,400,"False",749,425,341,-84,84,1
"C10QT",282,197,"1200x900",600,2,600,400,"False",903,212,387,175,175,0
"C10QT",283,120,"1200x900",600,1,600,400,"True",690,655,644,-11,11,0
"C10QT",284,88,"1200x900",600,1,600,400,"False",186,554,626,72,72,0
"C10QT",285,16,"1200x900",600,0,600,400,"True",297,514,461,-53,53,1
"C10QT",286,632,"1200x900",1000,2,600,400,"False",984,227,632,405,405,0
"C10QT",287,138,"1200x900",600,1,600,400,"True",844,580,621,41,41,1
"C10QT",288,384,"1200x900",800,2,600,400,"True",821,707,675,-32,32,0
"C10QT",289,493,"1200x900",1000,0,600,400,"True",80,582,523,-59,59,1
"C10QT",290,403,"1200x900",800,2,600,400,"False",625,704,518,-186,186,0
"C10QT",291,543,"1200x900",1000,1,600,400,"False",88,202,626,424,424,0
"C10QT",292,353,"1200x900",800,1,600,400,"True",90,476,517,41,41,0
"C10QT",293,560,"1200x900",1000,1,600,400,"True",516,693,742,49,49,0
"C10QT",294,439,"1200x900",1000,0,600,400,"False",110,229,379,150,150,1
"C10QT",295,509,"1200x900",1000,1,600,400,"False",509,434,336,-98,98,0
"C10QT",296,73,"1200x900",600,1,600,400,"True",94,665,655,-10,10,0
"C10QT",297,282,"1200x900",800,0,600,400,"True",109,246,283,37,37,1
"C10QT",299,589,"1200x900",1000,2,600,400,"False",856,418,500,82,82,0
"C10QT",300,212,"1200x900",600,2,600,400,"False",841,206,421,215,215,0
"C10QT",301,505,"1200x900",1000,1,600,400,"True",191,484,426,-58,58,1
"C10QT",302,5,"1200x900",600,0,600,400,"False",228,587,511,-76,76,0
"C10QT",303,358,"1200x900",800,1,600,400,"False",263,635,336,-299,299,0
"C10QT",304,550,"1200x900",1000,1,600,400,"False",301,459,568,109,109,0
"C10QT",305,301,"1200x900",800,1,600,400,"True",162,574,501,-73,73,0
"C10QT",306,131,"1200x900",600,1,600,400,"False",531,367,585,218,218,0
"C10QT",307,501,"1200x900",1000,0,600,400,"True",96,323,314,-9,9,1
"C10QT",308,98,"1200x900",600,1,600,400,"True",625,530,515,-15,15,0
"C10QT",309,578,"1200x900",1000,2,600,400,"False",966,276,450,174,174,0
"C10QT",310,327,"1200x900",800,1,600,400,"True",152,339,335,-4,4,0
"C10QT",311,54,"1200x900",600,0,600,400,"True",474,564,570,6,6,1
"C10QT",312,369,"1200x900",800,2,600,400,"True",903,594,581,-13,13,0
"C10QT",313,119,"1200x900",600,1,600,400,"False",168,563,629,66,66,0
"C10QT",314,350,"1200x900",800,1,600,400,"False",182,566,402,-164,164,0
"C10QT",315,14,"1200x900",600,0,600,400,"False",399,224,287,63,63,1
"C10QT",316,409,"1200x900",800,2,600,400,"False",501,659,548,-111,111,0
"C10QT",317,401,"1200x900",800,2,600,400,"False",821,260,204,-56,56,0
"C10QT",318,445,"1200x900",1000,0,600,400,"True",78,302,255,-47,47,1
"C10QT",319,231,"1200x900",800,0,600,400,"True",251,718,763,45,45,1
"C10QT",320,542,"1200x900",1000,1,600,400,"False",304,401,286,-115,115,0
"C10QT",321,313,"1200x900",800,1,600,400,"True",588,421,387,-34,34,0
"C10QT",322,625,"1200x900",1000,2,600,400,"True",279,228,263,35,35,0
"C10QT",323,170,"1200x900",600,2,600,400,"False",996,468,389,-79,79,0
"C10QT",324,456,"1200x900",1000,0,600,400,"True",91,257,310,53,53,1
"C10QT",325,537,"1200x900",1000,1,600,400,"False",621,412,603,191,191,1
"C10QT",326,185,"1200x900",600,2,600,400,"False",907,212,312,100,100,0
"C10QT",327,176,"1200x900",600,2,600,400,"True",1033,281,305,24,24,0
"C10QT",328,253,"1200x900",800,0,600,400,"True",177,424,408,-16,16,1
"C10QT",329,242,"1200x900",800,0,600,400,"True",117,448,415,-33,33,1
"C10QT",330,109,"1200x900",600,1,600,400,"False",691,589,443,-146,146,0
"C10QT",331,474,"1200x900",1000,0,600,400,"False",85,339,414,75,75,1
"C10QT",332,83,"1200x900",600,1,600,400,"True",763,568,591,23,23,1
"C10QT",333,123,"1200x900",600,1,600,400,"False",761,365,308,-57,57,1
"C10QT",334,412,"1200x900",800,2,600,400,"True",842,280,285,5,5,0
"C10QT",335,319,"1200x900",800,1,600,400,"True",494,587,626,39,39,1
"C10QT",336,643,"1200x900",1000,2,600,400,"True",740,325,405,80,80,0
"C10QT",337,4,"1200x900",600,0,600,400,"True",602,200,136,-64,64,1
"C10QT",338,485,"1200x900",1000,0,600,400,"True",121,694,693,-1,1,1
"C10QT",339,64,"1200x900",600,0,600,400,"True",102,339,340,1,1,0
"C10QT",341,626,"1200x900",1000,2,600,400,"False",329,449,604,155,155,0
"C10QT",342,112,"1200x900",600,1,600,400,"False",681,490,388,-102,102,0
"C10QT",343,87,"1200x900",600,1,600,400,"True",231,604,647,43,43,0
"C10QT",344,117,"1200x900",600,1,600,400,"False",711,456,298,-158,158,0
"C10QT",345,187,"1200x900",600,2,600,400,"False",857,639,543,-96,96,0
"C10QT",346,61,"1200x900",600,0,600,400,"True",272,670,616,-54,54,1
"C10QT",347,237,"1200x900",800,0,600,400,"True",204,481,542,61,61,1
"C10QT",348,303,"1200x900",800,1,600,400,"True",241,431,406,-25,25,0
"C10QT",349,271,"1200x900",800,0,600,400,"True",74,360,385,25,25,1
"C10QT",350,370,"1200x900",800,2,600,400,"False",874,336,202,-134,134,0
"C10QT",351,468,"1200x900",1000,0,600,400,"True",121,219,263,44,44,1
"C10QT",352,380,"1200x900",800,2,600,400,"True",942,228,195,-33,33,0
"C10QT",353,147,"1200x900",600,2,600,400,"False",942,418,344,-74,74,0
"C10QT",355,622,"1200x900",1000,2,600,400,"False",307,683,323,-360,360,0
"C10QT",356,527,"1200x900",1000,1,600,400,"False",565,601,487,-114,114,0
"C10QT",357,190,"1200x900",600,2,600,400,"False",977,238,370,132,132,0
"C10QT",358,467,"1200x900",1000,0,600,400,"True",74,712,670,-42,42,1
"C10QT",359,494,"1200x900",1000,0,600,400,"True",127,692,650,-42,42,1
"C10QT",360,154,"1200x900",600,2,600,400,"False",941,454,326,-128,128,0
"C10QT",361,346,"1200x900",800,1,600,400,"True",269,635,553,-82,82,0
"C10QT",362,59,"1200x900",600,0,600,400,"True",391,692,719,27,27,1
"C10QT",363,387,"1200x900",800,2,600,400,"False",990,444,289,-155,155,0
"C10QT",364,539,"1200x900",1000,1,600,400,"False",510,383,468,85,85,0
"C10QT",365,36,"1200x900",600,0,600,400,"True",128,346,399,53,53,1
"C10QT",366,599,"1200x900",1000,2,600,400,"False",316,570,255,-315,315,0
"C10QT",367,241,"1200x900",800,0,600,400,"True",129,227,253,26,26,1
"C10QT",369,394,"1200x900",800,2,600,400,"True",847,292,318,26,26,0
"C10QT",370,255,"1200x900",800,0,600,400,"False",93,709,578,-131,131,1
"C10QT",371,490,"1200x900",1000,0,600,400,"True",114,183,216,33,33,1
"C10QT",372,66,"1200x900",600,0,600,400,"True",155,673,692,19,19,0
"C10QT",373,477,"1200x900",1000,0,600,400,"True",88,640,659,19,19,1
"C10QT",374,624,"1200x900",1000,2,600,400,"False",693,501,419,-82,82,0
"C10QT",375,368,"1200x900",800,2,600,400,"True",778,515,496,-19,19,0
"C10QT",376,510,"1200x900",1000,1,600,400,"False",486,338,272,-66,66,1
"C10QT",377,396,"1200x900",800,2,600,400,"True",678,663,618,-45,45,0
"C10QT",378,454,"1200x900",1000,0,600,400,"True",78,687,648,-39,39,1
"C10QT",380,613,"1200x900",1000,2,600,400,"False",690,374,459,85,85,0
"C10QT",381,464,"1200x900",1000,0,600,400,"True",82,222,278,56,56,1
"C10QT",382,354,"1200x900",800,1,600,400,"False",118,236,328,92,92,0
"C10QT",383,444,"1200x900",1000,0,600,400,"True",101,714,681,-33,33,1
"C10QT",384,410,"1200x900",800,2,600,400,"False",916,477,221,-256,256,0
"C10QT",385,627,"1200x900",1000,2,600,400,"False",760,510,655,145,145,0
"C10QT",386,7,"1200x900",600,0,600,400,"True",431,654,644,-10,10,1
"C10QT",387,159,"1200x900",600,2,600,400,"False",992,309,472,163,163,0
"C10QT",388,425,"1200x900",800,2,600,400,"True",621,438,470,32,32,0
"C10QT",389,373,"1200x900",800,2,600,400,"False",694,326,185,-141,141,0
"C10QT",390,486,"1200x900",1000,0,600,400,"True",102,676,646,-30,30,1
"C10QT",392,173,"1200x900",600,2,600,400,"False",948,693,446,-247,247,0
"C10QT",393,471,"1200x900",1000,0,600,400,"False",122,200,314,114,114,1
"C10QT",394,528,"1200x900",1000,1,600,400,"False",839,227,500,273,273,1
"C10QT",395,85,"1200x900",600,1,600,400,"False",434,347,454,107,107,0
"C10QT",396,326,"1200x900",800,1,600,400,"False",103,482,300,-182,182,0
"C10QT",397,487,"1200x900",1000,0,600,400,"True",78,670,676,6,6,1
"C10QT",398,648,"1200x900",1000,2,600,400,"True",557,394,417,23,23,0
"C10QT",400,553,"1200x900",1000,1,600,400,"False",116,712,248,-464,464,0
"C10QT",401,216,"1200x900",600,2,600,400,"True",1029,286,311,25,25,0
"C10QT",402,388,"1200x900",800,2,600,400,"False",930,320,514,194,194,0
"C10QT",403,378,"1200x900",800,2,600,400,"False",1018,708,310,-398,398,0
"C10QT",404,552,"1200x900",1000,1,600,400,"False",255,412,491,79,79,0
"C10QT",405,262,"1200x900",800,0,600,400,"True",196,481,435,-46,46,1
"C10QT",406,491,"1200x900",1000,0,600,400,"False",108,198,267,69,69,1
"C10QT",407,411,"1200x900",800,2,600,400,"True",805,361,405,44,44,0
"C10QT",408,92,"1200x900",600,1,600,400,"True",624,605,617,12,12,0
"C10QT",409,428,"1200x900",800,2,600,400,"True",732,665,591,-74,74,0
"C10QT",410,334,"1200x900",800,1,600,400,"True",481,665,645,-20,20,0
"C10QT",411,615,"1200x900",1000,2,600,400,"True",736,634,648,14,14,0
"C10QT",412,523,"1200x900",1000,1,600,400,"False",339,318,449,131,131,0
"C10QT",413,434,"1200x900",1000,0,600,400,"True",89,657,682,25,25,1
"C10QT",414,639,"1200x900",1000,2,600,400,"False",504,456,369,-87,87,0
"C10QT",415,343,"1200x900",800,1,600,400,"True",407,557,505,-52,52,0
"C10QT",416,390,"1200x900",800,2,600,400,"False",982,674,553,-121,121,1
"C10QT",417,460,"1200x900",1000,0,600,400,"True",155,189,205,16,16,1
"C10QT",418,158,"1200x900",600,2,600,400,"True",939,300,381,81,81,0
"C10QT",419,482,"1200x900",1000,0,600,400,"False",79,686,528,-158,158,1
"C10QT",420,63,"1200x900",600,0,600,400,"True",311,188,193,5,5,1
"C10QT",421,168,"1200x900",600,2,600,400,"True",1001,439,447,8,8,0
"C10QT",422,67,"1200x900",600,0,600,400,"True",289,308,316,8,8,1
"C10QT",423,145,"1200x900",600,2,600,400,"False",1004,630,371,-259,259,0
"C10QT",424,348,"1200x900",800,1,600,400,"False",764,294,366,72,72,0
"C10QT",426,260,"1200x900",800,0,600,400,"True",103,525,526,1,1,1
"C10QT",427,600,"1200x900",1000,2,600,400,"False",765,207,501,294,294,0
"C10QT",428,89,"1200x900",600,1,600,400,"True",917,366,406,40,40,1
"C10QT",429,423,"1200x900",800,2,600,400,"True",1051,710,689,-21,21,1
"C10QT",430,381,"1200x900",800,2,600,400,"False",705,408,554,146,146,0
"C10QT",431,426,"1200x900",800,2,600,400,"True",830,263,267,4,4,0
"C10QT",432,526,"1200x900",1000,1,600,400,"False",497,710,594,-116,116,0
"C10QT",433,405,"1200x900",800,2,600,400,"False",790,307,433,126,126,0
"C10QT",434,642,"1200x900",1000,2,600,400,"False",776,316,642,326,326,0
"C10QT",435,365,"1200x900",800,2,600,400,"False",1055,305,674,369,369,0
"C10QT",436,500,"1200x900",1000,0,600,400,"False",105,700,462,-238,238,1
"C10QT",437,513,"1200x900",1000,1,600,400,"False",235,602,265,-337,337,0
"C10QT",438,93,"1200x900",600,1,600,400,"False",139,540,417,-123,123,0
"C10QT",439,638,"1200x900",1000,2,600,400,"False",385,198,288,90,90,0
"C10QT",440,268,"1200x900",800,0,600,400,"True",148,400,432,32,32,1
"C10QT",441,437,"1200x900",1000,0,600,400,"False",74,667,557,-110,110,1
"C10QT",442,99,"1200x900",600,1,600,400,"False",811,407,493,86,86,0
"C10QT",443,525,"1200x900",1000,1,600,400,"False",123,690,561,-129,129,0
"C10QT",444,127,"1200x900",600,1,600,400,"False",309,691,572,-119,119,0
"C10QT",445,512,"1200x900",1000,1,600,400,"True",139,261,279,18,18,0
"C10QT",446,479,"1200x900",1000,0,600,400,"True",74,705,694,-11,11,1
"C10QT",447,53,"1200x900",600,0,600,400,"True",177,189,219,30,30,0
"C10QT",448,529,"1200x900",1000,1,600,400,"False",267,412,691,279,279,1
"C10QT",449,640,"1200x900",1000,2,600,400,"True",361,334,384,50,50,0
"C10QT",450,551,"1200x900",1000,1,600,400,"True",146,445,457,12,12,1
"C10QT",451,306,"1200x900",800,1,600,400,"False",164,524,656,132,132,0
"C10QT",452,503,"1200x900",1000,0,600,400,"False",86,279,353,74,74,1
"C10QT",454,507,"1200x900",1000,1,600,400,"True",608,583,532,-51,51,1
"C10QT",455,442,"1200x900",1000,0,600,400,"False",87,183,270,87,87,1
"C10QT",456,391,"1200x900",800,2,600,400,"True",895,521,472,-49,49,0
"C10QT",457,174,"1200x900",600,2,600,400,"False",998,457,369,-88,88,0
"C10QT",458,440,"1200x900",1000,0,600,400,"True",71,237,254,17,17,1
"C10QT",459,193,"1200x900",600,2,600,400,"False",874,588,464,-124,124,0
"C10QT",460,591,"1200x900",1000,2,600,400,"True",698,336,411,75,75,0
"C10QT",461,484,"1200x900",1000,0,600,400,"True",100,223,189,-34,34,1
"C10QT",462,39,"1200x900",600,0,600,400,"True",210,609,585,-24,24,0
"C10QT",463,228,"1200x900",800,0,600,400,"True",174,687,635,-52,52,1
"C10QT",464,142,"1200x900",600,1,600,400,"False",286,474,561,87,87,0
"C10QT",465,565,"1200x900",1000,1,600,400,"True",451,562,567,5,5,0
"C10QT",466,259,"1200x900",800,0,600,400,"True",156,180,237,57,57,1
"C10QT",467,530,"1200x900",1000,1,600,400,"False",584,405,261,-144,144,1
"C10QT",468,519,"1200x900",1000,1,600,400,"True",319,565,602,37,37,1
"C10QT",469,417,"1200x900",800,2,600,400,"False",750,280,520,240,240,0
"C10QT",470,424,"1200x900",800,2,600,400,"False",903,545,344,-201,201,0
"C10QT",471,592,"1200x900",1000,2,600,400,"True",492,392,388,-4,4,0
"C10QT",472,375,"1200x900",800,2,600,400,"True",716,384,385,1,1,0
"C10QT",473,635,"1200x900",1000,2,600,400,"False",833,402,310,-92,92,0
"C10QT",474,70,"1200x900",600,0,600,400,"True",309,703,682,-21,21,1
"C10QT",475,225,"1200x900",800,0,600,400,"True",178,423,438,15,15,1
"C10QT",476,619,"1200x900",1000,2,600,400,"False",803,247,495,248,248,0
"C10QT",477,336,"1200x900",800,1,600,400,"True",251,587,585,-2,2,0
"C10QT",478,531,"1200x900",1000,1,600,400,"False",233,362,457,95,95,0
"C10QT",479,544,"1200x900",1000,1,600,400,"True",602,620,688,68,68,0
"C10QT",480,291,"1200x900",800,1,600,400,"False",522,694,565,-129,129,0
"C10QT",481,280,"1200x900",800,0,600,400,"True",104,302,312,10,10,1
"C10QT",482,603,"1200x900",1000,2,600,400,"True",693,280,342,62,62,0
"C10QT",483,132,"1200x900",600,1,600,400,"True",333,185,296,111,111,0
"C10QT",484,230,"1200x900",800,0,600,400,"True",99,678,727,49,49,1
"C10QT",485,504,"1200x900",1000,0,600,400,"True",107,699,680,-19,19,1
"C10QT",486,90,"1200x900",600,1,600,400,"False",560,474,399,-75,75,0
"C10QT",487,277,"1200x900",800,0,600,400,"True",140,310,261,-49,49,1
"C10QT",488,606,"1200x900",1000,2,600,400,"False",653,627,505,-122,122,0
"C10QT",489,476,"1200x900",1000,0,600,400,"False",76,359,284,-75,75,1
"C10QT",490,415,"1200x900",800,2,600,400,"False",823,684,576,-108,108,0
"C10QT",491,205,"1200x900",600,2,600,400,"True",1021,504,546,42,42,0
"C10QT",492,266,"1200x900",800,0,600,400,"False",126,303,396,93,93,1
"C10QT",493,420,"1200x900",800,2,600,400,"False",519,223,597,374,374,0
"C10QT",494,587,"1200x900",1000,2,600,400,"False",741,686,236,-450,450,0
"C10QT",495,533,"1200x900",1000,1,600,400,"False",355,483,555,72,72,0
"C10QT",496,65,"1200x900",600,0,600,400,"False",442,645,573,-72,72,1
"C10QT",497,355,"1200x900",800,1,600,400,"True",77,386,437,51,51,0
"C10QT",498,612,"1200x900",1000,2,600,400,"False",706,198,444,246,246,0
"C10QT",499,69,"1200x900",600,0,600,400,"True",322,268,261,-7,7,0
"C10QT",500,429,"1200x900",800,2,600,400,"True",682,692,684,-8,8,0
"C10QT",501,521,"1200x900",1000,1,600,400,"False",111,303,427,124,124,1
"C10QT",502,148,"1200x900",600,2,600,400,"True",907,330,277,-53,53,0
"C10QT",503,299,"1200x900",800,1,600,400,"False",779,274,562,288,288,0
"C10QT",504,52,"1200x900",600,0,600,400,"True",171,188,213,25,25,0
"C10QT",505,75,"1200x900",600,1,600,400,"True",635,558,525,-33,33,0
"C10QT",506,499,"1200x900",1000,0,600,400,"True",93,271,303,32,32,1
"C10QT",507,618,"1200x900",1000,2,600,400,"False",276,671,517,-154,154,0
"C10QT",508,637,"1200x900",1000,2,600,400,"False",750,460,527,67,67,0
"C10QT",509,107,"1200x900",600,1,600,400,"False",878,678,561,-117,117,0
"C10QT",510,341,"1200x900",800,1,600,400,"False",735,632,442,-190,190,1
"C10QT",511,608,"1200x900",1000,2,600,400,"False",742,250,559,309,309,0
"C10QT",512,186,"1200x900",600,2,600,400,"True",997,197,295,98,98,0
"C10QT",513,352,"1200x900",800,1,600,400,"False",235,717,583,-134,134,0
"C10QT",514,607,"1200x900",1000,2,600,400,"False",900,573,371,-202,202,1
"C10QT",515,506,"1200x900",1000,1,600,400,"False",559,567,360,-207,207,1
"C10QT",516,37,"1200x900",600,0,600,400,"True",258,403,439,36,36,1
"C10QT",517,201,"1200x900",600,2,600,400,"False",1005,462,268,-194,194,0
"C10QT",518,431,"1200x900",800,2,600,400,"False",694,382,559,177,177,0
"C10QT",519,191,"1200x900",600,2,600,400,"True",962,396,468,72,72,0
"C10QT",520,636,"1200x900",1000,2,600,400,"False",575,583,296,-287,287,0
"C10QT",521,585,"1200x900",1000,2,600,400,"True",698,688,604,-84,84,1
"C10QT",522,300,"1200x900",800,1,600,400,"True",620,693,671,-22,22,0
"C10QT",523,133,"1200x900",600,1,600,400,"True",345,551,540,-11,11,0
"C10QT",524,330,"1200x900",800,1,600,400,"True",759,301,309,8,8,1
"C10QT",525,579,"1200x900",1000,2,600,400,"False",803,394,570,176,176,0
"C10QT",526,124,"1200x900",600,1,600,400,"False",345,467,375,-92,92,0
"C10QT",527,462,"1200x900",1000,0,600,400,"False",102,672,591,-81,81,1
"C10QT",528,549,"1200x900",1000,1,600,400,"True",657,366,381,15,15,0
"C10QT",529,548,"1200x900",1000,1,600,400,"False",103,278,463,185,185,0
"C10QT",530,576,"1200x900",1000,1,600,400,"False",376,713,560,-153,153,0
"C10QT",531,244,"1200x900",800,0,600,400,"True",194,203,180,-23,23,1
"C10QT",532,150,"1200x900",600,2,600,400,"True",897,345,316,-29,29,0
"C10QT",533,188,"1200x900",600,2,600,400,"True",900,195,151,-44,44,0
"C10QT",534,536,"1200x900",1000,1,600,400,"True",580,213,155,-58,58,0
"C10QT",535,345,"1200x900",800,1,600,400,"False",841,566,693,127,127,1
"C10QT",536,156,"1200x900",600,2,600,400,"False",913,197,311,114,114,0
"C10QT",537,432,"1200x900",800,2,600,400,"False",792,380,249,-131,131,0
"C10QT",538,620,"1200x900",1000,2,600,400,"False",832,649,180,-469,469,0
"C10QT",539,379,"1200x900",800,2,600,400,"False",994,325,721,396,396,0
"C10QT",540,524,"1200x900",1000,1,600,400,"False",534,470,613,143,143,0
"C10QT",541,164,"1200x900",600,2,600,400,"False",1051,268,441,173,173,0
"C10QT",542,372,"1200x900",800,2,600,400,"False",833,620,521,-99,99,0
"C10QT",543,248,"1200x900",800,0,600,400,"False",94,240,389,149,149,1
"C10QT",544,621,"1200x900",1000,2,600,400,"False",540,478,575,97,97,0
"C10QT",545,13,"1200x900",600,0,600,400,"False",296,211,346,135,135,1
"C10QT",546,270,"1200x900",800,0,600,400,"True",192,418,438,20,20,1
"C10QT",547,580,"1200x900",1000,2,600,400,"True",651,267,281,14,14,0
"C10QT",548,79,"1200x900",600,1,600,400,"False",731,289,494,205,205,0
"C10QT",549,356,"1200x900",800,1,600,400,"True",123,484,537,53,53,0
"C10QT",550,210,"1200x900",600,2,600,400,"False",835,506,587,81,81,0
"C10QT",551,144,"1200x900",600,1,600,400,"False",718,371,465,94,94,0
"C10QT",552,582,"1200x900",1000,2,600,400,"True",554,347,353,6,6,0
"C10QT",553,610,"1200x900",1000,2,600,400,"True",702,293,242,-51,51,0
"C10QT",554,202,"1200x900",600,2,600,400,"False",966,460,343,-117,117,0
"C10QT",555,449,"1200x900",1000,0,600,400,"False",105,683,581,-102,102,1
"C10QT",556,593,"1200x900",1000,2,600,400,"True",246,719,692,-27,27,0
"C10QT",557,322,"1200x900",800,1,600,400,"False",703,206,318,112,112,1
"C10QT",558,573,"1200x900",1000,1,600,400,"False",486,615,696,81,81,0
"C10QT",559,314,"1200x900",800,1,600,400,"True",277,616,588,-28,28,1
"C10QT",560,278,"1200x900",800,0,600,400,"True",251,711,650,-61,61,1
"C10QT",561,184,"1200x900",600,2,600,400,"False",1067,441,696,255,255,0
"C10QT",562,34,"1200x900",600,0,600,400,"True",361,242,292,50,50,1
"C10QT",563,488,"1200x900",1000,0,600,400,"False",129,687,467,-220,220,1
"C10QT",564,459,"1200x900",1000,0,600,400,"True",70,645,599,-46,46,1
"C10QT",565,515,"1200x900",1000,1,600,400,"False",307,217,342,125,125,0
"C10QT",566,15,"1200x900",600,0,600,400,"True",473,352,361,9,9,1
"C10QT",567,104,"1200x900",600,1,600,400,"True",448,584,542,-42,42,0
"C10QT",568,177,"1200x900",600,2,600,400,"True",912,236,244,8,8,0
"C10QT",569,136,"1200x900",600,1,600,400,"True",264,205,245,40,40,0
"C10QT",570,46,"1200x900",600,0,600,400,"True",193,355,327,-28,28,1
"C10QT",571,238,"1200x900",800,0,600,400,"True",162,283,316,33,33,1
"C10QT",572,181,"1200x900",600,2,600,400,"True",1018,223,282,59,59,0
"C10QT",573,33,"1200x900",600,0,600,400,"True",198,533,539,6,6,1
"C10QT",574,143,"1200x900",600,1,600,400,"False",479,284,383,99,99,1
"C10QT",575,609,"1200x900",1000,2,600,400,"False",697,627,414,-213,213,0
"C10QT",576,448,"1200x900",1000,0,600,400,"True",107,641,630,-11,11,1
"C10QT",577,77,"1200x900",600,1,600,400,"False",780,525,427,-98,98,0
"C10QT",578,383,"1200x900",800,2,600,400,"True",855,407,447,40,40,0
"C10QT",579,19,"1200x900",600,0,600,400,"True",286,686,656,-30,30,0
"C10QT",580,298,"1200x900",800,1,600,400,"True",311,457,447,-10,10,0
"C10QT",581,213,"1200x900",600,2,600,400,"True",822,275,339,64,64,0
"C10QT",582,23,"1200x900",600,0,600,400,"True",308,463,399,-64,64,1
"C10QT",583,496,"1200x900",1000,0,600,400,"True",70,639,643,4,4,1
"C10QT",584,546,"1200x900",1000,1,600,400,"True",305,374,422,48,48,0
"C10QT",585,20,"1200x900",600,0,600,400,"True",204,545,505,-40,40,1
"C10QT",586,204,"1200x900",600,2,600,400,"True",1053,432,504,72,72,0
"C10QT",587,26,"1200x900",600,0,600,400,"True",70,712,660,-52,52,0
"C10QT",588,2,"1200x900",600,0,600,400,"True",159,323,375,52,52,0
"C10QT",589,574,"1200x900",1000,1,600,400,"False",614,194,294,100,100,0
"C10QT",590,304,"1200x900",800,1,600,400,"False",667,605,284,-321,321,0
"C10QT",591,386,"1200x900",800,2,600,400,"True",774,301,262,-39,39,0
"C10QT",592,258,"1200x900",800,0,600,400,"True",126,664,699,35,35,1
"C10QT",593,447,"1200x900",1000,0,600,400,"False",71,339,232,-107,107,1
"C10QT",594,312,"1200x900",800,1,600,400,"False",238,683,571,-112,112,0
"C10QT",595,288,"1200x900",800,0,600,400,"True",180,547,539,-8,8,1
"C10QT",596,605,"1200x900",1000,2,600,400,"True",493,665,607,-58,58,0
"C10QT",597,29,"1200x900",600,0,600,400,"True",385,533,550,17,17,1
"C10QT",598,455,"1200x900",1000,0,600,400,"True",107,718,726,8,8,1
"C10QT",599,351,"1200x900",800,1,600,400,"True",122,581,618,37,37,0
"C10QT",600,508,"1200x900",1000,1,600,400,"False",596,485,582,97,97,0
"C10QT",601,94,"1200x900",600,1,600,400,"False",729,482,551,69,69,0
"C10QT",602,251,"1200x900",800,0,600,400,"False",88,352,444,92,92,1
"C10QT",603,121,"1200x900",600,1,600,400,"False",884,364,528,164,164,0
"C10QT",604,223,"1200x900",800,0,600,400,"True",179,191,136,-55,55,1
"C10QT",605,581,"1200x900",1000,2,600,400,"False",310,357,270,-87,87,0
"C10QT",606,72,"1200x900",600,0,600,400,"True",158,537,490,-47,47,0
"C10QT",607,263,"1200x900",800,0,600,400,"True",82,396,390,-6,6,1
"C10QT",608,564,"1200x900",1000,1,600,400,"True",215,264,331,67,67,0
"C10QT",609,71,"1200x900",600,0,600,400,"False",219,248,308,60,60,0
"C10QT",610,452,"1200x900",1000,0,600,400,"True",97,273,329,56,56,1
"C10QT",611,252,"1200x900",800,0,600,400,"True",224,673,651,-22,22,1
"C10QT",612,357,"1200x900",800,1,600,400,"True",109,594,572,-22,22,0
"C10QT",613,470,"1200x900",1000,0,600,400,"True",91,666,692,26,26,1
"C10QT",614,166,"1200x900",600,2,600,400,"True",896,274,294,20,20,0
"C10QT",615,604,"1200x900",1000,2,600,400,"False",459,593,490,-103,103,0
"C10QT",616,325,"1200x900",800,1,600,400,"False",105,394,310,-84,84,0
"C10QT",617,382,"1200x900",800,2,600,400,"False",870,523,281,-242,242,0
"C10QT",618,50,"1200x900",600,0,600,400,"False",75,582,513,-69,69,0
"C10QT",619,105,"1200x900",600,1,600,400,"False",527,440,602,162,162,0
"C10QT",620,371,"1200x900",800,2,600,400,"True",730,560,600,40,40,0
"C10QT",621,137,"1200x900",600,1,600,400,"True",789,577,574,-3,3,0
"C10QT",622,116,"1200x900",600,1,600,400,"True",767,289,292,3,3,0
"C10QT",623,153,"1200x900",600,2,600,400,"False",1037,601,714,113,113,0
"C10QT",624,155,"1200x900",600,2,600,400,"True",940,269,325,56,56,0
"C10QT",625,206,"1200x900",600,2,600,400,"True",975,223,274,51,51,0
"C10QT",626,82,"1200x900",600,1,600,400,"True",108,213,255,42,42,0
"C10QT",627,427,"1200x900",800,2,600,400,"True",812,380,381,1,1,0
"C10QT",628,366,"1200x900",800,2,600,400,"False",931,464,236,-228,228,0
"C10QT",629,285,"1200x900",800,0,600,400,"True",237,396,329,-67,67,1
"C10QT",630,74,"1200x900",600,1,600,400,"False",115,358,243,-115,115,0
"C10QT",631,31,"1200x900",600,0,600,400,"True",365,338,338,0,0,1
"C10QT",632,338,"1200x900",800,1,600,400,"True",813,253,278,25,25,1
"C10QT",633,196,"1200x900",600,2,600,400,"False",1030,397,266,-131,131,0
"C10QT",634,229,"1200x900",800,0,600,400,"True",117,697,694,-3,3,1
"C10QT",635,572,"1200x900",1000,1,600,400,"False",302,260,367,107,107,0
"C10QT",636,472,"1200x900",1000,0,600,400,"False",77,685,569,-116,116,1
"C10QT",637,645,"1200x900",1000,2,600,400,"False",619,396,280,-116,116,0
"C10QT",638,68,"1200x900",600,0,600,400,"True",165,367,349,-18,18,0
"C10QT",639,162,"1200x900",600,2,600,400,"True",849,279,319,40,40,0
"C10QT",640,310,"1200x900",800,1,600,400,"False",559,592,522,-70,70,0
"C10QT",641,224,"1200x900",800,0,600,400,"True",161,474,528,54,54,1
"C10QT",642,492,"1200x900",1000,0,600,400,"False",76,692,581,-111,111,1
"C10QT",643,6,"1200x900",600,0,600,400,"False",217,689,567,-122,122,1
"C10QT",644,97,"1200x900",600,1,600,400,"True",760,643,629,-14,14,1
"C10QT",645,274,"1200x900",800,0,600,400,"True",146,497,495,-2,2,1
"C10QT",646,21,"1200x900",600,0,600,400,"True",314,383,427,44,44,1
"C10QT",647,361,"1200x900",800,2,600,400,"True",931,328,282,-46,46,0
"C10QT",648,342,"1200x900",800,1,600,400,"False",677,204,349,145,145,0
"C11VS",1,536,"1200x900",1000,1,600,400,"False",580,213,331,118,118,0
"C11VS",2,437,"1200x900",1000,0,600,400,"True",74,667,631,-36,36,1
"C11VS",3,123,"1200x900",600,1,600,400,"False",761,365,157,-208,208,1
"C11VS",4,277,"1200x900",800,0,600,400,"False",140,310,399,89,89,1
"C11VS",5,539,"1200x900",1000,1,600,400,"True",510,383,377,-6,6,0
"C11VS",6,487,"1200x900",1000,0,600,400,"False",78,670,445,-225,225,1
"C11VS",7,86,"1200x900",600,1,600,400,"True",692,388,443,55,55,1
"C11VS",8,231,"1200x900",800,0,600,400,"False",251,718,394,-324,324,1
"C11VS",9,410,"1200x900",800,2,600,400,"False",916,477,248,-229,229,0
"C11VS",10,375,"1200x900",800,2,600,400,"False",716,384,499,115,115,0
"C11VS",11,87,"1200x900",600,1,600,400,"True",231,604,529,-75,75,0
"C11VS",12,333,"1200x900",800,1,600,400,"True",521,548,540,-8,8,0
"C11VS",13,18,"1200x900",600,0,600,400,"True",400,318,341,23,23,1
"C11VS",14,313,"1200x900",800,1,600,400,"True",588,421,458,37,37,0
"C11VS",15,138,"1200x900",600,1,600,400,"False",844,580,777,197,197,1
"C11VS",16,608,"1200x900",1000,2,600,400,"False",742,250,427,177,177,0
"C11VS",17,432,"1200x900",800,2,600,400,"False",792,380,249,-131,131,0
"C11VS",18,171,"1200x900",600,2,600,400,"False",909,200,387,187,187,0
"C11VS",19,498,"1200x900",1000,0,600,400,"False",100,260,366,106,106,1
"C11VS",20,259,"1200x900",800,0,600,400,"False",156,180,262,82,82,1
"C11VS",21,288,"1200x900",800,0,600,400,"False",180,547,368,-179,179,1
"C11VS",22,545,"1200x900",1000,1,600,400,"False",358,562,433,-129,129,0
"C11VS",23,481,"1200x900",1000,0,600,400,"False",80,185,318,133,133,1
"C11VS",24,646,"1200x900",1000,2,600,400,"True",829,227,257,30,30,1
"C11VS",25,551,"1200x900",1000,1,600,400,"True",146,445,513,68,68,1
"C11VS",26,339,"1200x900",800,1,600,400,"True",273,545,511,-34,34,1
"C11VS",27,503,"1200x900",1000,0,600,400,"False",86,279,496,217,217,1
"C11VS",28,571,"1200x900",1000,1,600,400,"True",239,522,574,52,52,1
"C11VS",29,598,"1200x900",1000,2,600,400,"False",706,559,719,160,160,0
"C11VS",30,119,"1200x900",600,1,600,400,"True",168,563,612,49,49,0
"C11VS",31,328,"1200x900",800,1,600,400,"True",104,649,587,-62,62,0
"C11VS",32,417,"1200x900",800,2,600,400,"False",750,280,425,145,145,0
"C11VS",33,527,"1200x900",1000,1,600,400,"False",565,601,522,-79,79,0
"C11VS",34,404,"1200x900",800,2,600,400,"False",842,396,331,-65,65,0
"C11VS",35,584,"1200x900",1000,2,600,400,"False",731,413,281,-132,132,0
"C11VS",36,626,"1200x900",1000,2,600,400,"False",329,449,306,-143,143,0
"C11VS",37,483,"1200x900",1000,0,600,400,"False",93,191,415,224,224,1
"C11VS",38,424,"1200x900",800,2,600,400,"False",903,545,271,-274,274,0
"C11VS",39,379,"1200x900",800,2,600,400,"False",994,325,679,354,354,0
"C11VS",40,20,"1200x900",600,0,600,400,"False",204,545,396,-149,149,1
"C11VS",41,205,"1200x900",600,2,600,400,"False",1021,504,614,110,110,0
"C11VS",42,152,"1200x900",600,2,600,400,"False",971,399,132,-267,267,0
"C11VS",43,486,"1200x900",1000,0,600,400,"False",102,676,460,-216,216,1
"C11VS",44,391,"1200x900",800,2,600,400,"False",895,521,455,-66,66,0
"C11VS",45,243,"1200x900",800,0,600,400,"True",114,332,375,43,43,1
"C11VS",46,79,"1200x900",600,1,600,400,"False",731,289,457,168,168,0
"C11VS",47,289,"1200x900",800,1,600,400,"True",421,703,706,3,3,1
"C11VS",48,294,"1200x900",800,1,600,400,"False",262,287,629,342,342,0
"C11VS",49,627,"1200x900",1000,2,600,400,"False",760,510,604,94,94,0
"C11VS",50,100,"1200x900",600,1,600,400,"False",453,511,323,-188,188,0
"C11VS",51,141,"1200x900",600,1,600,400,"False",671,582,488,-94,94,0
"C11VS",52,281,"1200x900",800,0,600,400,"True",112,611,553,-58,58,1
"C11VS",53,330,"1200x900",800,1,600,400,"True",759,301,297,-4,4,1
"C11VS",54,263,"1200x900",800,0,600,400,"True",82,396,350,-46,46,1
"C11VS",55,61,"1200x900",600,0,600,400,"False",272,670,477,-193,193,1
"C11VS",56,327,"1200x900",800,1,600,400,"False",152,339,254,-85,85,0
"C11VS",57,531,"1200x900",1000,1,600,400,"True",233,362,431,69,69,0
"C11VS",58,303,"1200x900",800,1,600,400,"False",241,431,337,-94,94,0
"C11VS",59,460,"1200x900",1000,0,600,400,"False",155,189,347,158,158,1
"C11VS",60,22,"1200x900",600,0,600,400,"False",398,591,494,-97,97,1
"C11VS",61,415,"1200x900",800,2,600,400,"True",823,684,615,-69,69,0
"C11VS",62,538,"1200x900",1000,1,600,400,"True",308,457,469,12,12,1
"C11VS",63,309,"1200x900",800,1,600,400,"False",186,225,545,320,320,0
"C11VS",64,184,"1200x900",600,2,600,400,"False",1067,441,696,255,255,0
"C11VS",65,189,"1200x900",600,2,600,400,"True",881,397,372,-25,25,0
"C11VS",66,290,"1200x900",800,1,600,400,"False",789,603,450,-153,153,0
"C11VS",67,25,"1200x900",600,0,600,400,"True",263,403,418,15,15,1
"C11VS",68,238,"1200x900",800,0,600,400,"False",162,283,380,97,97,1
"C11VS",70,240,"1200x900",800,0,600,400,"False",330,656,424,-232,232,1
"C11VS",71,403,"1200x900",800,2,600,400,"False",625,704,573,-131,131,0
"C11VS",72,233,"1200x900",800,0,600,400,"True",164,700,705,5,5,1
"C11VS",73,37,"1200x900",600,0,600,400,"True",258,403,378,-25,25,1
"C11VS",74,159,"1200x900",600,2,600,400,"False",992,309,160,-149,149,0
"C11VS",75,130,"1200x900",600,1,600,400,"True",741,428,420,-8,8,0
"C11VS",76,315,"1200x900",800,1,600,400,"True",105,211,287,76,76,0
"C11VS",77,234,"1200x900",800,0,600,400,"True",72,344,367,23,23,1
"C11VS",78,3,"1200x900",600,0,600,400,"True",298,443,413,-30,30,1
"C11VS",79,164,"1200x900",600,2,600,400,"False",1051,268,133,-135,135,0
"C11VS",80,266,"1200x900",800,0,600,400,"False",126,303,377,74,74,1
"C11VS",81,199,"1200x900",600,2,600,400,"False",992,467,159,-308,308,0
"C11VS",82,291,"1200x900",800,1,600,400,"False",522,694,560,-134,134,0
"C11VS",83,162,"1200x900",600,2,600,400,"True",849,279,286,7,7,0
"C11VS",84,564,"1200x900",1000,1,600,400,"False",215,264,344,80,80,0
"C11VS",85,319,"1200x900",800,1,600,400,"False",494,587,766,179,179,1
"C11VS",86,580,"1200x900",1000,2,600,400,"True",651,267,220,-47,47,0
"C11VS",87,578,"1200x900",1000,2,600,400,"False",966,276,545,269,269,0
"C11VS",88,369,"1200x900",800,2,600,400,"False",903,594,731,137,137,0
"C11VS",89,63,"1200x900",600,0,600,400,"True",311,188,206,18,18,1
"C11VS",90,462,"1200x900",1000,0,600,400,"False",102,672,395,-277,277,1
"C11VS",91,69,"1200x900",600,0,600,400,"False",322,268,390,122,122,0
"C11VS",92,350,"1200x900",800,1,600,400,"False",182,566,412,-154,154,0
"C11VS",93,111,"1200x900",600,1,600,400,"True",922,552,508,-44,44,1
"C11VS",94,440,"1200x900",1000,0,600,400,"False",71,237,429,192,192,1
"C11VS",95,91,"1200x900",600,1,600,400,"True",417,630,631,1,1,1
"C11VS",96,329,"1200x900",800,1,600,400,"False",517,239,375,136,136,0
"C11VS",97,196,"1200x900",600,2,600,400,"False",1030,397,226,-171,171,0
"C11VS",98,176,"1200x900",600,2,600,400,"False",1033,281,187,-94,94,0
"C11VS",99,322,"1200x900",800,1,600,400,"False",703,206,281,75,75,1
"C11VS",100,153,"1200x900",600,2,600,400,"False",1037,601,737,136,136,0
"C11VS",101,576,"1200x900",1000,1,600,400,"True",376,713,654,-59,59,0
"C11VS",102,84,"1200x900",600,1,600,400,"False",144,184,110,-74,74,0
"C11VS",103,285,"1200x900",800,0,600,400,"False",237,396,505,109,109,1
"C11VS",104,217,"1200x900",800,0,600,400,"False",85,573,463,-110,110,1
"C11VS",105,505,"1200x900",1000,1,600,400,"False",191,484,371,-113,113,1
"C11VS",106,249,"1200x900",800,0,600,400,"True",126,306,324,18,18,1
"C11VS",107,251,"1200x900",800,0,600,400,"True",88,352,316,-36,36,1
"C11VS",108,638,"1200x900",1000,2,600,400,"True",385,198,247,49,49,0
"C11VS",109,553,"1200x900",1000,1,600,400,"False",116,712,250,-462,462,0
"C11VS",110,247,"1200x900",800,0,600,400,"True",160,424,471,47,47,1
"C11VS",111,204,"1200x900",600,2,600,400,"False",1053,432,192,-240,240,0
"C11VS",112,362,"1200x900",800,2,600,400,"False",819,338,488,150,150,0
"C11VS",113,170,"1200x900",600,2,600,400,"False",996,468,217,-251,251,0
"C11VS",114,606,"1200x900",1000,2,600,400,"False",653,627,722,95,95,0
"C11VS",115,590,"1200x900",1000,2,600,400,"False",636,278,145,-133,133,0
"C11VS",116,225,"1200x900",800,0,600,400,"False",178,423,300,-123,123,1
"C11VS",117,127,"1200x900",600,1,600,400,"True",309,691,718,27,27,0
"C11VS",118,353,"1200x900",800,1,600,400,"False",90,476,676,200,200,0
"C11VS",119,104,"1200x900",600,1,600,400,"False",448,584,745,161,161,0
"C11VS",120,401,"1200x900",800,2,600,400,"False",821,260,183,-77,77,0
"C11VS",121,45,"1200x900",600,0,600,400,"False",487,678,456,-222,222,1
"C11VS",122,276,"1200x900",800,0,600,400,"False",281,217,314,97,97,1
"C11VS",123,260,"1200x900",800,0,600,400,"True",103,525,585,60,60,1
"C11VS",124,420,"1200x900",800,2,600,400,"True",519,223,276,53,53,0
"C11VS",125,117,"1200x900",600,1,600,400,"False",711,456,249,-207,207,0
"C11VS",126,245,"1200x900",800,0,600,400,"False",296,235,351,116,116,1
"C11VS",127,496,"1200x900",1000,0,600,400,"False",70,639,504,-135,135,1
"C11VS",128,452,"1200x900",1000,0,600,400,"False",97,273,423,150,150,1
"C11VS",129,226,"1200x900",800,0,600,400,"True",187,229,187,-42,42,1
"C11VS",130,561,"1200x900",1000,1,600,400,"False",231,406,700,294,294,0
"C11VS",131,188,"1200x900",600,2,600,400,"True",900,195,145,-50,50,0
"C11VS",132,244,"1200x900",800,0,600,400,"True",194,203,186,-17,17,1
"C11VS",133,212,"1200x900",600,2,600,400,"True",841,206,197,-9,9,0
"C11VS",134,367,"1200x900",800,2,600,400,"False",613,464,339,-125,125,0
"C11VS",135,430,"1200x900",800,2,600,400,"False",922,254,164,-90,90,0
"C11VS",136,139,"1200x900",600,1,600,400,"False",192,695,496,-199,199,0
"C11VS",137,635,"1200x900",1000,2,600,400,"False",833,402,281,-121,121,0
"C11VS",138,143,"1200x900",600,1,600,400,"True",479,284,358,74,74,1
"C11VS",139,464,"1200x900",1000,0,600,400,"False",82,222,348,126,126,1
"C11VS",140,421,"1200x900",800,2,600,400,"False",898,394,243,-151,151,0
"C11VS",141,422,"1200x900",800,2,600,400,"False",712,558,323,-235,235,0
"C11VS",142,97,"1200x900",600,1,600,400,"False",760,643,712,69,69,1
"C11VS",143,642,"1200x900",1000,2,600,400,"False",776,316,549,233,233,0
"C11VS",144,318,"1200x900",800,1,600,400,"False",788,534,758,224,224,0
"C11VS",145,270,"1200x900",800,0,600,400,"False",192,418,500,82,82,1
"C11VS",146,416,"1200x900",800,2,600,400,"False",748,617,350,-267,267,0
"C11VS",147,206,"1200x900",600,2,600,400,"True",975,223,221,-2,2,0
"C11VS",148,549,"1200x900",1000,1,600,400,"True",657,366,416,50,50,0
"C11VS",149,591,"1200x900",1000,2,600,400,"True",698,336,308,-28,28,0
"C11VS",150,513,"1200x900",1000,1,600,400,"False",235,602,245,-357,357,0
"C11VS",151,387,"1200x900",800,2,600,400,"False",990,444,159,-285,285,0
"C11VS",152,209,"1200x900",600,2,600,400,"True",937,637,670,33,33,0
"C11VS",153,488,"1200x900",1000,0,600,400,"True",129,687,647,-40,40,1
"C11VS",154,560,"1200x900",1000,1,600,400,"True",516,693,702,9,9,0
"C11VS",155,92,"1200x900",600,1,600,400,"False",624,605,719,114,114,0
"C11VS",156,180,"1200x900",600,2,600,400,"True",929,270,308,38,38,0
"C11VS",157,131,"1200x900",600,1,600,400,"False",531,367,606,239,239,0
"C11VS",158,624,"1200x900",1000,2,600,400,"True",693,501,537,36,36,0
"C11VS",159,94,"1200x900",600,1,600,400,"False",729,482,384,-98,98,0
"C11VS",160,35,"1200x900",600,0,600,400,"True",366,555,530,-25,25,1
"C11VS",161,340,"1200x900",800,1,600,400,"False",226,240,516,276,276,0
"C11VS",162,34,"1200x900",600,0,600,400,"True",361,242,262,20,20,1
"C11VS",163,388,"1200x900",800,2,600,400,"False",930,320,634,314,314,0
"C11VS",164,40,"1200x900",600,0,600,400,"True",143,513,497,-16,16,0
"C11VS",165,588,"1200x900",1000,2,600,400,"False",585,350,257,-93,93,0
"C11VS",166,39,"1200x900",600,0,600,400,"True",210,609,625,16,16,0
"C11VS",167,239,"1200x900",800,0,600,400,"False",114,231,369,138,138,1
"C11VS",168,258,"1200x900",800,0,600,400,"False",126,664,583,-81,81,1
"C11VS",169,429,"1200x900",800,2,600,400,"True",682,692,719,27,27,0
"C11VS",170,583,"1200x900",1000,2,600,400,"False",949,284,413,129,129,1
"C11VS",171,220,"1200x900",800,0,600,400,"True",108,699,645,-54,54,1
"C11VS",172,568,"1200x900",1000,1,600,400,"False",286,475,640,165,165,1
"C11VS",173,71,"1200x900",600,0,600,400,"False",219,248,470,222,222,0
"C11VS",174,228,"1200x900",800,0,600,400,"True",174,687,651,-36,36,1
"C11VS",175,321,"1200x900",800,1,600,400,"False",601,190,392,202,202,0
"C11VS",176,475,"1200x900",1000,0,600,400,"False",101,715,495,-220,220,1
"C11VS",177,107,"1200x900",600,1,600,400,"False",878,678,616,-62,62,0
"C11VS",178,592,"1200x900",1000,2,600,400,"False",492,392,621,229,229,0
"C11VS",179,287,"1200x900",800,0,600,400,"True",120,567,552,-15,15,1
"C11VS",180,371,"1200x900",800,2,600,400,"True",730,560,493,-67,67,0
"C11VS",181,105,"1200x900",600,1,600,400,"False",527,440,772,332,332,0
"C11VS",182,504,"1200x900",1000,0,600,400,"False",107,699,602,-97,97,1
"C11VS",183,489,"1200x900",1000,0,600,400,"True",88,604,637,33,33,1
"C11VS",184,221,"1200x900",800,0,600,400,"True",132,520,498,-22,22,1
"C11VS",185,534,"1200x900",1000,1,600,400,"True",328,504,523,19,19,1
"C11VS",186,418,"1200x900",800,2,600,400,"False",754,507,432,-75,75,0
"C11VS",187,88,"1200x900",600,1,600,400,"True",186,554,509,-45,45,0
"C11VS",188,311,"1200x900",800,1,600,400,"False",710,261,622,361,361,0
"C11VS",189,103,"1200x900",600,1,600,400,"False",528,320,470,150,150,1
"C11VS",190,137,"1200x900",600,1,600,400,"True",789,577,623,46,46,0
"C11VS",191,620,"1200x900",1000,2,600,400,"False",832,649,429,-220,220,0
"C11VS",192,73,"1200x900",600,1,600,400,"True",94,665,698,33,33,0
"C11VS",193,32,"1200x900",600,0,600,400,"False",152,563,696,133,133,1
"C11VS",194,70,"1200x900",600,0,600,400,"True",309,703,708,5,5,1
"C11VS",195,83,"1200x900",600,1,600,400,"True",763,568,533,-35,35,1
"C11VS",196,341,"1200x900",800,1,600,400,"True",735,632,599,-33,33,1
"C11VS",197,596,"1200x900",1000,2,600,400,"False",706,513,639,126,126,0
"C11VS",198,1,"1200x900",600,0,600,400,"True",136,502,554,52,52,0
"C11VS",199,411,"1200x900",800,2,600,400,"True",805,361,432,71,71,0
"C11VS",200,543,"1200x900",1000,1,600,400,"False",88,202,417,215,215,0
"C11VS",201,465,"1200x900",1000,0,600,400,"False",85,203,392,189,189,1
"C11VS",202,473,"1200x900",1000,0,600,400,"True",75,323,376,53,53,1
"C11VS",203,490,"1200x900",1000,0,600,400,"False",114,183,333,150,150,1
"C11VS",204,115,"1200x900",600,1,600,400,"False",545,307,251,-56,56,0
"C11VS",205,445,"1200x900",1000,0,600,400,"False",78,302,403,101,101,1
"C11VS",206,53,"1200x900",600,0,600,400,"False",177,189,304,115,115,0
"C11VS",207,472,"1200x900",1000,0,600,400,"False",77,685,566,-119,119,1
"C11VS",208,283,"1200x900",800,0,600,400,"False",90,264,372,108,108,1
"C11VS",209,570,"1200x900",1000,1,600,400,"False",315,352,450,98,98,0
"C11VS",210,248,"1200x900",800,0,600,400,"False",94,240,317,77,77,1
"C11VS",211,65,"1200x900",600,0,600,400,"False",442,645,526,-119,119,1
"C11VS",212,98,"1200x900",600,1,600,400,"True",625,530,536,6,6,0
"C11VS",213,232,"1200x900",800,0,600,400,"True",84,511,492,-19,19,1
"C11VS",214,408,"1200x900",800,2,600,400,"True",758,567,529,-38,38,0
"C11VS",215,546,"1200x900",1000,1,600,400,"True",305,374,409,35,35,0
"C11VS",216,500,"1200x900",1000,0,600,400,"False",105,700,619,-81,81,1
"C11VS",217,567,"1200x900",1000,1,600,400,"True",655,297,243,-54,54,1
"C11VS",218,454,"1200x900",1000,0,600,400,"False",78,687,473,-214,214,1
"C11VS",219,4,"1200x900",600,0,600,400,"False",602,200,355,155,155,1
"C11VS",220,355,"1200x900",800,1,600,400,"True",77,386,428,42,42,0
"C11VS",221,267,"1200x900",800,0,600,400,"True",145,665,648,-17,17,1
"C11VS",222,116,"1200x900",600,1,600,400,"True",767,289,295,6,6,0
"C11VS",223,614,"1200x900",1000,2,600,400,"False",823,563,278,-285,285,0
"C11VS",224,211,"1200x900",600,2,600,400,"False",986,407,336,-71,71,0
"C11VS",225,182,"1200x900",600,2,600,400,"True",933,389,439,50,50,0
"C11VS",226,378,"1200x900",800,2,600,400,"False",1018,708,429,-279,279,0
"C11VS",227,384,"1200x900",800,2,600,400,"False",821,707,413,-294,294,0
"C11VS",228,508,"1200x900",1000,1,600,400,"True",596,485,551,66,66,0
"C11VS",229,41,"1200x900",600,0,600,400,"True",370,452,461,9,9,1
"C11VS",230,149,"1200x900",600,2,600,400,"True",890,289,280,-9,9,0
"C11VS",231,310,"1200x900",800,1,600,400,"True",559,592,588,-4,4,0
"C11VS",232,46,"1200x900",600,0,600,400,"True",193,355,380,25,25,1
"C11VS",233,444,"1200x900",1000,0,600,400,"False",101,714,589,-125,125,1
"C11VS",234,554,"1200x900",1000,1,600,400,"True",79,309,317,8,8,1
"C11VS",235,602,"1200x900",1000,2,600,400,"False",865,452,315,-137,137,0
"C11VS",236,365,"1200x900",800,2,600,400,"False",1055,305,581,276,276,0
"C11VS",237,13,"1200x900",600,0,600,400,"False",296,211,429,218,218,1
"C11VS",238,160,"1200x900",600,2,600,400,"True",863,606,648,42,42,0
"C11VS",239,106,"1200x900",600,1,600,400,"True",803,659,646,-13,13,1
"C11VS",240,201,"1200x900",600,2,600,400,"False",1005,462,636,174,174,0
"C11VS",241,605,"1200x900",1000,2,600,400,"False",493,665,550,-115,115,0
"C11VS",242,241,"1200x900",800,0,600,400,"False",129,227,364,137,137,1
"C11VS",243,298,"1200x900",800,1,600,400,"True",311,457,524,67,67,0
"C11VS",244,565,"1200x900",1000,1,600,400,"True",451,562,552,-10,10,0
"C11VS",245,474,"1200x900",1000,0,600,400,"False",85,339,556,217,217,1
"C11VS",246,494,"1200x900",1000,0,600,400,"True",127,692,640,-52,52,1
"C11VS",247,219,"1200x900",800,0,600,400,"True",202,502,547,45,45,1
"C11VS",248,522,"1200x900",1000,1,600,400,"False",223,379,542,163,163,0
"C11VS",249,64,"1200x900",600,0,600,400,"True",102,339,396,57,57,0
"C11VS",250,368,"1200x900",800,2,600,400,"False",778,515,407,-108,108,0
"C11VS",251,492,"1200x900",1000,0,600,400,"True",76,692,651,-41,41,1
"C11VS",252,222,"1200x900",800,0,600,400,"False",152,206,406,200,200,1
"C11VS",253,43,"1200x900",600,0,600,400,"True",277,446,508,62,62,1
"C11VS",254,296,"1200x900",800,1,600,400,"False",89,279,413,134,134,0
"C11VS",255,438,"1200x900",1000,0,600,400,"False",77,713,558,-155,155,1
"C11VS",256,305,"1200x900",800,1,600,400,"True",471,716,663,-53,53,0
"C11VS",257,95,"1200x900",600,1,600,400,"False",749,425,491,66,66,1
"C11VS",258,491,"1200x900",1000,0,600,400,"False",108,198,409,211,211,1
"C11VS",259,441,"1200x900",1000,0,600,400,"False",85,684,562,-122,122,1
"C11VS",260,582,"1200x900",1000,2,600,400,"True",554,347,375,28,28,0
"C11VS",261,173,"1200x900",600,2,600,400,"True",948,693,657,-36,36,0
"C11VS",262,518,"1200x900",1000,1,600,400,"True",583,717,683,-34,34,0
"C11VS",263,525,"1200x900",1000,1,600,400,"True",123,690,669,-21,21,0
"C11VS",264,426,"1200x900",800,2,600,400,"False",830,263,416,153,153,0
"C11VS",265,594,"1200x900",1000,2,600,400,"False",537,637,449,-188,188,0
"C11VS",266,363,"1200x900",800,2,600,400,"False",800,218,332,114,114,0
"C11VS",267,316,"1200x900",800,1,600,400,"False",362,319,560,241,241,0
"C11VS",268,56,"1200x900",600,0,600,400,"True",148,491,502,11,11,0
"C11VS",269,269,"1200x900",800,0,600,400,"False",160,295,380,85,85,1
"C11VS",270,67,"1200x900",600,0,600,400,"True",289,308,367,59,59,1
"C11VS",271,443,"1200x900",1000,0,600,400,"False",99,651,586,-65,65,1
"C11VS",272,544,"1200x900",1000,1,600,400,"True",602,620,643,23,23,0
"C11VS",273,268,"1200x900",800,0,600,400,"False",148,400,519,119,119,1
"C11VS",274,154,"1200x900",600,2,600,400,"False",941,454,386,-68,68,0
"C11VS",275,302,"1200x900",800,1,600,400,"False",479,467,601,134,134,1
"C11VS",276,585,"1200x900",1000,2,600,400,"True",698,688,613,-75,75,1
"C11VS",277,515,"1200x900",1000,1,600,400,"False",307,217,579,362,362,0
"C11VS",278,81,"1200x900",600,1,600,400,"True",696,225,232,7,7,0
"C11VS",279,386,"1200x900",800,2,600,400,"True",774,301,347,46,46,0
"C11VS",280,161,"1200x900",600,2,600,400,"True",939,553,495,-58,58,0
"C11VS",281,558,"1200x900",1000,1,600,400,"False",72,464,570,106,106,1
"C11VS",282,177,"1200x900",600,2,600,400,"True",912,236,318,82,82,0
"C11VS",283,282,"1200x900",800,0,600,400,"False",109,246,396,150,150,1
"C11VS",284,194,"1200x900",600,2,600,400,"True",896,236,280,44,44,0
"C11VS",285,331,"1200x900",800,1,600,400,"True",240,620,624,4,4,0
"C11VS",286,593,"1200x900",1000,2,600,400,"False",246,719,510,-209,209,0
"C11VS",287,286,"1200x900",800,0,600,400,"False",105,378,514,136,136,1
"C11VS",288,396,"1200x900",800,2,600,400,"True",678,663,614,-49,49,0
"C11VS",289,308,"1200x900",800,1,600,400,"False",437,425,533,108,108,0
"C11VS",290,48,"1200x900",600,0,600,400,"True",323,645,622,-23,23,1
"C11VS",291,512,"1200x900",1000,1,600,400,"False",139,261,418,157,157,0
"C11VS",292,637,"1200x900",1000,2,600,400,"True",750,460,460,0,0,0
"C11VS",293,279,"1200x900",800,0,600,400,"False",252,202,383,181,181,1
"C11VS",295,235,"1200x900",800,0,600,400,"True",146,646,651,5,5,1
"C11VS",296,370,"1200x900",800,2,600,400,"False",874,336,501,165,165,0
"C11VS",297,6,"1200x900",600,0,600,400,"True",217,689,696,7,7,1
"C11VS",298,495,"1200x900",1000,0,600,400,"True",93,692,692,0,0,1
"C11VS",299,203,"1200x900",600,2,600,400,"True",938,603,625,22,22,0
"C11VS",300,75,"1200x900",600,1,600,400,"True",635,558,577,19,19,0
"C11VS",301,581,"1200x900",1000,2,600,400,"False",310,357,657,300,300,0
"C11VS",302,372,"1200x900",800,2,600,400,"True",833,620,640,20,20,0
"C11VS",303,165,"1200x900",600,2,600,400,"True",912,554,600,46,46,0
"C11VS",304,514,"1200x900",1000,1,600,400,"True",539,690,651,-39,39,0
"C11VS",305,485,"1200x900",1000,0,600,400,"True",121,694,733,39,39,1
"C11VS",306,528,"1200x900",1000,1,600,400,"False",839,227,599,372,372,1
"C11VS",307,49,"1200x900",600,0,600,400,"False",109,380,449,69,69,0
"C11VS",308,550,"1200x900",1000,1,600,400,"False",301,459,540,81,81,0
"C11VS",309,632,"1200x900",1000,2,600,400,"False",984,227,519,292,292,0
"C11VS",310,501,"1200x900",1000,0,600,400,"False",96,323,483,160,160,1
"C11VS",311,414,"1200x900",800,2,600,400,"False",831,592,454,-138,138,0
"C11VS",312,507,"1200x900",1000,1,600,400,"True",608,583,566,-17,17,1
"C11VS",313,99,"1200x900",600,1,600,400,"False",811,407,510,103,103,0
"C11VS",314,577,"1200x900",1000,2,600,400,"False",455,420,522,102,102,0
"C11VS",315,459,"1200x900",1000,0,600,400,"False",70,645,435,-210,210,1
"C11VS",316,58,"1200x900",600,0,600,400,"True",353,655,655,0,0,1
"C11VS",317,257,"1200x900",800,0,600,400,"False",97,219,354,135,135,1
"C11VS",318,623,"1200x900",1000,2,600,400,"False",636,527,363,-164,164,0
"C11VS",319,262,"1200x900",800,0,600,400,"False",196,481,415,-66,66,1
"C11VS",320,439,"1200x900",1000,0,600,400,"False",110,229,348,119,119,1
"C11VS",322,402,"1200x900",800,2,600,400,"True",878,234,197,-37,37,0
"C11VS",323,284,"1200x900",800,0,600,400,"True",135,293,262,-31,31,1
"C11VS",324,213,"1200x900",600,2,600,400,"True",822,275,316,41,41,0
"C11VS",325,136,"1200x900",600,1,600,400,"False",264,205,133,-72,72,0
"C11VS",326,393,"1200x900",800,2,600,400,"False",657,620,231,-389,389,0
"C11VS",327,126,"1200x900",600,1,600,400,"False",849,354,442,88,88,0
"C11VS",328,448,"1200x900",1000,0,600,400,"False",107,641,562,-79,79,1
"C11VS",329,62,"1200x900",600,0,600,400,"True",345,346,359,13,13,1
"C11VS",330,102,"1200x900",600,1,600,400,"True",861,603,588,-15,15,0
"C11VS",331,455,"1200x900",1000,0,600,400,"False",107,718,635,-83,83,1
"C11VS",332,587,"1200x900",1000,2,600,400,"False",741,686,463,-223,223,0
"C11VS",333,640,"1200x900",1000,2,600,400,"False",361,334,496,162,162,0
"C11VS",334,332,"1200x900",800,1,600,400,"False",260,699,483,-216,216,0
"C11VS",335,292,"1200x900",800,1,600,400,"False",88,565,652,87,87,0
"C11VS",336,366,"1200x900",800,2,600,400,"False",931,464,271,-193,193,0
"C11VS",337,354,"1200x900",800,1,600,400,"False",118,236,506,270,270,0
"C11VS",339,484,"1200x900",1000,0,600,400,"False",100,223,411,188,188,1
"C11VS",340,297,"1200x900",800,1,600,400,"False",625,244,321,77,77,0
"C11VS",341,383,"1200x900",800,2,600,400,"True",855,407,383,-24,24,0
"C11VS",342,648,"1200x900",1000,2,600,400,"True",557,394,440,46,46,0
"C11VS",343,413,"1200x900",800,2,600,400,"True",849,506,459,-47,47,0
"C11VS",344,118,"1200x900",600,1,600,400,"True",190,588,638,50,50,0
"C11VS",345,14,"1200x900",600,0,600,400,"False",399,224,341,117,117,1
"C11VS",346,524,"1200x900",1000,1,600,400,"False",534,470,664,194,194,0
"C11VS",347,215,"1200x900",600,2,600,400,"False",939,596,482,-114,114,0
"C11VS",348,147,"1200x900",600,2,600,400,"False",942,418,276,-142,142,0
"C11VS",349,434,"1200x900",1000,0,600,400,"False",89,657,593,-64,64,1
"C11VS",350,264,"1200x900",800,0,600,400,"True",198,660,727,67,67,1
"C11VS",351,314,"1200x900",800,1,600,400,"True",277,616,599,-17,17,1
"C11VS",352,60,"1200x900",600,0,600,400,"False",365,213,370,157,157,1
"C11VS",353,27,"1200x900",600,0,600,400,"True",373,309,312,3,3,1
"C11VS",354,185,"1200x900",600,2,600,400,"True",907,212,210,-2,2,0
"C11VS",355,631,"1200x900",1000,2,600,400,"False",699,479,645,166,166,0
"C11VS",356,342,"1200x900",800,1,600,400,"False",677,204,325,121,121,0
"C11VS",357,579,"1200x900",1000,2,600,400,"False",803,394,517,123,123,0
"C11VS",358,295,"1200x900",800,1,600,400,"True",471,334,385,51,51,0
"C11VS",359,409,"1200x900",800,2,600,400,"True",501,659,583,-76,76,0
"C11VS",360,609,"1200x900",1000,2,600,400,"True",697,627,556,-71,71,0
"C11VS",361,509,"1200x900",1000,1,600,400,"False",509,434,507,73,73,0
"C11VS",363,616,"1200x900",1000,2,600,400,"False",854,357,256,-101,101,1
"C11VS",364,406,"1200x900",800,2,600,400,"False",971,233,434,201,201,0
"C11VS",365,575,"1200x900",1000,1,600,400,"False",272,693,607,-86,86,0
"C11VS",366,532,"1200x900",1000,1,600,400,"False",215,207,477,270,270,0
"C11VS",367,612,"1200x900",1000,2,600,400,"True",706,198,228,30,30,0
"C11VS",368,76,"1200x900",600,1,600,400,"False",647,614,720,106,106,0
"C11VS",369,470,"1200x900",1000,0,600,400,"True",91,666,608,-58,58,1
"C11VS",370,306,"1200x900",800,1,600,400,"False",164,524,723,199,199,0
"C11VS",371,338,"1200x900",800,1,600,400,"False",813,253,476,223,223,1
"C11VS",372,151,"1200x900",600,2,600,400,"True",828,680,598,-82,82,0
"C11VS",373,569,"1200x900",1000,1,600,400,"False",494,720,412,-308,308,0
"C11VS",374,478,"1200x900",1000,0,600,400,"False",79,672,560,-112,112,1
"C11VS",375,55,"1200x900",600,0,600,400,"True",211,305,252,-53,53,1
"C11VS",376,433,"1200x900",1000,0,600,400,"False",76,222,314,92,92,1
"C11VS",377,124,"1200x900",600,1,600,400,"False",345,467,373,-94,94,0
"C11VS",379,155,"1200x900",600,2,600,400,"True",940,269,315,46,46,0
"C11VS",380,29,"1200x900",600,0,600,400,"True",385,533,489,-44,44,1
"C11VS",381,166,"1200x900",600,2,600,400,"True",896,274,339,65,65,0
"C11VS",382,431,"1200x900",800,2,600,400,"True",694,382,384,2,2,0
"C11VS",383,280,"1200x900",800,0,600,400,"True",104,302,322,20,20,1
"C11VS",384,197,"1200x900",600,2,600,400,"False",903,212,364,152,152,0
"C11VS",385,535,"1200x900",1000,1,600,400,"True",372,410,381,-29,29,0
"C11VS",386,51,"1200x900",600,0,600,400,"False",272,181,344,163,163,1
"C11VS",387,390,"1200x900",800,2,600,400,"True",982,674,718,44,44,1
"C11VS",388,224,"1200x900",800,0,600,400,"True",161,474,505,31,31,1
"C11VS",389,172,"1200x900",600,2,600,400,"True",912,444,474,30,30,0
"C11VS",390,530,"1200x900",1000,1,600,400,"False",584,405,153,-252,252,1
"C11VS",391,72,"1200x900",600,0,600,400,"True",158,537,539,2,2,0
"C11VS",392,633,"1200x900",1000,2,600,400,"False",564,253,548,295,295,0
"C11VS",393,447,"1200x900",1000,0,600,400,"False",71,339,488,149,149,1
"C11VS",394,361,"1200x900",800,2,600,400,"True",931,328,342,14,14,0
"C11VS",395,96,"1200x900",600,1,600,400,"False",433,458,598,140,140,0
"C11VS",396,562,"1200x900",1000,1,600,400,"True",347,540,594,54,54,0
"C11VS",397,621,"1200x900",1000,2,600,400,"False",540,478,333,-145,145,0
"C11VS",398,628,"1200x900",1000,2,600,400,"True",768,410,482,72,72,0
"C11VS",399,293,"1200x900",800,1,600,400,"False",561,396,506,110,110,0
"C11VS",400,125,"1200x900",600,1,600,400,"True",750,531,537,6,6,0
"C11VS",401,192,"1200x900",600,2,600,400,"False",1064,320,643,323,323,0
"C11VS",402,252,"1200x900",800,0,600,400,"False",224,673,768,95,95,1
"C11VS",403,128,"1200x900",600,1,600,400,"False",661,258,376,118,118,1
"C11VS",404,54,"1200x900",600,0,600,400,"False",474,564,466,-98,98,1
"C11VS",405,523,"1200x900",1000,1,600,400,"False",339,318,415,97,97,0
"C11VS",406,140,"1200x900",600,1,600,400,"True",700,523,527,4,4,0
"C11VS",407,109,"1200x900",600,1,600,400,"False",691,589,446,-143,143,0
"C11VS",408,325,"1200x900",800,1,600,400,"False",105,394,513,119,119,0
"C11VS",409,142,"1200x900",600,1,600,400,"True",286,474,502,28,28,0
"C11VS",410,193,"1200x900",600,2,600,400,"True",874,588,586,-2,2,0
"C11VS",411,566,"1200x900",1000,1,600,400,"False",378,472,380,-92,92,1
"C11VS",412,278,"1200x900",800,0,600,400,"False",251,711,575,-136,136,1
"C11VS",413,112,"1200x900",600,1,600,400,"True",681,490,514,24,24,0
"C11VS",414,636,"1200x900",1000,2,600,400,"False",575,583,372,-211,211,0
"C11VS",415,548,"1200x900",1000,1,600,400,"False",103,278,444,166,166,0
"C11VS",416,273,"1200x900",800,0,600,400,"True",180,309,317,8,8,1
"C11VS",418,178,"1200x900",600,2,600,400,"True",1041,510,481,-29,29,0
"C11VS",419,395,"1200x900",800,2,600,400,"False",743,334,430,96,96,0
"C11VS",420,183,"1200x900",600,2,600,400,"True",927,289,293,4,4,0
"C11VS",421,68,"1200x900",600,0,600,400,"True",165,367,368,1,1,0
"C11VS",422,599,"1200x900",1000,2,600,400,"False",316,570,329,-241,241,0
"C11VS",423,385,"1200x900",800,2,600,400,"False",740,456,333,-123,123,0
"C11VS",424,334,"1200x900",800,1,600,400,"False",481,665,545,-120,120,0
"C11VS",425,300,"1200x900",800,1,600,400,"True",620,693,709,16,16,0
"C11VS",426,10,"1200x900",600,0,600,400,"False",400,499,579,80,80,1
"C11VS",427,301,"1200x900",800,1,600,400,"True",162,574,572,-2,2,0
"C11VS",428,610,"1200x900",1000,2,600,400,"False",702,293,420,127,127,0
"C11VS",429,21,"1200x900",600,0,600,400,"True",314,383,339,-44,44,1
"C11VS",430,373,"1200x900",800,2,600,400,"False",694,326,439,113,113,0
"C11VS",431,11,"1200x900",600,0,600,400,"True",372,670,611,-59,59,1
"C11VS",432,323,"1200x900",800,1,600,400,"False",388,348,592,244,244,0
"C11VS",433,526,"1200x900",1000,1,600,400,"True",497,710,735,25,25,0
"C11VS",434,619,"1200x900",1000,2,600,400,"False",803,247,525,278,278,0
"C11VS",435,643,"1200x900",1000,2,600,400,"True",740,325,321,-4,4,0
"C11VS",436,15,"1200x900",600,0,600,400,"False",473,352,417,65,65,1
"C11VS",437,574,"1200x900",1000,1,600,400,"False",614,194,271,77,77,0
"C11VS",438,423,"1200x900",800,2,600,400,"True",1051,710,618,-92,92,1
"C11VS",439,82,"1200x900",600,1,600,400,"False",108,213,349,136,136,0
"C11VS",440,274,"1200x900",800,0,600,400,"True",146,497,491,-6,6,1
"C11VS",442,595,"1200x900",1000,2,600,400,"False",687,640,272,-368,368,0
"C11VS",443,597,"1200x900",1000,2,600,400,"False",352,239,447,208,208,0
"C11VS",444,198,"1200x900",600,2,600,400,"True",976,500,459,-41,41,0
"C11VS",445,479,"1200x900",1000,0,600,400,"True",74,705,645,-60,60,1
"C11VS",446,304,"1200x900",800,1,600,400,"False",667,605,298,-307,307,0
"C11VS",447,208,"1200x900",600,2,600,400,"False",946,399,503,104,104,0
"C11VS",448,93,"1200x900",600,1,600,400,"True",139,540,463,-77,77,0
"C11VS",449,557,"1200x900",1000,1,600,400,"False",677,505,746,241,241,1
"C11VS",450,26,"1200x900",600,0,600,400,"True",70,712,661,-51,51,0
"C11VS",451,376,"1200x900",800,2,600,400,"True",788,275,366,91,91,0
"C11VS",453,521,"1200x900",1000,1,600,400,"True",111,303,375,72,72,1
"C11VS",454,629,"1200x900",1000,2,600,400,"False",681,257,409,152,152,0
"C11VS",455,59,"1200x900",600,0,600,400,"True",391,692,659,-33,33,1
"C11VS",456,517,"1200x900",1000,1,600,400,"False",548,182,388,206,206,0
"C11VS",457,335,"1200x900",800,1,600,400,"False",124,360,572,212,212,0
"C11VS",458,253,"1200x900",800,0,600,400,"True",177,424,446,22,22,1
"C11VS",459,463,"1200x900",1000,0,600,400,"False",115,693,515,-178,178,1
"C11VS",460,85,"1200x900",600,1,600,400,"False",434,347,708,361,361,0
"C11VS",461,537,"1200x900",1000,1,600,400,"False",621,412,606,194,194,1
"C11VS",462,456,"1200x900",1000,0,600,400,"False",91,257,424,167,167,1
"C11VS",463,547,"1200x900",1000,1,600,400,"True",369,384,436,52,52,1
"C11VS",464,120,"1200x900",600,1,600,400,"False",690,655,580,-75,75,0
"C11VS",465,453,"1200x900",1000,0,600,400,"False",71,393,490,97,97,1
"C11VS",466,186,"1200x900",600,2,600,400,"True",997,197,257,60,60,0
"C11VS",467,326,"1200x900",800,1,600,400,"True",103,482,485,3,3,0
"C11VS",468,202,"1200x900",600,2,600,400,"False",966,460,326,-134,134,0
"C11VS",469,8,"1200x900",600,0,600,400,"False",156,679,586,-93,93,0
"C11VS",470,271,"1200x900",800,0,600,400,"False",74,360,463,103,103,1
"C11VS",471,150,"1200x900",600,2,600,400,"True",897,345,309,-36,36,0
"C11VS",473,392,"1200x900",800,2,600,400,"True",1031,618,567,-51,51,0
"C11VS",474,216,"1200x900",600,2,600,400,"True",1029,286,245,-41,41,0
"C11VS",475,493,"1200x900",1000,0,600,400,"False",80,582,512,-70,70,1
"C11VS",476,134,"1200x900",600,1,600,400,"True",300,188,255,67,67,0
"C11VS",477,407,"1200x900",800,2,600,400,"False",989,340,275,-65,65,0
"C11VS",478,398,"1200x900",800,2,600,400,"True",944,698,634,-64,64,0
"C11VS",479,101,"1200x900",600,1,600,400,"True",541,656,672,16,16,0
"C11VS",480,634,"1200x900",1000,2,600,400,"False",735,313,463,150,150,0
"C11VS",481,66,"1200x900",600,0,600,400,"False",155,673,559,-114,114,0
"C11VS",482,337,"1200x900",800,1,600,400,"True",299,622,580,-42,42,0
"C11VS",483,618,"1200x900",1000,2,600,400,"False",276,671,522,-149,149,0
"C11VS",484,377,"1200x900",800,2,600,400,"False",683,388,325,-63,63,0
"C11VS",485,615,"1200x900",1000,2,600,400,"True",736,634,592,-42,42,0
"C11VS",486,345,"1200x900",800,1,600,400,"True",841,566,616,50,50,1
"C11VS",487,169,"1200x900",600,2,600,400,"False",924,290,208,-82,82,0
"C11VS",488,480,"1200x900",1000,0,600,400,"True",100,231,289,58,58,1
"C11VS",489,144,"1200x900",600,1,600,400,"True",718,371,379,8,8,0
"C11VS",491,425,"1200x900",800,2,600,400,"True",621,438,493,55,55,0
"C11VS",492,78,"1200x900",600,1,600,400,"True",885,684,724,40,40,0
"C11VS",493,324,"1200x900",800,1,600,400,"False",719,712,433,-279,279,1
"C11VS",494,394,"1200x900",800,2,600,400,"False",847,292,424,132,132,0
"C11VS",495,299,"1200x900",800,1,600,400,"False",779,274,647,373,373,0
"C11VS",496,502,"1200x900",1000,0,600,400,"True",111,639,578,-61,61,1
"C11VS",497,397,"1200x900",800,2,600,400,"True",817,692,621,-71,71,0
"C11VS",498,242,"1200x900",800,0,600,400,"True",117,448,431,-17,17,1
"C11VS",499,187,"1200x900",600,2,600,400,"False",857,639,473,-166,166,0
"C11VS",500,349,"1200x900",800,1,600,400,"True",402,665,611,-54,54,0
"C11VS",501,428,"1200x900",800,2,600,400,"False",732,665,533,-132,132,0
"C11VS",502,552,"1200x900",1000,1,600,400,"False",255,412,660,248,248,0
"C11VS",503,9,"1200x900",600,0,600,400,"True",509,654,670,16,16,1
"C11VS",504,5,"1200x900",600,0,600,400,"True",228,587,561,-26,26,0
"C11VS",506,516,"1200x900",1000,1,600,400,"False",440,559,687,128,128,0
"C11VS",507,449,"1200x900",1000,0,600,400,"True",105,683,654,-29,29,1
"C11VS",508,467,"1200x900",1000,0,600,400,"False",74,712,602,-110,110,1
"C11VS",509,630,"1200x900",1000,2,600,400,"True",754,559,606,47,47,0
"C11VS",510,611,"1200x900",1000,2,600,400,"False",414,511,449,-62,62,0
"C11VS",511,265,"1200x900",800,0,600,400,"True",229,353,399,46,46,1
"C11VS",512,74,"1200x900",600,1,600,400,"False",115,358,257,-101,101,0
"C11VS",513,110,"1200x900",600,1,600,400,"False",776,550,622,72,72,1
"C11VS",514,435,"1200x900",1000,0,600,400,"False",119,200,382,182,182,1
"C11VS",515,210,"1200x900",600,2,600,400,"True",835,506,445,-61,61,0
"C11VS",516,156,"1200x900",600,2,600,400,"False",913,197,446,249,249,0
"C11VS",517,476,"1200x900",1000,0,600,400,"True",76,359,361,2,2,1
"C11VS",518,405,"1200x900",800,2,600,400,"True",790,307,356,49,49,0
"C11VS",520,146,"1200x900",600,2,600,400,"False",989,492,305,-187,187,0
"C11VS",521,604,"1200x900",1000,2,600,400,"False",459,593,491,-102,102,0
"C11VS",522,482,"1200x900",1000,0,600,400,"False",79,686,545,-141,141,1
"C11VS",523,133,"1200x900",600,1,600,400,"False",345,551,631,80,80,0
"C11VS",524,23,"1200x900",600,0,600,400,"True",308,463,486,23,23,1
"C11VS",525,419,"1200x900",800,2,600,400,"True",769,351,348,-3,3,0
"C11VS",526,457,"1200x900",1000,0,600,400,"False",97,630,509,-121,121,1
"C11VS",527,400,"1200x900",800,2,600,400,"False",733,297,390,93,93,0
"C11VS",528,356,"1200x900",800,1,600,400,"True",123,484,529,45,45,0
"C11VS",529,351,"1200x900",800,1,600,400,"True",122,581,549,-32,32,0
"C11VS",530,157,"1200x900",600,2,600,400,"True",1016,323,337,14,14,0
"C11VS",531,227,"1200x900",800,0,600,400,"True",196,551,499,-52,52,1
"C11VS",532,129,"1200x900",600,1,600,400,"False",859,482,374,-108,108,1
"C11VS",533,471,"1200x900",1000,0,600,400,"False",122,200,416,216,216,1
"C11VS",534,90,"1200x900",600,1,600,400,"False",560,474,226,-248,248,0
"C11VS",535,617,"1200x900",1000,2,600,400,"False",294,180,319,139,139,0
"C11VS",536,559,"1200x900",1000,1,600,400,"False",641,244,374,130,130,0
"C11VS",537,135,"1200x900",600,1,600,400,"False",759,569,391,-178,178,0
"C11VS",538,436,"1200x900",1000,0,600,400,"False",82,617,505,-112,112,1
"C11VS",539,80,"1200x900",600,1,600,400,"False",616,423,568,145,145,1
"C11VS",540,607,"1200x900",1000,2,600,400,"True",900,573,570,-3,3,1
"C11VS",541,168,"1200x900",600,2,600,400,"False",1001,439,354,-85,85,0
"C11VS",542,380,"1200x900",800,2,600,400,"False",942,228,325,97,97,0
"C11VS",544,477,"1200x900",1000,0,600,400,"True",88,640,596,-44,44,1
"C11VS",545,427,"1200x900",800,2,600,400,"True",812,380,386,6,6,0
"C11VS",546,312,"1200x900",800,1,600,400,"True",238,683,717,34,34,0
"C11VS",547,148,"1200x900",600,2,600,400,"True",907,330,312,-18,18,0
"C11VS",548,519,"1200x900",1000,1,600,400,"False",319,565,746,181,181,1
"C11VS",549,195,"1200x900",600,2,600,400,"True",942,249,311,62,62,0
"C11VS",551,317,"1200x900",800,1,600,400,"False",185,564,695,131,131,0
"C11VS",552,121,"1200x900",600,1,600,400,"False",884,364,515,151,151,0
"C11VS",553,114,"1200x900",600,1,600,400,"True",183,697,639,-58,58,0
"C11VS",554,191,"1200x900",600,2,600,400,"True",962,396,392,-4,4,0
"C11VS",555,255,"1200x900",800,0,600,400,"False",93,709,594,-115,115,1
"C11VS",556,541,"1200x900",1000,1,600,400,"False",339,478,648,170,170,0
"C11VS",557,468,"1200x900",1000,0,600,400,"False",121,219,413,194,194,1
"C11VS",558,542,"1200x900",1000,1,600,400,"False",304,401,204,-197,197,0
"C11VS",559,230,"1200x900",800,0,600,400,"True",99,678,614,-64,64,1
"C11VS",560,359,"1200x900",800,1,600,400,"False",653,241,486,245,245,0
"C11VS",561,644,"1200x900",1000,2,600,400,"True",495,486,491,5,5,0
"C11VS",562,181,"1200x900",600,2,600,400,"False",1018,223,161,-62,62,0
"C11VS",563,272,"1200x900",800,0,600,400,"True",200,181,227,46,46,1
"C11VS",564,229,"1200x900",800,0,600,400,"False",117,697,404,-293,293,1
"C11VS",566,24,"1200x900",600,0,600,400,"False",430,538,466,-72,72,1
"C11VS",567,622,"1200x900",1000,2,600,400,"False",307,683,532,-151,151,0
"C11VS",568,113,"1200x900",600,1,600,400,"True",897,657,655,-2,2,0
"C11VS",571,529,"1200x900",1000,1,600,400,"True",267,412,400,-12,12,1
"C11VS",572,647,"1200x900",1000,2,600,400,"False",560,637,504,-133,133,0
"C11VS",573,510,"1200x900",1000,1,600,400,"True",486,338,386,48,48,1
"C11VS",574,163,"1200x900",600,2,600,400,"True",1046,665,664,-1,1,0
"C11VS",575,175,"1200x900",600,2,600,400,"False",1028,432,245,-187,187,0
"C11VS",576,108,"1200x900",600,1,600,400,"False",830,239,345,106,106,0
"C11VS",577,89,"1200x900",600,1,600,400,"False",917,366,482,116,116,1
"C11VS",579,218,"1200x900",800,0,600,400,"True",106,397,415,18,18,1
"C11VS",581,33,"1200x900",600,0,600,400,"True",198,533,527,-6,6,1
"C11VS",582,28,"1200x900",600,0,600,400,"True",336,410,468,58,58,1
"C11VS",583,7,"1200x900",600,0,600,400,"False",431,654,506,-148,148,1
"C11VS",584,36,"1200x900",600,0,600,400,"False",128,346,422,76,76,1
"C11VS",585,573,"1200x900",1000,1,600,400,"True",486,615,582,-33,33,0
"C11VS",586,12,"1200x900",600,0,600,400,"False",365,336,408,72,72,1
"C11VS",587,19,"1200x900",600,0,600,400,"False",286,686,575,-111,111,0
"C11VS",588,158,"1200x900",600,2,600,400,"True",939,300,360,60,60,0
"C11VS",590,461,"1200x900",1000,0,600,400,"False",95,711,541,-170,170,1
"C11VS",591,625,"1200x900",1000,2,600,400,"False",279,228,556,328,328,0
"C11VS",592,261,"1200x900",800,0,600,400,"False",86,713,624,-89,89,1
"C11VS",593,381,"1200x900",800,2,600,400,"True",705,408,460,52,52,0
"C11VS",594,38,"1200x900",600,0,600,400,"True",120,628,591,-37,37,1
"C11VS",595,348,"1200x900",800,1,600,400,"True",764,294,325,31,31,0
"C11VS",596,275,"1200x900",800,0,600,400,"False",120,594,486,-108,108,0
"C11VS",597,167,"1200x900",600,2,600,400,"True",956,241,276,35,35,0
"C11VS",598,600,"1200x900",1000,2,600,400,"False",765,207,522,315,315,0
"C11VS",599,207,"1200x900",600,2,600,400,"True",838,235,311,76,76,0
"C11VS",600,52,"1200x900",600,0,600,400,"True",171,188,196,8,8,0
"C11VS",601,603,"1200x900",1000,2,600,400,"True",693,280,313,33,33,0
"C11VS",602,223,"1200x900",800,0,600,400,"True",179,191,221,30,30,1
"C11VS",603,364,"1200x900",800,2,600,400,"False",1018,204,464,260,260,0
"C11VS",604,246,"1200x900",800,0,600,400,"True",196,418,428,10,10,1
"C11VS",605,236,"1200x900",800,0,600,400,"True",162,350,367,17,17,1
"C11VS",606,47,"1200x900",600,0,600,400,"False",303,499,419,-80,80,1
"C11VS",607,145,"1200x900",600,2,600,400,"True",1004,630,639,9,9,0
"C11VS",608,343,"1200x900",800,1,600,400,"False",407,557,325,-232,232,0
"C11VS",609,446,"1200x900",1000,0,600,400,"True",72,298,335,37,37,1
"C11VS",610,132,"1200x900",600,1,600,400,"True",333,185,165,-20,20,0
"C11VS",611,497,"1200x900",1000,0,600,400,"False",106,696,489,-207,207,1
"C11VS",612,237,"1200x900",800,0,600,400,"True",204,481,462,-19,19,1
"C11VS",613,346,"1200x900",800,1,600,400,"True",269,635,589,-46,46,0
"C11VS",614,572,"1200x900",1000,1,600,400,"False",302,260,376,116,116,0
"C11VS",615,77,"1200x900",600,1,600,400,"False",780,525,417,-108,108,0
"C11VS",616,30,"1200x900",600,0,600,400,"True",107,353,354,1,1,0
"C11VS",617,563,"1200x900",1000,1,600,400,"False",201,696,556,-140,140,0
"C11VS",618,179,"1200x900",600,2,600,400,"True",908,602,589,-13,13,0
"C11VS",619,190,"1200x900",600,2,600,400,"True",977,238,209,-29,29,0
"C11VS",620,174,"1200x900",600,2,600,400,"False",998,457,274,-183,183,0
"C11VS",621,344,"1200x900",800,1,600,400,"True",589,408,416,8,8,0
"C11VS",622,520,"1200x900",1000,1,600,400,"False",564,260,362,102,102,0
"C11VS",623,250,"1200x900",800,0,600,400,"False",290,248,325,77,77,1
"C11VS",624,586,"1200x900",1000,2,600,400,"True",802,262,304,42,42,0
"C11VS",626,357,"1200x900",800,1,600,400,"True",109,594,566,-28,28,0
"C11VS",627,555,"1200x900",1000,1,600,400,"True",444,556,538,-18,18,0
"C11VS",628,399,"1200x900",800,2,600,400,"False",603,602,491,-111,111,0
"C11VS",629,641,"1200x900",1000,2,600,400,"False",897,272,692,420,420,0
"C11VS",630,360,"1200x900",800,1,600,400,"True",203,608,590,-18,18,0
"C11VS",631,320,"1200x900",800,1,600,400,"False",644,376,599,223,223,0
"C11VS",632,352,"1200x900",800,1,600,400,"False",235,717,601,-116,116,0
"C11VS",633,540,"1200x900",1000,1,600,400,"True",389,568,581,13,13,1
"C11VS",634,31,"1200x900",600,0,600,400,"True",365,338,357,19,19,1
"C11VS",635,347,"1200x900",800,1,600,400,"False",757,295,723,428,428,1
"C11VS",636,50,"1200x900",600,0,600,400,"True",75,582,535,-47,47,0
"C11VS",637,506,"1200x900",1000,1,600,400,"False",559,567,320,-247,247,1
"C11VS",638,601,"1200x900",1000,2,600,400,"False",735,697,411,-286,286,0
"C11VS",639,639,"1200x900",1000,2,600,400,"False",504,456,326,-130,130,0
"C11VS",640,16,"1200x900",600,0,600,400,"False",297,514,403,-111,111,1
"C11VS",641,336,"1200x900",800,1,600,400,"True",251,587,614,27,27,0
"C11VS",642,589,"1200x900",1000,2,600,400,"True",856,418,434,16,16,0
"C11VS",643,2,"1200x900",600,0,600,400,"True",159,323,304,-19,19,0
"C11VS",644,44,"1200x900",600,0,600,400,"True",305,554,519,-35,35,1
"C11VS",645,214,"1200x900",600,2,600,400,"False",1046,305,190,-115,115,0
"C11VS",646,451,"1200x900",1000,0,600,400,"True",110,702,665,-37,37,1
"C11VS",647,256,"1200x900",800,0,600,400,"False",192,656,578,-78,78,1
"C11VS",648,358,"1200x900",800,1,600,400,"False",263,635,212,-423,423,0
"C12KA",1,162,"1200x900",600,2,600,400,"False",849,279,144,-135,135,0
"C12KA",2,132,"1200x900",600,1,600,400,"True",333,185,153,-32,32,0
"C12KA",3,203,"1200x900",600,2,600,400,"False",938,603,278,-325,325,0
"C12KA",4,633,"1200x900",1000,2,600,400,"False",564,253,463,210,210,0
"C12KA",5,324,"1200x900",800,1,600,400,"False",719,712,428,-284,284,1
"C12KA",6,74,"1200x900",600,1,600,400,"False",115,358,431,73,73,0
"C12KA",7,245,"1200x900",800,0,600,400,"True",296,235,208,-27,27,1
"C12KA",8,121,"1200x900",600,1,600,400,"False",884,364,486,122,122,0
"C12KA",9,3,"1200x900",600,0,600,400,"True",298,443,438,-5,5,1
"C12KA",10,515,"1200x900",1000,1,600,400,"False",307,217,476,259,259,0
"C12KA",11,346,"1200x900",800,1,600,400,"False",269,635,723,88,88,0
"C12KA",12,421,"1200x900",800,2,600,400,"True",898,394,352,-42,42,0
"C12KA",13,490,"1200x900",1000,0,600,400,"True",114,183,196,13,13,1
"C12KA",14,140,"1200x900",600,1,600,400,"False",700,523,351,-172,172,0
"C12KA",15,570,"1200x900",1000,1,600,400,"False",315,352,581,229,229,0
"C12KA",16,358,"1200x900",800,1,600,400,"False",263,635,177,-458,458,0
"C12KA",17,109,"1200x900",600,1,600,400,"False",691,589,370,-219,219,0
"C12KA",18,557,"1200x900",1000,1,600,400,"False",677,505,629,124,124,1
"C12KA",19,107,"1200x900",600,1,600,400,"False",878,678,433,-245,245,0
"C12KA",20,591,"1200x900",1000,2,600,400,"True",698,336,354,18,18,0
"C12KA",21,373,"1200x900",800,2,600,400,"False",694,326,438,112,112,0
"C12KA",22,247,"1200x900",800,0,600,400,"False",160,424,287,-137,137,1
"C12KA",23,152,"1200x900",600,2,600,400,"True",971,399,375,-24,24,0
"C12KA",24,352,"1200x900",800,1,600,400,"False",235,717,496,-221,221,0
"C12KA",25,543,"1200x900",1000,1,600,400,"False",88,202,528,326,326,0
"C12KA",26,480,"1200x900",1000,0,600,400,"True",100,231,197,-34,34,1
"C12KA",27,487,"1200x900",1000,0,600,400,"False",78,670,411,-259,259,1
"C12KA",28,337,"1200x900",800,1,600,400,"False",299,622,725,103,103,0
"C12KA",29,455,"1200x900",1000,0,600,400,"False",107,718,462,-256,256,1
"C12KA",30,251,"1200x900",800,0,600,400,"True",88,352,306,-46,46,1
"C12KA",31,209,"1200x900",600,2,600,400,"False",937,637,452,-185,185,0
"C12KA",32,400,"1200x900",800,2,600,400,"False",733,297,556,259,259,0
"C12KA",33,556,"1200x900",1000,1,600,400,"False",415,420,247,-173,173,0
"C12KA",34,45,"1200x900",600,0,600,400,"False",487,678,610,-68,68,1
"C12KA",35,527,"1200x900",1000,1,600,400,"True",565,601,651,50,50,0
"C12KA",36,106,"1200x900",600,1,600,400,"False",803,659,443,-216,216,1
"C12KA",37,67,"1200x900",600,0,600,400,"True",289,308,293,-15,15,1
"C12KA",38,42,"1200x900",600,0,600,400,"False",233,479,409,-70,70,0
"C12KA",39,86,"1200x900",600,1,600,400,"False",692,388,266,-122,122,1
"C12KA",40,389,"1200x900",800,2,600,400,"False",843,530,296,-234,234,0
"C12KA",41,467,"1200x900",1000,0,600,400,"True",74,712,722,10,10,1
"C12KA",42,342,"1200x900",800,1,600,400,"False",677,204,457,253,253,0
"C12KA",43,438,"1200x900",1000,0,600,400,"True",77,713,738,25,25,1
"C12KA",44,297,"1200x900",800,1,600,400,"False",625,244,342,98,98,0
"C12KA",45,511,"1200x900",1000,1,600,400,"True",408,390,341,-49,49,1
"C12KA",46,458,"1200x900",1000,0,600,400,"False",78,624,482,-142,142,1
"C12KA",47,411,"1200x900",800,2,600,400,"True",805,361,438,77,77,0
"C12KA",48,418,"1200x900",800,2,600,400,"False",754,507,251,-256,256,0
"C12KA",49,415,"1200x900",800,2,600,400,"False",823,684,523,-161,161,0
"C12KA",50,96,"1200x900",600,1,600,400,"False",433,458,581,123,123,0
"C12KA",51,555,"1200x900",1000,1,600,400,"False",444,556,273,-283,283,0
"C12KA",52,485,"1200x900",1000,0,600,400,"False",121,694,623,-71,71,1
"C12KA",53,59,"1200x900",600,0,600,400,"True",391,692,711,19,19,1
"C12KA",54,6,"1200x900",600,0,600,400,"True",217,689,772,83,83,1
"C12KA",55,641,"1200x900",1000,2,600,400,"False",897,272,667,395,395,0
"C12KA",56,221,"1200x900",800,0,600,400,"False",132,520,370,-150,150,1
"C12KA",57,17,"1200x900",600,0,600,400,"False",402,496,390,-106,106,1
"C12KA",58,85,"1200x900",600,1,600,400,"False",434,347,446,99,99,0
"C12KA",59,493,"1200x900",1000,0,600,400,"True",80,582,649,67,67,1
"C12KA",60,356,"1200x900",800,1,600,400,"False",123,484,757,273,273,0
"C12KA",61,170,"1200x900",600,2,600,400,"True",996,468,434,-34,34,0
"C12KA",62,62,"1200x900",600,0,600,400,"True",345,346,317,-29,29,1
"C12KA",63,489,"1200x900",1000,0,600,400,"False",88,604,481,-123,123,1
"C12KA",64,569,"1200x900",1000,1,600,400,"False",494,720,630,-90,90,0
"C12KA",65,396,"1200x900",800,2,600,400,"True",678,663,593,-70,70,0
"C12KA",66,133,"1200x900",600,1,600,400,"True",345,551,513,-38,38,0
"C12KA",67,636,"1200x900",1000,2,600,400,"False",575,583,287,-296,296,0
"C12KA",68,108,"1200x900",600,1,600,400,"True",830,239,245,6,6,0
"C12KA",69,387,"1200x900",800,2,600,400,"False",990,444,144,-300,300,0
"C12KA",70,533,"1200x900",1000,1,600,400,"False",355,483,157,-326,326,0
"C12KA",71,330,"1200x900",800,1,600,400,"False",759,301,192,-109,109,1
"C12KA",72,353,"1200x900",800,1,600,400,"False",90,476,563,87,87,0
"C12KA",73,235,"1200x900",800,0,600,400,"True",146,646,599,-47,47,1
"C12KA",74,188,"1200x900",600,2,600,400,"False",900,195,521,326,326,0
"C12KA",75,214,"1200x900",600,2,600,400,"False",1046,305,249,-56,56,0
"C12KA",76,583,"1200x900",1000,2,600,400,"True",949,284,333,49,49,1
"C12KA",77,587,"1200x900",1000,2,600,400,"False",741,686,356,-330,330,0
"C12KA",78,215,"1200x900",600,2,600,400,"True",939,596,529,-67,67,0
"C12KA",79,643,"1200x900",1000,2,600,400,"True",740,325,360,35,35,0
"C12KA",80,72,"1200x900",600,0,600,400,"False",158,537,464,-73,73,0
"C12KA",81,73,"1200x900",600,1,600,400,"False",94,665,479,-186,186,0
"C12KA",82,82,"1200x900",600,1,600,400,"False",108,213,550,337,337,0
"C12KA",83,26,"1200x900",600,0,600,400,"False",70,712,636,-76,76,0
"C12KA",84,15,"1200x900",600,0,600,400,"True",473,352,350,-2,2,1
"C12KA",85,362,"1200x900",800,2,600,400,"True",819,338,342,4,4,0
"C12KA",86,580,"1200x900",1000,2,600,400,"False",651,267,564,297,297,0
"C12KA",87,1,"1200x900",600,0,600,400,"True",136,502,473,-29,29,0
"C12KA",88,445,"1200x900",1000,0,600,400,"True",78,302,329,27,27,1
"C12KA",89,186,"1200x900",600,2,600,400,"True",997,197,258,61,61,0
"C12KA",90,614,"1200x900",1000,2,600,400,"False",823,563,260,-303,303,0
"C12KA",91,305,"1200x900",800,1,600,400,"False",471,716,241,-475,475,0
"C12KA",92,354,"1200x900",800,1,600,400,"False",118,236,427,191,191,0
"C12KA",93,495,"1200x900",1000,0,600,400,"False",93,692,548,-144,144,1
"C12KA",94,558,"1200x900",1000,1,600,400,"False",72,464,306,-158,158,1
"C12KA",95,55,"1200x900",600,0,600,400,"True",211,305,283,-22,22,1
"C12KA",96,282,"1200x900",800,0,600,400,"True",109,246,224,-22,22,1
"C12KA",97,462,"1200x900",1000,0,600,400,"False",102,672,465,-207,207,1
"C12KA",98,201,"1200x900",600,2,600,400,"False",1005,462,230,-232,232,0
"C12KA",99,150,"1200x900",600,2,600,400,"True",897,345,415,70,70,0
"C12KA",100,347,"1200x900",800,1,600,400,"False",757,295,399,104,104,1
"C12KA",101,147,"1200x900",600,2,600,400,"False",942,418,194,-224,224,0
"C12KA",102,290,"1200x900",800,1,600,400,"False",789,603,493,-110,110,0
"C12KA",103,28,"1200x900",600,0,600,400,"True",336,410,396,-14,14,1
"C12KA",104,595,"1200x900",1000,2,600,400,"False",687,640,482,-158,158,0
"C12KA",105,308,"1200x900",800,1,600,400,"True",437,425,376,-49,49,0
"C12KA",106,295,"1200x900",800,1,600,400,"False",471,334,509,175,175,0
"C12KA",107,143,"1200x900",600,1,600,400,"False",479,284,400,116,116,1
"C12KA",108,544,"1200x900",1000,1,600,400,"False",602,620,209,-411,411,0
"C12KA",109,146,"1200x900",600,2,600,400,"False",989,492,261,-231,231,0
"C12KA",110,242,"1200x900",800,0,600,400,"False",117,448,365,-83,83,1
"C12KA",111,444,"1200x900",1000,0,600,400,"False",101,714,525,-189,189,1
"C12KA",112,443,"1200x900",1000,0,600,400,"True",99,651,588,-63,63,1
"C12KA",113,518,"1200x900",1000,1,600,400,"False",583,717,387,-330,330,0
"C12KA",114,125,"1200x900",600,1,600,400,"True",750,531,587,56,56,0
"C12KA",115,177,"1200x900",600,2,600,400,"True",912,236,213,-23,23,0
"C12KA",116,87,"1200x900",600,1,600,400,"False",231,604,425,-179,179,0
"C12KA",117,11,"1200x900",600,0,600,400,"True",372,670,680,10,10,1
"C12KA",118,336,"1200x900",800,1,600,400,"False",251,587,398,-189,189,0
"C12KA",119,289,"1200x900",800,1,600,400,"True",421,703,664,-39,39,1
"C12KA",120,293,"1200x900",800,1,600,400,"True",561,396,434,38,38,0
"C12KA",121,222,"1200x900",800,0,600,400,"True",152,206,223,17,17,1
"C12KA",122,64,"1200x900",600,0,600,400,"True",102,339,281,-58,58,0
"C12KA",123,301,"1200x900",800,1,600,400,"False",162,574,778,204,204,0
"C12KA",124,278,"1200x900",800,0,600,400,"True",251,711,675,-36,36,1
"C12KA",125,220,"1200x900",800,0,600,400,"False",108,699,582,-117,117,1
"C12KA",126,117,"1200x900",600,1,600,400,"True",711,456,500,44,44,0
"C12KA",127,54,"1200x900",600,0,600,400,"False",474,564,461,-103,103,1
"C12KA",128,474,"1200x900",1000,0,600,400,"True",85,339,279,-60,60,1
"C12KA",129,513,"1200x900",1000,1,600,400,"False",235,602,286,-316,316,0
"C12KA",130,36,"1200x900",600,0,600,400,"True",128,346,391,45,45,1
"C12KA",131,406,"1200x900",800,2,600,400,"True",971,233,212,-21,21,0
"C12KA",132,451,"1200x900",1000,0,600,400,"False",110,702,568,-134,134,1
"C12KA",133,4,"1200x900",600,0,600,400,"True",602,200,191,-9,9,1
"C12KA",134,456,"1200x900",1000,0,600,400,"False",91,257,123,-134,134,1
"C12KA",135,510,"1200x900",1000,1,600,400,"False",486,338,231,-107,107,1
"C12KA",136,350,"1200x900",800,1,600,400,"True",182,566,530,-36,36,0
"C12KA",137,224,"1200x900",800,0,600,400,"False",161,474,326,-148,148,1
"C12KA",138,223,"1200x900",800,0,600,400,"False",179,191,402,211,211,1
"C12KA",139,249,"1200x900",800,0,600,400,"True",126,306,362,56,56,1
"C12KA",140,321,"1200x900",800,1,600,400,"False",601,190,298,108,108,0
"C12KA",141,58,"1200x900",600,0,600,400,"False",353,655,569,-86,86,1
"C12KA",142,597,"1200x900",1000,2,600,400,"False",352,239,426,187,187,0
"C12KA",143,432,"1200x900",800,2,600,400,"False",792,380,490,110,110,0
"C12KA",144,118,"1200x900",600,1,600,400,"False",190,588,380,-208,208,0
"C12KA",145,422,"1200x900",800,2,600,400,"False",712,558,232,-326,326,0
"C12KA",146,204,"1200x900",600,2,600,400,"False",1053,432,148,-284,284,0
"C12KA",147,316,"1200x900",800,1,600,400,"True",362,319,294,-25,25,0
"C12KA",148,79,"1200x900",600,1,600,400,"False",731,289,192,-97,97,0
"C12KA",149,149,"1200x900",600,2,600,400,"True",890,289,334,45,45,0
"C12KA",150,56,"1200x900",600,0,600,400,"False",148,491,212,-279,279,0
"C12KA",151,635,"1200x900",1000,2,600,400,"True",833,402,477,75,75,0
"C12KA",152,491,"1200x900",1000,0,600,400,"True",108,198,166,-32,32,1
"C12KA",153,307,"1200x900",800,1,600,400,"False",716,247,105,-142,142,0
"C12KA",154,604,"1200x900",1000,2,600,400,"True",459,593,587,-6,6,0
"C12KA",155,195,"1200x900",600,2,600,400,"False",942,249,457,208,208,0
"C12KA",156,239,"1200x900",800,0,600,400,"True",114,231,170,-61,61,1
"C12KA",157,329,"1200x900",800,1,600,400,"True",517,239,274,35,35,0
"C12KA",158,606,"1200x900",1000,2,600,400,"False",653,627,153,-474,474,0
"C12KA",159,202,"1200x900",600,2,600,400,"False",966,460,281,-179,179,0
"C12KA",160,145,"1200x900",600,2,600,400,"False",1004,630,288,-342,342,0
"C12KA",161,448,"1200x900",1000,0,600,400,"True",107,641,687,46,46,1
"C12KA",162,196,"1200x900",600,2,600,400,"True",1030,397,428,31,31,0
"C12KA",163,68,"1200x900",600,0,600,400,"True",165,367,365,-2,2,0
"C12KA",164,405,"1200x900",800,2,600,400,"True",790,307,260,-47,47,0
"C12KA",165,568,"1200x900",1000,1,600,400,"False",286,475,557,82,82,1
"C12KA",166,525,"1200x900",1000,1,600,400,"True",123,690,661,-29,29,0
"C12KA",167,521,"1200x900",1000,1,600,400,"False",111,303,700,397,397,1
"C12KA",168,459,"1200x900",1000,0,600,400,"False",70,645,555,-90,90,1
"C12KA",169,505,"1200x900",1000,1,600,400,"False",191,484,670,186,186,1
"C12KA",170,43,"1200x900",600,0,600,400,"True",277,446,472,26,26,1
"C12KA",171,31,"1200x900",600,0,600,400,"True",365,338,364,26,26,1
"C12KA",172,33,"1200x900",600,0,600,400,"True",198,533,486,-47,47,1
"C12KA",173,111,"1200x900",600,1,600,400,"True",922,552,559,7,7,1
"C12KA",174,95,"1200x900",600,1,600,400,"False",749,425,279,-146,146,1
"C12KA",175,425,"1200x900",800,2,600,400,"True",621,438,470,32,32,0
"C12KA",176,120,"1200x900",600,1,600,400,"False",690,655,298,-357,357,0
"C12KA",177,370,"1200x900",800,2,600,400,"False",874,336,616,280,280,0
"C12KA",178,638,"1200x900",1000,2,600,400,"True",385,198,153,-45,45,0
"C12KA",179,71,"1200x900",600,0,600,400,"True",219,248,214,-34,34,0
"C12KA",180,394,"1200x900",800,2,600,400,"True",847,292,292,0,0,0
"C12KA",181,53,"1200x900",600,0,600,400,"True",177,189,209,20,20,0
"C12KA",182,179,"1200x900",600,2,600,400,"False",908,602,343,-259,259,0
"C12KA",183,193,"1200x900",600,2,600,400,"False",874,588,372,-216,216,0
"C12KA",184,607,"1200x900",1000,2,600,400,"True",900,573,558,-15,15,1
"C12KA",185,528,"1200x900",1000,1,600,400,"False",839,227,489,262,262,1
"C12KA",186,588,"1200x900",1000,2,600,400,"True",585,350,302,-48,48,0
"C12KA",187,589,"1200x900",1000,2,600,400,"False",856,418,286,-132,132,0
"C12KA",188,234,"1200x900",800,0,600,400,"True",72,344,322,-22,22,1
"C12KA",189,582,"1200x900",1000,2,600,400,"True",554,347,343,-4,4,0
"C12KA",190,27,"1200x900",600,0,600,400,"True",373,309,267,-42,42,1
"C12KA",191,285,"1200x900",800,0,600,400,"False",237,396,189,-207,207,1
"C12KA",192,296,"1200x900",800,1,600,400,"False",89,279,411,132,132,0
"C12KA",193,414,"1200x900",800,2,600,400,"False",831,592,258,-334,334,0
"C12KA",194,542,"1200x900",1000,1,600,400,"True",304,401,416,15,15,0
"C12KA",195,361,"1200x900",800,2,600,400,"True",931,328,334,6,6,0
"C12KA",196,550,"1200x900",1000,1,600,400,"False",301,459,388,-71,71,0
"C12KA",197,596,"1200x900",1000,2,600,400,"False",706,513,287,-226,226,0
"C12KA",198,403,"1200x900",800,2,600,400,"False",625,704,366,-338,338,0
"C12KA",199,639,"1200x900",1000,2,600,400,"False",504,456,317,-139,139,0
"C12KA",200,158,"1200x900",600,2,600,400,"False",939,300,599,299,299,0
"C12KA",201,212,"1200x900",600,2,600,400,"False",841,206,517,311,311,0
"C12KA",202,420,"1200x900",800,2,600,400,"True",519,223,237,14,14,0
"C12KA",203,594,"1200x900",1000,2,600,400,"False",537,637,347,-290,290,0
"C12KA",204,77,"1200x900",600,1,600,400,"False",780,525,600,75,75,0
"C12KA",205,46,"1200x900",600,0,600,400,"True",193,355,383,28,28,1
"C12KA",206,229,"1200x900",800,0,600,400,"True",117,697,742,45,45,1
"C12KA",207,157,"1200x900",600,2,600,400,"False",1016,323,232,-91,91,0
"C12KA",208,327,"1200x900",800,1,600,400,"False",152,339,96,-243,243,0
"C12KA",209,161,"1200x900",600,2,600,400,"False",939,553,455,-98,98,0
"C12KA",210,379,"1200x900",800,2,600,400,"False",994,325,457,132,132,0
"C12KA",211,374,"1200x900",800,2,600,400,"False",755,450,356,-94,94,0
"C12KA",212,524,"1200x900",1000,1,600,400,"True",534,470,439,-31,31,0
"C12KA",213,397,"1200x900",800,2,600,400,"False",817,692,322,-370,370,0
"C12KA",214,252,"1200x900",800,0,600,400,"True",224,673,666,-7,7,1
"C12KA",215,398,"1200x900",800,2,600,400,"False",944,698,481,-217,217,0
"C12KA",216,625,"1200x900",1000,2,600,400,"False",279,228,534,306,306,0
"C12KA",217,371,"1200x900",800,2,600,400,"False",730,560,459,-101,101,0
"C12KA",218,127,"1200x900",600,1,600,400,"False",309,691,487,-204,204,0
"C12KA",219,309,"1200x900",800,1,600,400,"False",186,225,430,205,205,0
"C12KA",220,154,"1200x900",600,2,600,400,"False",941,454,264,-190,190,0
"C12KA",221,243,"1200x900",800,0,600,400,"True",114,332,362,30,30,1
"C12KA",222,585,"1200x900",1000,2,600,400,"False",698,688,228,-460,460,1
"C12KA",223,99,"1200x900",600,1,600,400,"True",811,407,422,15,15,0
"C12KA",224,98,"1200x900",600,1,600,400,"True",625,530,501,-29,29,0
"C12KA",225,613,"1200x900",1000,2,600,400,"True",690,374,408,34,34,0
"C12KA",226,265,"1200x900",800,0,600,400,"True",229,353,363,10,10,1
"C12KA",227,578,"1200x900",1000,2,600,400,"True",966,276,328,52,52,0
"C12KA",229,446,"1200x900",1000,0,600,400,"False",72,298,429,131,131,1
"C12KA",230,93,"1200x900",600,1,600,400,"False",139,540,347,-193,193,0
"C12KA",231,13,"1200x900",600,0,600,400,"False",296,211,304,93,93,1
"C12KA",232,244,"1200x900",800,0,600,400,"True",194,203,199,-4,4,1
"C12KA",234,562,"1200x900",1000,1,600,400,"False",347,540,261,-279,279,0
"C12KA",235,449,"1200x900",1000,0,600,400,"False",105,683,451,-232,232,1
"C12KA",236,91,"1200x900",600,1,600,400,"False",417,630,432,-198,198,1
"C12KA",237,646,"1200x900",1000,2,600,400,"False",829,227,370,143,143,1
"C12KA",238,616,"1200x900",1000,2,600,400,"False",854,357,538,181,181,1
"C12KA",239,83,"1200x900",600,1,600,400,"True",763,568,585,17,17,1
"C12KA",240,63,"1200x900",600,0,600,400,"True",311,188,215,27,27,1
"C12KA",241,522,"1200x900",1000,1,600,400,"True",223,379,339,-40,40,0
"C12KA",242,464,"1200x900",1000,0,600,400,"True",82,222,226,4,4,1
"C12KA",244,225,"1200x900",800,0,600,400,"False",178,423,314,-109,109,1
"C12KA",245,391,"1200x900",800,2,600,400,"False",895,521,414,-107,107,0
"C12KA",246,441,"1200x900",1000,0,600,400,"False",85,684,580,-104,104,1
"C12KA",247,577,"1200x900",1000,2,600,400,"False",455,420,686,266,266,0
"C12KA",248,626,"1200x900",1000,2,600,400,"False",329,449,538,89,89,0
"C12KA",249,153,"1200x900",600,2,600,400,"False",1037,601,312,-289,289,0
"C12KA",250,473,"1200x900",1000,0,600,400,"True",75,323,325,2,2,1
"C12KA",251,78,"1200x900",600,1,600,400,"False",885,684,298,-386,386,0
"C12KA",252,423,"1200x900",800,2,600,400,"False",1051,710,263,-447,447,1
"C12KA",253,608,"1200x900",1000,2,600,400,"False",742,250,370,120,120,0
"C12KA",254,276,"1200x900",800,0,600,400,"True",281,217,271,54,54,1
"C12KA",255,584,"1200x900",1000,2,600,400,"True",731,413,367,-46,46,0
"C12KA",256,119,"1200x900",600,1,600,400,"False",168,563,298,-265,265,0
"C12KA",257,304,"1200x900",800,1,600,400,"False",667,605,457,-148,148,0
"C12KA",258,545,"1200x900",1000,1,600,400,"True",358,562,529,-33,33,0
"C12KA",259,553,"1200x900",1000,1,600,400,"True",116,712,677,-35,35,0
"C12KA",260,287,"1200x900",800,0,600,400,"False",120,567,659,92,92,1
"C12KA",261,576,"1200x900",1000,1,600,400,"True",376,713,775,62,62,0
"C12KA",262,23,"1200x900",600,0,600,400,"False",308,463,561,98,98,1
"C12KA",263,48,"1200x900",600,0,600,400,"True",323,645,607,-38,38,1
"C12KA",264,453,"1200x900",1000,0,600,400,"False",71,393,501,108,108,1
"C12KA",265,70,"1200x900",600,0,600,400,"False",309,703,626,-77,77,1
"C12KA",266,454,"1200x900",1000,0,600,400,"True",78,687,656,-31,31,1
"C12KA",267,644,"1200x900",1000,2,600,400,"True",495,486,515,29,29,0
"C12KA",268,180,"1200x900",600,2,600,400,"False",929,270,455,185,185,0
"C12KA",269,116,"1200x900",600,1,600,400,"False",767,289,190,-99,99,0
"C12KA",270,38,"1200x900",600,0,600,400,"False",120,628,457,-171,171,1
"C12KA",271,288,"1200x900",800,0,600,400,"True",180,547,548,1,1,1
"C12KA",272,130,"1200x900",600,1,600,400,"True",741,428,392,-36,36,0
"C12KA",273,182,"1200x900",600,2,600,400,"False",933,389,540,151,151,0
"C12KA",274,538,"1200x900",1000,1,600,400,"True",308,457,391,-66,66,1
"C12KA",275,447,"1200x900",1000,0,600,400,"True",71,339,356,17,17,1
"C12KA",276,218,"1200x900",800,0,600,400,"True",106,397,325,-72,72,1
"C12KA",277,517,"1200x900",1000,1,600,400,"False",548,182,425,243,243,0
"C12KA",278,134,"1200x900",600,1,600,400,"True",300,188,207,19,19,0
"C12KA",279,210,"1200x900",600,2,600,400,"False",835,506,311,-195,195,0
"C12KA",280,18,"1200x900",600,0,600,400,"True",400,318,307,-11,11,1
"C12KA",281,567,"1200x900",1000,1,600,400,"False",655,297,192,-105,105,1
"C12KA",282,20,"1200x900",600,0,600,400,"True",204,545,559,14,14,1
"C12KA",283,627,"1200x900",1000,2,600,400,"False",760,510,388,-122,122,0
"C12KA",284,344,"1200x900",800,1,600,400,"False",589,408,534,126,126,0
"C12KA",285,399,"1200x900",800,2,600,400,"False",603,602,409,-193,193,0
"C12KA",286,262,"1200x900",800,0,600,400,"True",196,481,445,-36,36,1
"C12KA",287,349,"1200x900",800,1,600,400,"False",402,665,723,58,58,0
"C12KA",288,433,"1200x900",1000,0,600,400,"False",76,222,341,119,119,1
"C12KA",289,360,"1200x900",800,1,600,400,"False",203,608,763,155,155,0
"C12KA",290,311,"1200x900",800,1,600,400,"False",710,261,374,113,113,0
"C12KA",291,502,"1200x900",1000,0,600,400,"False",111,639,540,-99,99,1
"C12KA",292,81,"1200x900",600,1,600,400,"False",696,225,567,342,342,0
"C12KA",293,534,"1200x900",1000,1,600,400,"False",328,504,714,210,210,1
"C12KA",294,47,"1200x900",600,0,600,400,"True",303,499,510,11,11,1
"C12KA",295,207,"1200x900",600,2,600,400,"False",838,235,325,90,90,0
"C12KA",296,76,"1200x900",600,1,600,400,"False",647,614,408,-206,206,0
"C12KA",297,573,"1200x900",1000,1,600,400,"False",486,615,467,-148,148,0
"C12KA",298,503,"1200x900",1000,0,600,400,"True",86,279,292,13,13,1
"C12KA",299,504,"1200x900",1000,0,600,400,"False",107,699,549,-150,150,1
"C12KA",300,426,"1200x900",800,2,600,400,"False",830,263,456,193,193,0
"C12KA",301,14,"1200x900",600,0,600,400,"False",399,224,287,63,63,1
"C12KA",302,477,"1200x900",1000,0,600,400,"False",88,640,551,-89,89,1
"C12KA",303,579,"1200x900",1000,2,600,400,"False",803,394,220,-174,174,0
"C12KA",304,552,"1200x900",1000,1,600,400,"False",255,412,711,299,299,0
"C12KA",305,165,"1200x900",600,2,600,400,"False",912,554,188,-366,366,0
"C12KA",306,388,"1200x900",800,2,600,400,"False",930,320,458,138,138,0
"C12KA",307,227,"1200x900",800,0,600,400,"False",196,551,716,165,165,1
"C12KA",308,624,"1200x900",1000,2,600,400,"True",693,501,550,49,49,0
"C12KA",309,144,"1200x900",600,1,600,400,"False",718,371,475,104,104,0
"C12KA",310,211,"1200x900",600,2,600,400,"False",986,407,547,140,140,0
"C12KA",311,531,"1200x900",1000,1,600,400,"False",233,362,592,230,230,0
"C12KA",312,115,"1200x900",600,1,600,400,"False",545,307,567,260,260,0
"C12KA",313,24,"1200x900",600,0,600,400,"True",430,538,494,-44,44,1
"C12KA",314,40,"1200x900",600,0,600,400,"True",143,513,547,34,34,0
"C12KA",315,365,"1200x900",800,2,600,400,"False",1055,305,522,217,217,0
"C12KA",316,378,"1200x900",800,2,600,400,"False",1018,708,648,-60,60,0
"C12KA",317,178,"1200x900",600,2,600,400,"False",1041,510,306,-204,204,0
"C12KA",318,546,"1200x900",1000,1,600,400,"True",305,374,378,4,4,0
"C12KA",319,498,"1200x900",1000,0,600,400,"False",100,260,439,179,179,1
"C12KA",320,138,"1200x900",600,1,600,400,"False",844,580,343,-237,237,1
"C12KA",321,463,"1200x900",1000,0,600,400,"False",115,693,519,-174,174,1
"C12KA",322,402,"1200x900",800,2,600,400,"False",878,234,531,297,297,0
"C12KA",323,84,"1200x900",600,1,600,400,"True",144,184,249,65,65,0
"C12KA",324,61,"1200x900",600,0,600,400,"False",272,670,528,-142,142,1
"C12KA",325,615,"1200x900",1000,2,600,400,"False",736,634,276,-358,358,0
"C12KA",326,194,"1200x900",600,2,600,400,"False",896,236,488,252,252,0
"C12KA",327,345,"1200x900",800,1,600,400,"False",841,566,687,121,121,1
"C12KA",328,183,"1200x900",600,2,600,400,"False",927,289,633,344,344,0
"C12KA",329,100,"1200x900",600,1,600,400,"False",453,511,417,-94,94,0
"C12KA",330,200,"1200x900",600,2,600,400,"False",897,302,620,318,318,0
"C12KA",331,104,"1200x900",600,1,600,400,"False",448,584,256,-328,328,0
"C12KA",332,325,"1200x900",800,1,600,400,"False",105,394,689,295,295,0
"C12KA",333,240,"1200x900",800,0,600,400,"True",330,656,623,-33,33,1
"C12KA",334,500,"1200x900",1000,0,600,400,"False",105,700,536,-164,164,1
"C12KA",335,135,"1200x900",600,1,600,400,"False",759,569,245,-324,324,0
"C12KA",336,94,"1200x900",600,1,600,400,"False",729,482,624,142,142,0
"C12KA",337,66,"1200x900",600,0,600,400,"False",155,673,427,-246,246,0
"C12KA",338,318,"1200x900",800,1,600,400,"True",788,534,479,-55,55,0
"C12KA",339,590,"1200x900",1000,2,600,400,"False",636,278,552,274,274,0
"C12KA",340,151,"1200x900",600,2,600,400,"False",828,680,259,-421,421,0
"C12KA",341,507,"1200x900",1000,1,600,400,"False",608,583,424,-159,159,1
"C12KA",342,21,"1200x900",600,0,600,400,"False",314,383,307,-76,76,1
"C12KA",343,516,"1200x900",1000,1,600,400,"False",440,559,469,-90,90,0
"C12KA",344,560,"1200x900",1000,1,600,400,"False",516,693,267,-426,426,0
"C12KA",345,470,"1200x900",1000,0,600,400,"False",91,666,452,-214,214,1
"C12KA",346,110,"1200x900",600,1,600,400,"False",776,550,358,-192,192,1
"C12KA",347,294,"1200x900",800,1,600,400,"False",262,287,384,97,97,0
"C12KA",348,384,"1200x900",800,2,600,400,"False",821,707,315,-392,392,0
"C12KA",349,199,"1200x900",600,2,600,400,"False",992,467,411,-56,56,0
"C12KA",350,258,"1200x900",800,0,600,400,"False",126,664,509,-155,155,1
"C12KA",351,156,"1200x900",600,2,600,400,"False",913,197,408,211,211,0
"C12KA",352,357,"1200x900",800,1,600,400,"False",109,594,203,-391,391,0
"C12KA",353,479,"1200x900",1000,0,600,400,"True",74,705,673,-32,32,1
"C12KA",354,236,"1200x900",800,0,600,400,"True",162,350,388,38,38,1
"C12KA",355,481,"1200x900",1000,0,600,400,"False",80,185,270,85,85,1
"C12KA",356,315,"1200x900",800,1,600,400,"True",105,211,203,-8,8,0
"C12KA",357,122,"1200x900",600,1,600,400,"False",817,709,500,-209,209,0
"C12KA",358,169,"1200x900",600,2,600,400,"True",924,290,343,53,53,0
"C12KA",359,435,"1200x900",1000,0,600,400,"True",119,200,158,-42,42,1
"C12KA",360,32,"1200x900",600,0,600,400,"True",152,563,519,-44,44,1
"C12KA",361,343,"1200x900",800,1,600,400,"False",407,557,304,-253,253,0
"C12KA",362,620,"1200x900",1000,2,600,400,"False",832,649,496,-153,153,0
"C12KA",363,372,"1200x900",800,2,600,400,"False",833,620,203,-417,417,0
"C12KA",364,609,"1200x900",1000,2,600,400,"False",697,627,710,83,83,0
"C12KA",366,539,"1200x900",1000,1,600,400,"False",510,383,552,169,169,0
"C12KA",367,90,"1200x900",600,1,600,400,"False",560,474,610,136,136,0
"C12KA",368,271,"1200x900",800,0,600,400,"True",74,360,426,66,66,1
"C12KA",369,385,"1200x900",800,2,600,400,"True",740,456,399,-57,57,0
"C12KA",370,381,"1200x900",800,2,600,400,"False",705,408,510,102,102,0
"C12KA",371,631,"1200x900",1000,2,600,400,"False",699,479,389,-90,90,0
"C12KA",372,334,"1200x900",800,1,600,400,"False",481,665,298,-367,367,0
"C12KA",373,440,"1200x900",1000,0,600,400,"False",71,237,450,213,213,1
"C12KA",374,340,"1200x900",800,1,600,400,"False",226,240,302,62,62,0
"C12KA",375,429,"1200x900",800,2,600,400,"False",682,692,269,-423,423,0
"C12KA",376,501,"1200x900",1000,0,600,400,"False",96,323,430,107,107,1
"C12KA",377,313,"1200x900",800,1,600,400,"True",588,421,419,-2,2,0
"C12KA",378,326,"1200x900",800,1,600,400,"False",103,482,379,-103,103,0
"C12KA",379,126,"1200x900",600,1,600,400,"True",849,354,403,49,49,0
"C12KA",380,105,"1200x900",600,1,600,400,"True",527,440,353,-87,87,0
"C12KA",381,60,"1200x900",600,0,600,400,"False",365,213,297,84,84,1
"C12KA",382,380,"1200x900",800,2,600,400,"False",942,228,438,210,210,0
"C12KA",383,29,"1200x900",600,0,600,400,"True",385,533,533,0,0,1
"C12KA",384,523,"1200x900",1000,1,600,400,"False",339,318,518,200,200,0
"C12KA",385,274,"1200x900",800,0,600,400,"True",146,497,463,-34,34,1
"C12KA",386,266,"1200x900",800,0,600,400,"True",126,303,335,32,32,1
"C12KA",387,114,"1200x900",600,1,600,400,"False",183,697,270,-427,427,0
"C12KA",388,253,"1200x900",800,0,600,400,"False",177,424,304,-120,120,1
"C12KA",389,101,"1200x900",600,1,600,400,"False",541,656,390,-266,266,0
"C12KA",390,586,"1200x900",1000,2,600,400,"False",802,262,354,92,92,0
"C12KA",391,16,"1200x900",600,0,600,400,"False",297,514,282,-232,232,1
"C12KA",392,430,"1200x900",800,2,600,400,"False",922,254,546,292,292,0
"C12KA",393,465,"1200x900",1000,0,600,400,"True",85,203,223,20,20,1
"C12KA",394,424,"1200x900",800,2,600,400,"True",903,545,527,-18,18,0
"C12KA",395,359,"1200x900",800,1,600,400,"False",653,241,393,152,152,0
"C12KA",396,466,"1200x900",1000,0,600,400,"True",82,205,178,-27,27,1
"C12KA",397,592,"1200x900",1000,2,600,400,"True",492,392,362,-30,30,0
"C12KA",398,428,"1200x900",800,2,600,400,"False",732,665,304,-361,361,0
"C12KA",399,302,"1200x900",800,1,600,400,"True",479,467,485,18,18,1
"C12KA",400,57,"1200x900",600,0,600,400,"True",354,508,528,20,20,1
"C12KA",401,191,"1200x900",600,2,600,400,"True",962,396,451,55,55,0
"C12KA",402,92,"1200x900",600,1,600,400,"False",624,605,267,-338,338,0
"C12KA",403,566,"1200x900",1000,1,600,400,"True",378,472,504,32,32,1
"C12KA",404,88,"1200x900",600,1,600,400,"False",186,554,283,-271,271,0
"C12KA",405,647,"1200x900",1000,2,600,400,"False",560,637,477,-160,160,0
"C12KA",406,593,"1200x900",1000,2,600,400,"False",246,719,426,-293,293,0
"C12KA",407,408,"1200x900",800,2,600,400,"True",758,567,551,-16,16,0
"C12KA",408,155,"1200x900",600,2,600,400,"False",940,269,367,98,98,0
"C12KA",409,283,"1200x900",800,0,600,400,"True",90,264,230,-34,34,1
"C12KA",410,574,"1200x900",1000,1,600,400,"False",614,194,590,396,396,0
"C12KA",411,417,"1200x900",800,2,600,400,"False",750,280,444,164,164,0
"C12KA",412,413,"1200x900",800,2,600,400,"False",849,506,358,-148,148,0
"C12KA",413,237,"1200x900",800,0,600,400,"True",204,481,483,2,2,1
"C12KA",414,488,"1200x900",1000,0,600,400,"False",129,687,576,-111,111,1
"C12KA",415,483,"1200x900",1000,0,600,400,"False",93,191,356,165,165,1
"C12KA",416,395,"1200x900",800,2,600,400,"False",743,334,581,247,247,0
"C12KA",417,509,"1200x900",1000,1,600,400,"False",509,434,514,80,80,0
"C12KA",418,603,"1200x900",1000,2,600,400,"False",693,280,561,281,281,0
"C12KA",419,37,"1200x900",600,0,600,400,"True",258,403,358,-45,45,1
"C12KA",420,2,"1200x900",600,0,600,400,"True",159,323,291,-32,32,0
"C12KA",421,10,"1200x900",600,0,600,400,"False",400,499,364,-135,135,1
"C12KA",422,637,"1200x900",1000,2,600,400,"False",750,460,328,-132,132,0
"C12KA",423,623,"1200x900",1000,2,600,400,"False",636,527,438,-89,89,0
"C12KA",424,508,"1200x900",1000,1,600,400,"True",596,485,437,-48,48,0
"C12KA",425,270,"1200x900",800,0,600,400,"True",192,418,389,-29,29,1
"C12KA",426,219,"1200x900",800,0,600,400,"False",202,502,410,-92,92,1
"C12KA",427,551,"1200x900",1000,1,600,400,"True",146,445,508,63,63,1
"C12KA",428,255,"1200x900",800,0,600,400,"False",93,709,535,-174,174,1
"C12KA",429,564,"1200x900",1000,1,600,400,"False",215,264,440,176,176,0
"C12KA",430,520,"1200x900",1000,1,600,400,"True",564,260,317,57,57,0
"C12KA",431,612,"1200x900",1000,2,600,400,"True",706,198,257,59,59,0
"C12KA",432,605,"1200x900",1000,2,600,400,"False",493,665,335,-330,330,0
"C12KA",433,312,"1200x900",800,1,600,400,"False",238,683,379,-304,304,0
"C12KA",434,250,"1200x900",800,0,600,400,"False",290,248,328,80,80,1
"C12KA",435,461,"1200x900",1000,0,600,400,"False",95,711,494,-217,217,1
"C12KA",436,351,"1200x900",800,1,600,400,"False",122,581,306,-275,275,0
"C12KA",437,393,"1200x900",800,2,600,400,"False",657,620,442,-178,178,0
"C12KA",438,618,"1200x900",1000,2,600,400,"False",276,671,552,-119,119,0
"C12KA",439,264,"1200x900",800,0,600,400,"True",198,660,636,-24,24,1
"C12KA",440,565,"1200x900",1000,1,600,400,"True",451,562,617,55,55,0
"C12KA",441,41,"1200x900",600,0,600,400,"True",370,452,460,8,8,1
"C12KA",442,75,"1200x900",600,1,600,400,"True",635,558,559,1,1,0
"C12KA",443,610,"1200x900",1000,2,600,400,"False",702,293,690,397,397,0
"C12KA",444,19,"1200x900",600,0,600,400,"False",286,686,557,-129,129,0
"C12KA",445,292,"1200x900",800,1,600,400,"False",88,565,802,237,237,0
"C12KA",446,437,"1200x900",1000,0,600,400,"False",74,667,584,-83,83,1
"C12KA",447,167,"1200x900",600,2,600,400,"False",956,241,350,109,109,0
"C12KA",448,468,"1200x900",1000,0,600,400,"True",121,219,272,53,53,1
"C12KA",449,226,"1200x900",800,0,600,400,"False",187,229,314,85,85,1
"C12KA",450,246,"1200x900",800,0,600,400,"True",196,418,410,-8,8,1
"C12KA",451,581,"1200x900",1000,2,600,400,"False",310,357,527,170,170,0
"C12KA",452,452,"1200x900",1000,0,600,400,"False",97,273,396,123,123,1
"C12KA",453,548,"1200x900",1000,1,600,400,"False",103,278,342,64,64,0
"C12KA",454,475,"1200x900",1000,0,600,400,"False",101,715,577,-138,138,1
"C12KA",455,50,"1200x900",600,0,600,400,"True",75,582,554,-28,28,0
"C12KA",456,328,"1200x900",800,1,600,400,"False",104,649,419,-230,230,0
"C12KA",457,457,"1200x900",1000,0,600,400,"False",97,630,555,-75,75,1
"C12KA",458,174,"1200x900",600,2,600,400,"True",998,457,442,-15,15,0
"C12KA",459,12,"1200x900",600,0,600,400,"True",365,336,337,1,1,1
"C12KA",460,322,"1200x900",800,1,600,400,"False",703,206,300,94,94,1
"C12KA",461,598,"1200x900",1000,2,600,400,"False",706,559,215,-344,344,0
"C12KA",462,176,"1200x900",600,2,600,400,"True",1033,281,326,45,45,0
"C12KA",463,213,"1200x900",600,2,600,400,"False",822,275,368,93,93,0
"C12KA",464,97,"1200x900",600,1,600,400,"False",760,643,282,-361,361,1
"C12KA",465,216,"1200x900",600,2,600,400,"False",1029,286,420,134,134,0
"C12KA",466,602,"1200x900",1000,2,600,400,"False",865,452,331,-121,121,0
"C12KA",467,355,"1200x900",800,1,600,400,"True",77,386,336,-50,50,0
"C12KA",468,300,"1200x900",800,1,600,400,"False",620,693,397,-296,296,0
"C12KA",469,497,"1200x900",1000,0,600,400,"False",106,696,546,-150,150,1
"C12KA",470,52,"1200x900",600,0,600,400,"False",171,188,342,154,154,0
"C12KA",471,601,"1200x900",1000,2,600,400,"False",735,697,470,-227,227,0
"C12KA",472,494,"1200x900",1000,0,600,400,"False",127,692,570,-122,122,1
"C12KA",474,5,"1200x900",600,0,600,400,"True",228,587,546,-41,41,0
"C12KA",475,181,"1200x900",600,2,600,400,"False",1018,223,371,148,148,0
"C12KA",476,175,"1200x900",600,2,600,400,"True",1028,432,456,24,24,0
"C12KA",477,338,"1200x900",800,1,600,400,"False",813,253,340,87,87,1
"C12KA",478,112,"1200x900",600,1,600,400,"True",681,490,548,58,58,0
"C12KA",479,65,"1200x900",600,0,600,400,"False",442,645,462,-183,183,1
"C12KA",480,478,"1200x900",1000,0,600,400,"False",79,672,382,-290,290,1
"C12KA",481,571,"1200x900",1000,1,600,400,"False",239,522,350,-172,172,1
"C12KA",482,80,"1200x900",600,1,600,400,"True",616,423,457,34,34,1
"C12KA",483,333,"1200x900",800,1,600,400,"True",521,548,579,31,31,0
"C12KA",484,299,"1200x900",800,1,600,400,"True",779,274,305,31,31,0
"C12KA",485,335,"1200x900",800,1,600,400,"False",124,360,192,-168,168,0
"C12KA",486,102,"1200x900",600,1,600,400,"False",861,603,293,-310,310,0
"C12KA",487,217,"1200x900",800,0,600,400,"False",85,573,431,-142,142,1
"C12KA",488,460,"1200x900",1000,0,600,400,"False",155,189,356,167,167,1
"C12KA",489,390,"1200x900",800,2,600,400,"False",982,674,289,-385,385,1
"C12KA",492,192,"1200x900",600,2,600,400,"True",1064,320,365,45,45,0
"C12KA",493,472,"1200x900",1000,0,600,400,"False",77,685,408,-277,277,1
"C12KA",494,621,"1200x900",1000,2,600,400,"True",540,478,525,47,47,0
"C12KA",495,450,"1200x900",1000,0,600,400,"True",130,204,263,59,59,1
"C12KA",496,248,"1200x900",800,0,600,400,"True",94,240,176,-64,64,1
"C12KA",497,375,"1200x900",800,2,600,400,"True",716,384,371,-13,13,0
"C12KA",498,519,"1200x900",1000,1,600,400,"False",319,565,660,95,95,1
"C12KA",499,436,"1200x900",1000,0,600,400,"False",82,617,417,-200,200,1
"C12KA",500,256,"1200x900",800,0,600,400,"True",192,656,711,55,55,1
"C12KA",501,131,"1200x900",600,1,600,400,"True",531,367,332,-35,35,0
"C12KA",502,171,"1200x900",600,2,600,400,"False",909,200,470,270,270,0
"C12KA",503,386,"1200x900",800,2,600,400,"False",774,301,617,316,316,0
"C12KA",504,486,"1200x900",1000,0,600,400,"False",102,676,450,-226,226,1
"C12KA",505,369,"1200x900",800,2,600,400,"False",903,594,231,-363,363,0
"C12KA",506,506,"1200x900",1000,1,600,400,"False",559,567,490,-77,77,1
"C12KA",507,642,"1200x900",1000,2,600,400,"True",776,316,322,6,6,0
"C12KA",508,622,"1200x900",1000,2,600,400,"False",307,683,496,-187,187,0
"C12KA",509,532,"1200x900",1000,1,600,400,"False",215,207,284,77,77,0
"C12KA",510,123,"1200x900",600,1,600,400,"False",761,365,498,133,133,1
"C12KA",511,168,"1200x900",600,2,600,400,"False",1001,439,268,-171,171,0
"C12KA",512,549,"1200x900",1000,1,600,400,"False",657,366,459,93,93,0
"C12KA",513,442,"1200x900",1000,0,600,400,"False",87,183,423,240,240,1
"C12KA",514,561,"1200x900",1000,1,600,400,"False",231,406,174,-232,232,0
"C12KA",515,368,"1200x900",800,2,600,400,"False",778,515,363,-152,152,0
"C12KA",516,136,"1200x900",600,1,600,400,"False",264,205,465,260,260,0
"C12KA",517,291,"1200x900",800,1,600,400,"False",522,694,227,-467,467,0
"C12KA",518,275,"1200x900",800,0,600,400,"False",120,594,421,-173,173,0
"C12KA",519,632,"1200x900",1000,2,600,400,"True",984,227,181,-46,46,0
"C12KA",520,469,"1200x900",1000,0,600,400,"True",73,227,287,60,60,1
"C12KA",521,599,"1200x900",1000,2,600,400,"False",316,570,190,-380,380,0
"C12KA",522,367,"1200x900",800,2,600,400,"False",613,464,312,-152,152,0
"C12KA",523,541,"1200x900",1000,1,600,400,"True",339,478,417,-61,61,0
"C12KA",524,529,"1200x900",1000,1,600,400,"False",267,412,598,186,186,1
"C12KA",525,9,"1200x900",600,0,600,400,"False",509,654,510,-144,144,1
"C12KA",526,69,"1200x900",600,0,600,400,"True",322,268,304,36,36,0
"C12KA",527,25,"1200x900",600,0,600,400,"True",263,403,379,-24,24,1
"C12KA",528,332,"1200x900",800,1,600,400,"True",260,699,743,44,44,0
"C12KA",529,103,"1200x900",600,1,600,400,"False",528,320,442,122,122,1
"C12KA",530,645,"1200x900",1000,2,600,400,"False",619,396,555,159,159,0
"C12KA",531,376,"1200x900",800,2,600,400,"False",788,275,382,107,107,0
"C12KA",532,310,"1200x900",800,1,600,400,"False",559,592,303,-289,289,0
"C12KA",533,629,"1200x900",1000,2,600,400,"False",681,257,432,175,175,0
"C12KA",534,331,"1200x900",800,1,600,400,"False",240,620,695,75,75,0
"C12KA",535,259,"1200x900",800,0,600,400,"False",156,180,268,88,88,1
"C12KA",536,471,"1200x900",1000,0,600,400,"True",122,200,214,14,14,1
"C12KA",537,492,"1200x900",1000,0,600,400,"False",76,692,481,-211,211,1
"C12KA",538,268,"1200x900",800,0,600,400,"True",148,400,351,-49,49,1
"C12KA",539,184,"1200x900",600,2,600,400,"False",1067,441,271,-170,170,0
"C12KA",540,35,"1200x900",600,0,600,400,"True",366,555,571,16,16,1
"C12KA",541,269,"1200x900",800,0,600,400,"False",160,295,372,77,77,1
"C12KA",542,260,"1200x900",800,0,600,400,"True",103,525,553,28,28,1
"C12KA",543,190,"1200x900",600,2,600,400,"False",977,238,656,418,418,0
"C12KA",544,279,"1200x900",800,0,600,400,"True",252,202,231,29,29,1
"C12KA",545,22,"1200x900",600,0,600,400,"True",398,591,529,-62,62,1
"C12KA",546,496,"1200x900",1000,0,600,400,"True",70,639,620,-19,19,1
"C12KA",547,634,"1200x900",1000,2,600,400,"False",735,313,472,159,159,0
"C12KA",548,416,"1200x900",800,2,600,400,"True",748,617,671,54,54,0
"C12KA",549,187,"1200x900",600,2,600,400,"False",857,639,341,-298,298,0
"C12KA",550,30,"1200x900",600,0,600,400,"True",107,353,413,60,60,0
"C12KA",551,366,"1200x900",800,2,600,400,"True",931,464,543,79,79,0
"C12KA",552,241,"1200x900",800,0,600,400,"True",129,227,266,39,39,1
"C12KA",553,439,"1200x900",1000,0,600,400,"False",110,229,126,-103,103,1
"C12KA",554,410,"1200x900",800,2,600,400,"True",916,477,433,-44,44,0
"C12KA",555,44,"1200x900",600,0,600,400,"True",305,554,558,4,4,1
"C12KA",556,514,"1200x900",1000,1,600,400,"False",539,690,206,-484,484,0
"C12KA",557,7,"1200x900",600,0,600,400,"True",431,654,691,37,37,1
"C12KA",558,206,"1200x900",600,2,600,400,"True",975,223,168,-55,55,0
"C12KA",559,404,"1200x900",800,2,600,400,"True",842,396,454,58,58,0
"C12KA",560,198,"1200x900",600,2,600,400,"False",976,500,227,-273,273,0
"C12KA",561,575,"1200x900",1000,1,600,400,"False",272,693,541,-152,152,0
"C12KA",562,281,"1200x900",800,0,600,400,"True",112,611,672,61,61,1
"C12KA",563,427,"1200x900",800,2,600,400,"False",812,380,162,-218,218,0
"C12KA",564,298,"1200x900",800,1,600,400,"False",311,457,610,153,153,0
"C12KA",565,141,"1200x900",600,1,600,400,"False",671,582,421,-161,161,0
"C12KA",566,185,"1200x900",600,2,600,400,"False",907,212,540,328,328,0
"C12KA",567,363,"1200x900",800,2,600,400,"True",800,218,294,76,76,0
"C12KA",568,484,"1200x900",1000,0,600,400,"True",100,223,158,-65,65,1
"C12KA",569,535,"1200x900",1000,1,600,400,"False",372,410,594,184,184,0
"C12KA",570,172,"1200x900",600,2,600,400,"True",912,444,465,21,21,0
"C12KA",571,512,"1200x900",1000,1,600,400,"False",139,261,330,69,69,0
"C12KA",572,476,"1200x900",1000,0,600,400,"False",76,359,279,-80,80,1
"C12KA",573,230,"1200x900",800,0,600,400,"False",99,678,587,-91,91,1
"C12KA",574,261,"1200x900",800,0,600,400,"True",86,713,678,-35,35,1
"C12KA",575,640,"1200x900",1000,2,600,400,"False",361,334,717,383,383,0
"C12KA",576,286,"1200x900",800,0,600,400,"True",105,378,307,-71,71,1
"C12KA",577,303,"1200x900",800,1,600,400,"True",241,431,462,31,31,0
"C12KA",578,617,"1200x900",1000,2,600,400,"False",294,180,572,392,392,0
"C12KA",579,323,"1200x900",800,1,600,400,"False",388,348,227,-121,121,0
"C12KA",580,208,"1200x900",600,2,600,400,"True",946,399,331,-68,68,0
"C12KA",581,530,"1200x900",1000,1,600,400,"False",584,405,190,-215,215,1
"C12KA",582,272,"1200x900",800,0,600,400,"False",200,181,275,94,94,1
"C12KA",583,228,"1200x900",800,0,600,400,"False",174,687,565,-122,122,1
"C12KA",584,160,"1200x900",600,2,600,400,"False",863,606,402,-204,204,0
"C12KA",586,563,"1200x900",1000,1,600,400,"True",201,696,635,-61,61,0
"C12KA",587,630,"1200x900",1000,2,600,400,"False",754,559,341,-218,218,0
"C12KA",588,320,"1200x900",800,1,600,400,"False",644,376,456,80,80,0
"C12KA",589,128,"1200x900",600,1,600,400,"True",661,258,268,10,10,1
"C12KA",590,412,"1200x900",800,2,600,400,"False",842,280,462,182,182,0
"C12KA",591,392,"1200x900",800,2,600,400,"False",1031,618,353,-265,265,0
"C12KA",592,619,"1200x900",1000,2,600,400,"True",803,247,252,5,5,0
"C12KA",593,431,"1200x900",800,2,600,400,"False",694,382,158,-224,224,0
"C12KA",594,142,"1200x900",600,1,600,400,"False",286,474,350,-124,124,0
"C12KA",595,382,"1200x900",800,2,600,400,"False",870,523,642,119,119,0
"C12KA",596,536,"1200x900",1000,1,600,400,"False",580,213,320,107,107,0
"C12KA",597,267,"1200x900",800,0,600,400,"False",145,665,592,-73,73,1
"C12KA",598,254,"1200x900",800,0,600,400,"True",136,583,653,70,70,1
"C12KA",599,148,"1200x900",600,2,600,400,"False",907,330,545,215,215,0
"C12KA",600,34,"1200x900",600,0,600,400,"True",361,242,298,56,56,1
"C12KA",601,189,"1200x900",600,2,600,400,"False",881,397,557,160,160,0
"C12KA",602,277,"1200x900",800,0,600,400,"True",140,310,268,-42,42,1
"C12KA",603,383,"1200x900",800,2,600,400,"False",855,407,251,-156,156,0
"C12KA",604,554,"1200x900",1000,1,600,400,"False",79,309,183,-126,126,1
"C12KA",605,124,"1200x900",600,1,600,400,"True",345,467,443,-24,24,0
"C12KA",606,407,"1200x900",800,2,600,400,"False",989,340,262,-78,78,0
"C12KA",607,39,"1200x900",600,0,600,400,"False",210,609,424,-185,185,0
"C12KA",608,51,"1200x900",600,0,600,400,"True",272,181,171,-10,10,1
"C12KA",609,540,"1200x900",1000,1,600,400,"False",389,568,341,-227,227,1
"C12KA",610,113,"1200x900",600,1,600,400,"False",897,657,243,-414,414,0
"C12KA",611,339,"1200x900",800,1,600,400,"False",273,545,444,-101,101,1
"C12KA",612,526,"1200x900",1000,1,600,400,"True",497,710,758,48,48,0
"C12KA",613,8,"1200x900",600,0,600,400,"False",156,679,747,68,68,0
"C12KA",614,600,"1200x900",1000,2,600,400,"False",765,207,504,297,297,0
"C12KA",615,317,"1200x900",800,1,600,400,"False",185,564,329,-235,235,0
"C12KA",616,314,"1200x900",800,1,600,400,"False",277,616,514,-102,102,1
"C12KA",617,572,"1200x900",1000,1,600,400,"False",302,260,489,229,229,0
"C12KA",618,163,"1200x900",600,2,600,400,"False",1046,665,335,-330,330,0
"C12KA",619,129,"1200x900",600,1,600,400,"True",859,482,535,53,53,1
"C12KA",620,197,"1200x900",600,2,600,400,"False",903,212,565,353,353,0
"C12KA",621,434,"1200x900",1000,0,600,400,"False",89,657,334,-323,323,1
"C12KA",622,49,"1200x900",600,0,600,400,"True",109,380,432,52,52,0
"C12KA",623,139,"1200x900",600,1,600,400,"False",192,695,328,-367,367,0
"C12KA",624,537,"1200x900",1000,1,600,400,"False",621,412,696,284,284,1
"C12KA",625,238,"1200x900",800,0,600,400,"True",162,283,330,47,47,1
"C12KA",626,547,"1200x900",1000,1,600,400,"False",369,384,593,209,209,1
"C12KA",627,280,"1200x900",800,0,600,400,"True",104,302,264,-38,38,1
"C12KA",628,364,"1200x900",800,2,600,400,"True",1018,204,250,46,46,0
"C12KA",629,401,"1200x900",800,2,600,400,"False",821,260,356,96,96,0
"C12KA",630,257,"1200x900",800,0,600,400,"True",97,219,168,-51,51,1
"C12KA",631,611,"1200x900",1000,2,600,400,"True",414,511,513,2,2,0
"C12KA",632,273,"1200x900",800,0,600,400,"True",180,309,231,-78,78,1
"C12KA",633,377,"1200x900",800,2,600,400,"False",683,388,530,142,142,0
"C12KA",634,263,"1200x900",800,0,600,400,"True",82,396,420,24,24,1
"C12KA",635,409,"1200x900",800,2,600,400,"False",501,659,285,-374,374,0
"C12KA",636,319,"1200x900",800,1,600,400,"True",494,587,630,43,43,1
"C12KA",637,164,"1200x900",600,2,600,400,"True",1051,268,312,44,44,0
"C12KA",638,628,"1200x900",1000,2,600,400,"True",768,410,484,74,74,0
"C12KA",639,231,"1200x900",800,0,600,400,"False",251,718,577,-141,141,1
"C12KA",640,348,"1200x900",800,1,600,400,"True",764,294,262,-32,32,0
"C12KA",641,499,"1200x900",1000,0,600,400,"True",93,271,228,-43,43,1
"C12KA",642,482,"1200x900",1000,0,600,400,"False",79,686,499,-187,187,1
"C12KA",643,232,"1200x900",800,0,600,400,"True",84,511,581,70,70,1
"C12KA",644,419,"1200x900",800,2,600,400,"False",769,351,126,-225,225,0
"C12KA",645,306,"1200x900",800,1,600,400,"False",164,524,756,232,232,0
"C12KA",646,159,"1200x900",600,2,600,400,"False",992,309,542,233,233,0
"C12KA",647,173,"1200x900",600,2,600,400,"False",948,693,320,-373,373,0
"C12KA",648,137,"1200x900",600,1,600,400,"False",789,577,500,-77,77,0
"C13LD",1,302,"1200x900",800,1,600,400,"True",479,467,453,-14,14,1
"C13LD",2,397,"1200x900",800,2,600,400,"True",817,692,615,-77,77,0
"C13LD",3,482,"1200x900",1000,0,600,400,"False",79,686,507,-179,179,1
"C13LD",4,300,"1200x900",800,1,600,400,"True",620,693,648,-45,45,0
"C13LD",5,447,"1200x900",1000,0,600,400,"True",71,339,393,54,54,1
"C13LD",6,26,"1200x900",600,0,600,400,"False",70,712,640,-72,72,0
"C13LD",7,377,"1200x900",800,2,600,400,"True",683,388,397,9,9,0
"C13LD",8,137,"1200x900",600,1,600,400,"True",789,577,544,-33,33,0
"C13LD",9,502,"1200x900",1000,0,600,400,"True",111,639,586,-53,53,1
"C13LD",10,182,"1200x900",600,2,600,400,"False",933,389,224,-165,165,0
"C13LD",11,233,"1200x900",800,0,600,400,"False",164,700,498,-202,202,1
"C13LD",12,279,"1200x900",800,0,600,400,"False",252,202,395,193,193,1
"C13LD",13,439,"1200x900",1000,0,600,400,"True",110,229,282,53,53,1
"C13LD",14,637,"1200x900",1000,2,600,400,"False",750,460,599,139,139,0
"C13LD",15,183,"1200x900",600,2,600,400,"True",927,289,312,23,23,0
"C13LD",16,2,"1200x900",600,0,600,400,"True",159,323,346,23,23,0
"C13LD",17,214,"1200x900",600,2,600,400,"False",1046,305,178,-127,127,0
"C13LD",18,484,"1200x900",1000,0,600,400,"False",100,223,292,69,69,1
"C13LD",19,196,"1200x900",600,2,600,400,"False",1030,397,147,-250,250,0
"C13LD",20,108,"1200x900",600,1,600,400,"True",830,239,245,6,6,0
"C13LD",21,303,"1200x900",800,1,600,400,"True",241,431,451,20,20,0
"C13LD",22,621,"1200x900",1000,2,600,400,"False",540,478,362,-116,116,0
"C13LD",23,96,"1200x900",600,1,600,400,"False",433,458,357,-101,101,0
"C13LD",24,63,"1200x900",600,0,600,400,"True",311,188,156,-32,32,1
"C13LD",25,225,"1200x900",800,0,600,400,"True",178,423,414,-9,9,1
"C13LD",26,515,"1200x900",1000,1,600,400,"True",307,217,256,39,39,0
"C13LD",27,12,"1200x900",600,0,600,400,"True",365,336,283,-53,53,1
"C13LD",28,136,"1200x900",600,1,600,400,"False",264,205,373,168,168,0
"C13LD",29,327,"1200x900",800,1,600,400,"False",152,339,507,168,168,0
"C13LD",30,418,"1200x900",800,2,600,400,"False",754,507,390,-117,117,0
"C13LD",31,121,"1200x900",600,1,600,400,"True",884,364,307,-57,57,0
"C13LD",32,328,"1200x900",800,1,600,400,"False",104,649,430,-219,219,0
"C13LD",33,471,"1200x900",1000,0,600,400,"False",122,200,374,174,174,1
"C13LD",34,257,"1200x900",800,0,600,400,"True",97,219,213,-6,6,1
"C13LD",35,629,"1200x900",1000,2,600,400,"False",681,257,450,193,193,0
"C13LD",36,140,"1200x900",600,1,600,400,"True",700,523,501,-22,22,0
"C13LD",37,353,"1200x900",800,1,600,400,"False",90,476,717,241,241,0
"C13LD",38,258,"1200x900",800,0,600,400,"False",126,664,536,-128,128,1
"C13LD",39,550,"1200x900",1000,1,600,400,"True",301,459,399,-60,60,0
"C13LD",40,609,"1200x900",1000,2,600,400,"False",697,627,768,141,141,0
"C13LD",41,349,"1200x900",800,1,600,400,"False",402,665,735,70,70,0
"C13LD",42,435,"1200x900",1000,0,600,400,"False",119,200,475,275,275,1
"C13LD",43,344,"1200x900",800,1,600,400,"False",589,408,538,130,130,0
"C13LD",44,289,"1200x900",800,1,600,400,"False",421,703,433,-270,270,1
"C13LD",45,636,"1200x900",1000,2,600,400,"False",575,583,686,103,103,0
"C13LD",46,209,"1200x900",600,2,600,400,"True",937,637,649,12,12,0
"C13LD",47,339,"1200x900",800,1,600,400,"True",273,545,578,33,33,1
"C13LD",48,101,"1200x900",600,1,600,400,"False",541,656,427,-229,229,0
"C13LD",49,310,"1200x900",800,1,600,400,"True",559,592,562,-30,30,0
"C13LD",50,335,"1200x900",800,1,600,400,"False",124,360,499,139,139,0
"C13LD",52,411,"1200x900",800,2,600,400,"False",805,361,263,-98,98,0
"C13LD",53,61,"1200x900",600,0,600,400,"False",272,670,522,-148,148,1
"C13LD",54,348,"1200x900",800,1,600,400,"False",764,294,376,82,82,0
"C13LD",55,580,"1200x900",1000,2,600,400,"False",651,267,435,168,168,0
"C13LD",56,323,"1200x900",800,1,600,400,"False",388,348,454,106,106,0
"C13LD",57,81,"1200x900",600,1,600,400,"True",696,225,292,67,67,0
"C13LD",58,211,"1200x900",600,2,600,400,"True",986,407,433,26,26,0
"C13LD",59,586,"1200x900",1000,2,600,400,"False",802,262,529,267,267,0
"C13LD",60,499,"1200x900",1000,0,600,400,"False",93,271,487,216,216,1
"C13LD",61,623,"1200x900",1000,2,600,400,"False",636,527,330,-197,197,0
"C13LD",62,188,"1200x900",600,2,600,400,"True",900,195,271,76,76,0
"C13LD",63,522,"1200x900",1000,1,600,400,"True",223,379,393,14,14,0
"C13LD",64,205,"1200x900",600,2,600,400,"True",1021,504,459,-45,45,0
"C13LD",65,620,"1200x900",1000,2,600,400,"False",832,649,425,-224,224,0
"C13LD",66,332,"1200x900",800,1,600,400,"False",260,699,586,-113,113,0
"C13LD",67,589,"1200x900",1000,2,600,400,"False",856,418,720,302,302,0
"C13LD",68,230,"1200x900",800,0,600,400,"False",99,678,604,-74,74,1
"C13LD",69,480,"1200x900",1000,0,600,400,"False",100,231,492,261,261,1
"C13LD",70,161,"1200x900",600,2,600,400,"True",939,553,561,8,8,0
"C13LD",71,4,"1200x900",600,0,600,400,"False",602,200,361,161,161,1
"C13LD",72,65,"1200x900",600,0,600,400,"True",442,645,635,-10,10,1
"C13LD",73,312,"1200x900",800,1,600,400,"False",238,683,749,66,66,0
"C13LD",74,288,"1200x900",800,0,600,400,"False",180,547,630,83,83,1
"C13LD",75,459,"1200x900",1000,0,600,400,"False",70,645,355,-290,290,1
"C13LD",76,419,"1200x900",800,2,600,400,"True",769,351,321,-30,30,0
"C13LD",77,301,"1200x900",800,1,600,400,"False",162,574,482,-92,92,0
"C13LD",78,127,"1200x900",600,1,600,400,"True",309,691,668,-23,23,0
"C13LD",79,541,"1200x900",1000,1,600,400,"True",339,478,471,-7,7,0
"C13LD",80,55,"1200x900",600,0,600,400,"True",211,305,261,-44,44,1
"C13LD",81,356,"1200x900",800,1,600,400,"False",123,484,581,97,97,0
"C13LD",82,153,"1200x900",600,2,600,400,"False",1037,601,743,142,142,0
"C13LD",83,379,"1200x900",800,2,600,400,"False",994,325,530,205,205,0
"C13LD",84,523,"1200x900",1000,1,600,400,"False",339,318,459,141,141,0
"C13LD",85,364,"1200x900",800,2,600,400,"False",1018,204,390,186,186,0
"C13LD",86,291,"1200x900",800,1,600,400,"False",522,694,537,-157,157,0
"C13LD",87,395,"1200x900",800,2,600,400,"False",743,334,246,-88,88,0
"C13LD",88,119,"1200x900",600,1,600,400,"False",168,563,441,-122,122,0
"C13LD",89,608,"1200x900",1000,2,600,400,"False",742,250,472,222,222,0
"C13LD",90,445,"1200x900",1000,0,600,400,"True",78,302,292,-10,10,1
"C13LD",91,110,"1200x900",600,1,600,400,"True",776,550,494,-56,56,1
"C13LD",92,322,"1200x900",800,1,600,400,"False",703,206,314,108,108,1
"C13LD",93,635,"1200x900",1000,2,600,400,"False",833,402,187,-215,215,0
"C13LD",94,118,"1200x900",600,1,600,400,"False",190,588,439,-149,149,0
"C13LD",95,384,"1200x900",800,2,600,400,"False",821,707,616,-91,91,0
"C13LD",96,342,"1200x900",800,1,600,400,"False",677,204,380,176,176,0
"C13LD",97,114,"1200x900",600,1,600,400,"False",183,697,444,-253,253,0
"C13LD",98,351,"1200x900",800,1,600,400,"True",122,581,556,-25,25,0
"C13LD",99,495,"1200x900",1000,0,600,400,"True",93,692,646,-46,46,1
"C13LD",100,219,"1200x900",800,0,600,400,"True",202,502,540,38,38,1
"C13LD",101,476,"1200x900",1000,0,600,400,"False",76,359,427,68,68,1
"C13LD",102,157,"1200x900",600,2,600,400,"True",1016,323,372,49,49,0
"C13LD",104,567,"1200x900",1000,1,600,400,"True",655,297,400,103,103,1
"C13LD",105,309,"1200x900",800,1,600,400,"False",186,225,418,193,193,0
"C13LD",106,53,"1200x900",600,0,600,400,"True",177,189,175,-14,14,0
"C13LD",107,57,"1200x900",600,0,600,400,"False",354,508,411,-97,97,1
"C13LD",108,591,"1200x900",1000,2,600,400,"False",698,336,482,146,146,0
"C13LD",109,438,"1200x900",1000,0,600,400,"True",77,713,716,3,3,1
"C13LD",110,392,"1200x900",800,2,600,400,"False",1031,618,380,-238,238,0
"C13LD",111,69,"1200x900",600,0,600,400,"True",322,268,212,-56,56,0
"C13LD",112,626,"1200x900",1000,2,600,400,"False",329,449,359,-90,90,0
"C13LD",113,558,"1200x900",1000,1,600,400,"True",72,464,531,67,67,1
"C13LD",114,367,"1200x900",800,2,600,400,"False",613,464,373,-91,91,0
"C13LD",115,122,"1200x900",600,1,600,400,"True",817,709,658,-51,51,0
"C13LD",116,102,"1200x900",600,1,600,400,"False",861,603,754,151,151,0
"C13LD",117,383,"1200x900",800,2,600,400,"True",855,407,467,60,60,0
"C13LD",118,406,"1200x900",800,2,600,400,"False",971,233,325,92,92,0
"C13LD",119,180,"1200x900",600,2,600,400,"False",929,270,122,-148,148,0
"C13LD",120,33,"1200x900",600,0,600,400,"True",198,533,542,9,9,1
"C13LD",121,417,"1200x900",800,2,600,400,"False",750,280,353,73,73,0
"C13LD",122,247,"1200x900",800,0,600,400,"False",160,424,552,128,128,1
"C13LD",123,84,"1200x900",600,1,600,400,"False",144,184,587,403,403,0
"C13LD",124,281,"1200x900",800,0,600,400,"True",112,611,631,20,20,1
"C13LD",125,464,"1200x900",1000,0,600,400,"False",82,222,311,89,89,1
"C13LD",126,551,"1200x900",1000,1,600,400,"False",146,445,631,186,186,1
"C13LD",127,520,"1200x900",1000,1,600,400,"True",564,260,304,44,44,0
"C13LD",128,111,"1200x900",600,1,600,400,"False",922,552,709,157,157,1
"C13LD",129,594,"1200x900",1000,2,600,400,"True",537,637,653,16,16,0
"C13LD",130,239,"1200x900",800,0,600,400,"True",114,231,232,1,1,1
"C13LD",131,577,"1200x900",1000,2,600,400,"True",455,420,436,16,16,0
"C13LD",133,440,"1200x900",1000,0,600,400,"True",71,237,248,11,11,1
"C13LD",134,276,"1200x900",800,0,600,400,"False",281,217,112,-105,105,1
"C13LD",135,117,"1200x900",600,1,600,400,"False",711,456,667,211,211,0
"C13LD",136,350,"1200x900",800,1,600,400,"True",182,566,612,46,46,0
"C13LD",137,254,"1200x900",800,0,600,400,"False",136,583,757,174,174,1
"C13LD",138,88,"1200x900",600,1,600,400,"False",186,554,425,-129,129,0
"C13LD",139,155,"1200x900",600,2,600,400,"False",940,269,700,431,431,0
"C13LD",140,393,"1200x900",800,2,600,400,"False",657,620,476,-144,144,0
"C13LD",141,533,"1200x900",1000,1,600,400,"True",355,483,418,-65,65,0
"C13LD",143,600,"1200x900",1000,2,600,400,"False",765,207,623,416,416,0
"C13LD",144,481,"1200x900",1000,0,600,400,"True",80,185,210,25,25,1
"C13LD",145,399,"1200x900",800,2,600,400,"False",603,602,467,-135,135,0
"C13LD",146,603,"1200x900",1000,2,600,400,"False",693,280,502,222,222,0
"C13LD",147,573,"1200x900",1000,1,600,400,"False",486,615,509,-106,106,0
"C13LD",148,574,"1200x900",1000,1,600,400,"False",614,194,368,174,174,0
"C13LD",149,130,"1200x900",600,1,600,400,"True",741,428,493,65,65,0
"C13LD",150,156,"1200x900",600,2,600,400,"False",913,197,460,263,263,0
"C13LD",151,508,"1200x900",1000,1,600,400,"True",596,485,446,-39,39,0
"C13LD",152,568,"1200x900",1000,1,600,400,"False",286,475,636,161,161,1
"C13LD",153,504,"1200x900",1000,0,600,400,"True",107,699,698,-1,1,1
"C13LD",154,346,"1200x900",800,1,600,400,"False",269,635,709,74,74,0
"C13LD",155,89,"1200x900",600,1,600,400,"False",917,366,550,184,184,1
"C13LD",156,178,"1200x900",600,2,600,400,"True",1041,510,410,-100,100,0
"C13LD",157,604,"1200x900",1000,2,600,400,"True",459,593,559,-34,34,0
"C13LD",158,366,"1200x900",800,2,600,400,"True",931,464,530,66,66,0
"C13LD",159,58,"1200x900",600,0,600,400,"False",353,655,499,-156,156,1
"C13LD",160,259,"1200x900",800,0,600,400,"True",156,180,137,-43,43,1
"C13LD",161,581,"1200x900",1000,2,600,400,"True",310,357,297,-60,60,0
"C13LD",162,546,"1200x900",1000,1,600,400,"True",305,374,374,0,0,0
"C13LD",164,263,"1200x900",800,0,600,400,"False",82,396,525,129,129,1
"C13LD",165,376,"1200x900",800,2,600,400,"True",788,275,229,-46,46,0
"C13LD",166,390,"1200x900",800,2,600,400,"True",982,674,612,-62,62,1
"C13LD",167,256,"1200x900",800,0,600,400,"False",192,656,761,105,105,1
"C13LD",168,510,"1200x900",1000,1,600,400,"False",486,338,217,-121,121,1
"C13LD",169,245,"1200x900",800,0,600,400,"False",296,235,467,232,232,1
"C13LD",170,424,"1200x900",800,2,600,400,"False",903,545,408,-137,137,0
"C13LD",171,478,"1200x900",1000,0,600,400,"True",79,672,692,20,20,1
"C13LD",172,262,"1200x900",800,0,600,400,"True",196,481,541,60,60,1
"C13LD",173,511,"1200x900",1000,1,600,400,"False",408,390,488,98,98,1
"C13LD",174,107,"1200x900",600,1,600,400,"True",878,678,659,-19,19,0
"C13LD",175,197,"1200x900",600,2,600,400,"False",903,212,589,377,377,0
"C13LD",176,420,"1200x900",800,2,600,400,"False",519,223,363,140,140,0
"C13LD",177,27,"1200x900",600,0,600,400,"False",373,309,208,-101,101,1
"C13LD",178,648,"1200x900",1000,2,600,400,"True",557,394,353,-41,41,0
"C13LD",179,432,"1200x900",800,2,600,400,"False",792,380,243,-137,137,0
"C13LD",180,125,"1200x900",600,1,600,400,"True",750,531,520,-11,11,0
"C13LD",181,455,"1200x900",1000,0,600,400,"False",107,718,610,-108,108,1
"C13LD",182,490,"1200x900",1000,0,600,400,"False",114,183,268,85,85,1
"C13LD",183,147,"1200x900",600,2,600,400,"False",942,418,556,138,138,0
"C13LD",184,465,"1200x900",1000,0,600,400,"True",85,203,208,5,5,1
"C13LD",185,73,"1200x900",600,1,600,400,"False",94,665,427,-238,238,0
"C13LD",186,612,"1200x900",1000,2,600,400,"False",706,198,103,-95,95,0
"C13LD",187,282,"1200x900",800,0,600,400,"True",109,246,239,-7,7,1
"C13LD",188,408,"1200x900",800,2,600,400,"False",758,567,479,-88,88,0
"C13LD",189,104,"1200x900",600,1,600,400,"False",448,584,412,-172,172,0
"C13LD",190,501,"1200x900",1000,0,600,400,"True",96,323,251,-72,72,1
"C13LD",191,133,"1200x900",600,1,600,400,"True",345,551,582,31,31,0
"C13LD",192,640,"1200x900",1000,2,600,400,"True",361,334,282,-52,52,0
"C13LD",193,578,"1200x900",1000,2,600,400,"False",966,276,489,213,213,0
"C13LD",194,494,"1200x900",1000,0,600,400,"True",127,692,650,-42,42,1
"C13LD",195,442,"1200x900",1000,0,600,400,"False",87,183,312,129,129,1
"C13LD",196,50,"1200x900",600,0,600,400,"True",75,582,540,-42,42,0
"C13LD",197,601,"1200x900",1000,2,600,400,"False",735,697,526,-171,171,0
"C13LD",198,199,"1200x900",600,2,600,400,"True",992,467,528,61,61,0
"C13LD",199,283,"1200x900",800,0,600,400,"True",90,264,261,-3,3,1
"C13LD",200,229,"1200x900",800,0,600,400,"True",117,697,763,66,66,1
"C13LD",201,330,"1200x900",800,1,600,400,"True",759,301,305,4,4,1
"C13LD",202,556,"1200x900",1000,1,600,400,"False",415,420,507,87,87,0
"C13LD",203,177,"1200x900",600,2,600,400,"True",912,236,345,109,109,0
"C13LD",204,565,"1200x900",1000,1,600,400,"True",451,562,630,68,68,0
"C13LD",205,345,"1200x900",800,1,600,400,"False",841,566,850,284,284,1
"C13LD",206,563,"1200x900",1000,1,600,400,"True",201,696,681,-15,15,0
"C13LD",207,545,"1200x900",1000,1,600,400,"True",358,562,505,-57,57,0
"C13LD",208,524,"1200x900",1000,1,600,400,"False",534,470,543,73,73,0
"C13LD",209,560,"1200x900",1000,1,600,400,"False",516,693,586,-107,107,0
"C13LD",210,547,"1200x900",1000,1,600,400,"False",369,384,525,141,141,1
"C13LD",211,394,"1200x900",800,2,600,400,"False",847,292,422,130,130,0
"C13LD",212,32,"1200x900",600,0,600,400,"True",152,563,625,62,62,1
"C13LD",213,193,"1200x900",600,2,600,400,"False",874,588,487,-101,101,0
"C13LD",214,70,"1200x900",600,0,600,400,"False",309,703,631,-72,72,1
"C13LD",215,191,"1200x900",600,2,600,400,"True",962,396,453,57,57,0
"C13LD",216,123,"1200x900",600,1,600,400,"False",761,365,507,142,142,1
"C13LD",217,446,"1200x900",1000,0,600,400,"True",72,298,359,61,61,1
"C13LD",218,542,"1200x900",1000,1,600,400,"True",304,401,425,24,24,0
"C13LD",219,410,"1200x900",800,2,600,400,"True",916,477,547,70,70,0
"C13LD",220,272,"1200x900",800,0,600,400,"False",200,181,270,89,89,1
"C13LD",221,443,"1200x900",1000,0,600,400,"False",99,651,436,-215,215,1
"C13LD",222,296,"1200x900",800,1,600,400,"False",89,279,574,295,295,0
"C13LD",223,224,"1200x900",800,0,600,400,"False",161,474,401,-73,73,1
"C13LD",224,141,"1200x900",600,1,600,400,"True",671,582,634,52,52,0
"C13LD",225,486,"1200x900",1000,0,600,400,"True",102,676,702,26,26,1
"C13LD",226,112,"1200x900",600,1,600,400,"True",681,490,504,14,14,0
"C13LD",227,569,"1200x900",1000,1,600,400,"False",494,720,503,-217,217,0
"C13LD",228,195,"1200x900",600,2,600,400,"False",942,249,513,264,264,0
"C13LD",229,251,"1200x900",800,0,600,400,"False",88,352,433,81,81,1
"C13LD",230,614,"1200x900",1000,2,600,400,"True",823,563,550,-13,13,0
"C13LD",231,479,"1200x900",1000,0,600,400,"True",74,705,730,25,25,1
"C13LD",232,610,"1200x900",1000,2,600,400,"False",702,293,430,137,137,0
"C13LD",233,400,"1200x900",800,2,600,400,"True",733,297,380,83,83,0
"C13LD",234,506,"1200x900",1000,1,600,400,"False",559,567,490,-77,77,1
"C13LD",235,317,"1200x900",800,1,600,400,"False",185,564,426,-138,138,0
"C13LD",236,557,"1200x900",1000,1,600,400,"True",677,505,496,-9,9,1
"C13LD",237,487,"1200x900",1000,0,600,400,"True",78,670,683,13,13,1
"C13LD",238,212,"1200x900",600,2,600,400,"False",841,206,557,351,351,0
"C13LD",239,412,"1200x900",800,2,600,400,"False",842,280,450,170,170,0
"C13LD",240,644,"1200x900",1000,2,600,400,"False",495,486,287,-199,199,0
"C13LD",241,167,"1200x900",600,2,600,400,"False",956,241,518,277,277,0
"C13LD",242,181,"1200x900",600,2,600,400,"True",1018,223,381,158,158,0
"C13LD",243,627,"1200x900",1000,2,600,400,"True",760,510,443,-67,67,0
"C13LD",244,584,"1200x900",1000,2,600,400,"True",731,413,392,-21,21,0
"C13LD",246,454,"1200x900",1000,0,600,400,"False",78,687,585,-102,102,1
"C13LD",247,427,"1200x900",800,2,600,400,"True",812,380,368,-12,12,0
"C13LD",248,619,"1200x900",1000,2,600,400,"False",803,247,464,217,217,0
"C13LD",249,194,"1200x900",600,2,600,400,"False",896,236,323,87,87,0
"C13LD",250,268,"1200x900",800,0,600,400,"True",148,400,384,-16,16,1
"C13LD",251,507,"1200x900",1000,1,600,400,"False",608,583,428,-155,155,1
"C13LD",252,535,"1200x900",1000,1,600,400,"False",372,410,531,121,121,0
"C13LD",253,216,"1200x900",600,2,600,400,"True",1029,286,326,40,40,0
"C13LD",254,34,"1200x900",600,0,600,400,"True",361,242,276,34,34,1
"C13LD",255,261,"1200x900",800,0,600,400,"True",86,713,743,30,30,1
"C13LD",256,321,"1200x900",800,1,600,400,"False",601,190,269,79,79,0
"C13LD",257,169,"1200x900",600,2,600,400,"False",924,290,465,175,175,0
"C13LD",258,373,"1200x900",800,2,600,400,"True",694,326,396,70,70,0
"C13LD",259,95,"1200x900",600,1,600,400,"False",749,425,502,77,77,1
"C13LD",260,518,"1200x900",1000,1,600,400,"False",583,717,581,-136,136,0
"C13LD",261,47,"1200x900",600,0,600,400,"False",303,499,638,139,139,1
"C13LD",262,206,"1200x900",600,2,600,400,"False",975,223,427,204,204,0
"C13LD",263,306,"1200x900",800,1,600,400,"True",164,524,442,-82,82,0
"C13LD",264,304,"1200x900",800,1,600,400,"True",667,605,680,75,75,0
"C13LD",265,67,"1200x900",600,0,600,400,"True",289,308,267,-41,41,1
"C13LD",266,415,"1200x900",800,2,600,400,"False",823,684,427,-257,257,0
"C13LD",267,15,"1200x900",600,0,600,400,"True",473,352,339,-13,13,1
"C13LD",268,437,"1200x900",1000,0,600,400,"True",74,667,604,-63,63,1
"C13LD",269,270,"1200x900",800,0,600,400,"True",192,418,477,59,59,1
"C13LD",270,280,"1200x900",800,0,600,400,"False",104,302,432,130,130,1
"C13LD",271,207,"1200x900",600,2,600,400,"True",838,235,254,19,19,0
"C13LD",272,109,"1200x900",600,1,600,400,"False",691,589,437,-152,152,0
"C13LD",273,613,"1200x900",1000,2,600,400,"False",690,374,483,109,109,0
"C13LD",274,242,"1200x900",800,0,600,400,"False",117,448,526,78,78,1
"C13LD",275,267,"1200x900",800,0,600,400,"True",145,665,707,42,42,1
"C13LD",276,449,"1200x900",1000,0,600,400,"True",105,683,710,27,27,1
"C13LD",277,113,"1200x900",600,1,600,400,"False",897,657,357,-300,300,0
"C13LD",278,54,"1200x900",600,0,600,400,"True",474,564,598,34,34,1
"C13LD",279,71,"1200x900",600,0,600,400,"True",219,248,225,-23,23,0
"C13LD",280,343,"1200x900",800,1,600,400,"True",407,557,504,-53,53,0
"C13LD",281,92,"1200x900",600,1,600,400,"False",624,605,482,-123,123,0
"C13LD",282,203,"1200x900",600,2,600,400,"False",938,603,408,-195,195,0
"C13LD",283,496,"1200x900",1000,0,600,400,"False",70,639,787,148,148,1
"C13LD",284,120,"1200x900",600,1,600,400,"False",690,655,784,129,129,0
"C13LD",285,380,"1200x900",800,2,600,400,"False",942,228,356,128,128,0
"C13LD",286,461,"1200x900",1000,0,600,400,"True",95,711,752,41,41,1
"C13LD",287,453,"1200x900",1000,0,600,400,"True",71,393,414,21,21,1
"C13LD",288,220,"1200x900",800,0,600,400,"True",108,699,633,-66,66,1
"C13LD",289,516,"1200x900",1000,1,600,400,"False",440,559,468,-91,91,0
"C13LD",290,307,"1200x900",800,1,600,400,"True",716,247,314,67,67,0
"C13LD",291,231,"1200x900",800,0,600,400,"False",251,718,812,94,94,1
"C13LD",292,68,"1200x900",600,0,600,400,"False",165,367,451,84,84,0
"C13LD",293,56,"1200x900",600,0,600,400,"True",148,491,486,-5,5,0
"C13LD",294,152,"1200x900",600,2,600,400,"True",971,399,442,43,43,0
"C13LD",295,72,"1200x900",600,0,600,400,"True",158,537,535,-2,2,0
"C13LD",296,329,"1200x900",800,1,600,400,"False",517,239,452,213,213,0
"C13LD",297,434,"1200x900",1000,0,600,400,"True",89,657,655,-2,2,1
"C13LD",298,51,"1200x900",600,0,600,400,"True",272,181,158,-23,23,1
"C13LD",299,474,"1200x900",1000,0,600,400,"True",85,339,386,47,47,1
"C13LD",300,416,"1200x900",800,2,600,400,"False",748,617,555,-62,62,0
"C13LD",301,126,"1200x900",600,1,600,400,"True",849,354,366,12,12,0
"C13LD",302,98,"1200x900",600,1,600,400,"True",625,530,568,38,38,0
"C13LD",303,527,"1200x900",1000,1,600,400,"True",565,601,588,-13,13,0
"C13LD",304,505,"1200x900",1000,1,600,400,"False",191,484,421,-63,63,1
"C13LD",305,192,"1200x900",600,2,600,400,"False",1064,320,677,357,357,0
"C13LD",306,588,"1200x900",1000,2,600,400,"True",585,350,383,33,33,0
"C13LD",307,287,"1200x900",800,0,600,400,"True",120,567,610,43,43,1
"C13LD",309,36,"1200x900",600,0,600,400,"False",128,346,533,187,187,1
"C13LD",310,158,"1200x900",600,2,600,400,"False",939,300,492,192,192,0
"C13LD",311,277,"1200x900",800,0,600,400,"True",140,310,339,29,29,1
"C13LD",313,6,"1200x900",600,0,600,400,"True",217,689,656,-33,33,1
"C13LD",314,357,"1200x900",800,1,600,400,"True",109,594,611,17,17,0
"C13LD",315,647,"1200x900",1000,2,600,400,"False",560,637,531,-106,106,0
"C13LD",316,347,"1200x900",800,1,600,400,"False",757,295,600,305,305,1
"C13LD",317,549,"1200x900",1000,1,600,400,"True",657,366,340,-26,26,0
"C13LD",319,24,"1200x900",600,0,600,400,"True",430,538,512,-26,26,1
"C13LD",320,314,"1200x900",800,1,600,400,"True",277,616,621,5,5,1
"C13LD",321,389,"1200x900",800,2,600,400,"True",843,530,497,-33,33,0
"C13LD",322,266,"1200x900",800,0,600,400,"True",126,303,331,28,28,1
"C13LD",323,554,"1200x900",1000,1,600,400,"False",79,309,506,197,197,1
"C13LD",324,299,"1200x900",800,1,600,400,"False",779,274,627,353,353,0
"C13LD",325,602,"1200x900",1000,2,600,400,"False",865,452,289,-163,163,0
"C13LD",326,252,"1200x900",800,0,600,400,"True",224,673,623,-50,50,1
"C13LD",327,10,"1200x900",600,0,600,400,"True",400,499,503,4,4,1
"C13LD",328,544,"1200x900",1000,1,600,400,"False",602,620,546,-74,74,0
"C13LD",330,413,"1200x900",800,2,600,400,"True",849,506,423,-83,83,0
"C13LD",331,538,"1200x900",1000,1,600,400,"False",308,457,597,140,140,1
"C13LD",332,617,"1200x900",1000,2,600,400,"False",294,180,444,264,264,0
"C13LD",333,39,"1200x900",600,0,600,400,"False",210,609,688,79,79,0
"C13LD",334,149,"1200x900",600,2,600,400,"False",890,289,423,134,134,0
"C13LD",335,404,"1200x900",800,2,600,400,"True",842,396,367,-29,29,0
"C13LD",336,553,"1200x900",1000,1,600,400,"False",116,712,529,-183,183,0
"C13LD",337,30,"1200x900",600,0,600,400,"True",107,353,412,59,59,0
"C13LD",338,163,"1200x900",600,2,600,400,"True",1046,665,616,-49,49,0
"C13LD",339,62,"1200x900",600,0,600,400,"True",345,346,373,27,27,1
"C13LD",340,235,"1200x900",800,0,600,400,"True",146,646,652,6,6,1
"C13LD",341,331,"1200x900",800,1,600,400,"True",240,620,520,-100,100,0
"C13LD",342,76,"1200x900",600,1,600,400,"True",647,614,540,-74,74,0
"C13LD",343,409,"1200x900",800,2,600,400,"True",501,659,651,-8,8,0
"C13LD",344,176,"1200x900",600,2,600,400,"False",1033,281,474,193,193,0
"C13LD",345,105,"1200x900",600,1,600,400,"False",527,440,644,204,204,0
"C13LD",346,21,"1200x900",600,0,600,400,"True",314,383,329,-54,54,1
"C13LD",347,646,"1200x900",1000,2,600,400,"True",829,227,219,-8,8,1
"C13LD",348,638,"1200x900",1000,2,600,400,"False",385,198,280,82,82,0
"C13LD",349,298,"1200x900",800,1,600,400,"False",311,457,215,-242,242,0
"C13LD",350,517,"1200x900",1000,1,600,400,"False",548,182,275,93,93,0
"C13LD",351,243,"1200x900",800,0,600,400,"True",114,332,375,43,43,1
"C13LD",352,388,"1200x900",800,2,600,400,"False",930,320,579,259,259,0
"C13LD",353,232,"1200x900",800,0,600,400,"True",84,511,533,22,22,1
"C13LD",354,292,"1200x900",800,1,600,400,"False",88,565,717,152,152,0
"C13LD",355,361,"1200x900",800,2,600,400,"False",931,328,432,104,104,0
"C13LD",356,275,"1200x900",800,0,600,400,"True",120,594,535,-59,59,0
"C13LD",357,285,"1200x900",800,0,600,400,"True",237,396,458,62,62,1
"C13LD",358,372,"1200x900",800,2,600,400,"False",833,620,512,-108,108,0
"C13LD",359,165,"1200x900",600,2,600,400,"False",912,554,361,-193,193,0
"C13LD",360,582,"1200x900",1000,2,600,400,"False",554,347,562,215,215,0
"C13LD",361,599,"1200x900",1000,2,600,400,"True",316,570,552,-18,18,0
"C13LD",362,60,"1200x900",600,0,600,400,"True",365,213,255,42,42,1
"C13LD",363,74,"1200x900",600,1,600,400,"False",115,358,152,-206,206,0
"C13LD",364,642,"1200x900",1000,2,600,400,"False",776,316,383,67,67,0
"C13LD",365,13,"1200x900",600,0,600,400,"True",296,211,230,19,19,1
"C13LD",367,639,"1200x900",1000,2,600,400,"False",504,456,535,79,79,0
"C13LD",368,9,"1200x900",600,0,600,400,"True",509,654,705,51,51,1
"C13LD",369,171,"1200x900",600,2,600,400,"False",909,200,489,289,289,0
"C13LD",370,273,"1200x900",800,0,600,400,"True",180,309,340,31,31,1
"C13LD",372,210,"1200x900",600,2,600,400,"False",835,506,339,-167,167,0
"C13LD",373,503,"1200x900",1000,0,600,400,"True",86,279,224,-55,55,1
"C13LD",374,488,"1200x900",1000,0,600,400,"False",129,687,583,-104,104,1
"C13LD",375,25,"1200x900",600,0,600,400,"True",263,403,423,20,20,1
"C13LD",376,313,"1200x900",800,1,600,400,"False",588,421,515,94,94,0
"C13LD",377,526,"1200x900",1000,1,600,400,"False",497,710,389,-321,321,0
"C13LD",378,129,"1200x900",600,1,600,400,"True",859,482,554,72,72,1
"C13LD",379,340,"1200x900",800,1,600,400,"False",226,240,400,160,160,0
"C13LD",380,572,"1200x900",1000,1,600,400,"False",302,260,345,85,85,0
"C13LD",381,625,"1200x900",1000,2,600,400,"False",279,228,422,194,194,0
"C13LD",382,401,"1200x900",800,2,600,400,"True",821,260,314,54,54,0
"C13LD",383,320,"1200x900",800,1,600,400,"True",644,376,429,53,53,0
"C13LD",384,590,"1200x900",1000,2,600,400,"False",636,278,496,218,218,0
"C13LD",385,645,"1200x900",1000,2,600,400,"True",619,396,366,-30,30,0
"C13LD",386,407,"1200x900",800,2,600,400,"False",989,340,475,135,135,0
"C13LD",387,592,"1200x900",1000,2,600,400,"False",492,392,524,132,132,0
"C13LD",388,519,"1200x900",1000,1,600,400,"True",319,565,539,-26,26,1
"C13LD",389,425,"1200x900",800,2,600,400,"True",621,438,480,42,42,0
"C13LD",390,200,"1200x900",600,2,600,400,"False",897,302,456,154,154,0
"C13LD",391,583,"1200x900",1000,2,600,400,"False",949,284,420,136,136,1
"C13LD",392,326,"1200x900",800,1,600,400,"False",103,482,559,77,77,0
"C13LD",393,311,"1200x900",800,1,600,400,"False",710,261,478,217,217,0
"C13LD",394,333,"1200x900",800,1,600,400,"True",521,548,602,54,54,0
"C13LD",396,433,"1200x900",1000,0,600,400,"True",76,222,247,25,25,1
"C13LD",397,423,"1200x900",800,2,600,400,"False",1051,710,590,-120,120,1
"C13LD",399,598,"1200x900",1000,2,600,400,"True",706,559,527,-32,32,0
"C13LD",400,450,"1200x900",1000,0,600,400,"True",130,204,190,-14,14,1
"C13LD",401,80,"1200x900",600,1,600,400,"True",616,423,417,-6,6,1
"C13LD",402,91,"1200x900",600,1,600,400,"False",417,630,475,-155,155,1
"C13LD",403,184,"1200x900",600,2,600,400,"True",1067,441,389,-52,52,0
"C13LD",404,529,"1200x900",1000,1,600,400,"True",267,412,469,57,57,1
"C13LD",405,265,"1200x900",800,0,600,400,"True",229,353,318,-35,35,1
"C13LD",406,460,"1200x900",1000,0,600,400,"True",155,189,250,61,61,1
"C13LD",407,521,"1200x900",1000,1,600,400,"True",111,303,373,70,70,1
"C13LD",408,485,"1200x900",1000,0,600,400,"False",121,694,564,-130,130,1
"C13LD",409,269,"1200x900",800,0,600,400,"True",160,295,319,24,24,1
"C13LD",410,66,"1200x900",600,0,600,400,"False",155,673,563,-110,110,0
"C13LD",411,596,"1200x900",1000,2,600,400,"False",706,513,708,195,195,0
"C13LD",412,308,"1200x900",800,1,600,400,"False",437,425,583,158,158,0
"C13LD",413,370,"1200x900",800,2,600,400,"True",874,336,433,97,97,0
"C13LD",414,630,"1200x900",1000,2,600,400,"False",754,559,459,-100,100,0
"C13LD",415,430,"1200x900",800,2,600,400,"False",922,254,434,180,180,0
"C13LD",416,271,"1200x900",800,0,600,400,"True",74,360,397,37,37,1
"C13LD",417,624,"1200x900",1000,2,600,400,"False",693,501,437,-64,64,0
"C13LD",419,616,"1200x900",1000,2,600,400,"True",854,357,438,81,81,1
"C13LD",420,444,"1200x900",1000,0,600,400,"False",101,714,605,-109,109,1
"C13LD",421,336,"1200x900",800,1,600,400,"False",251,587,467,-120,120,0
"C13LD",422,185,"1200x900",600,2,600,400,"False",907,212,358,146,146,0
"C13LD",423,160,"1200x900",600,2,600,400,"False",863,606,439,-167,167,0
"C13LD",424,94,"1200x900",600,1,600,400,"True",729,482,433,-49,49,0
"C13LD",425,337,"1200x900",800,1,600,400,"False",299,622,459,-163,163,0
"C13LD",426,530,"1200x900",1000,1,600,400,"True",584,405,480,75,75,1
"C13LD",427,315,"1200x900",800,1,600,400,"False",105,211,414,203,203,0
"C13LD",428,536,"1200x900",1000,1,600,400,"True",580,213,272,59,59,0
"C13LD",429,97,"1200x900",600,1,600,400,"True",760,643,661,18,18,1
"C13LD",430,139,"1200x900",600,1,600,400,"True",192,695,669,-26,26,0
"C13LD",431,103,"1200x900",600,1,600,400,"False",528,320,184,-136,136,1
"C13LD",432,16,"1200x900",600,0,600,400,"False",297,514,640,126,126,1
"C13LD",433,290,"1200x900",800,1,600,400,"True",789,603,595,-8,8,0
"C13LD",434,429,"1200x900",800,2,600,400,"True",682,692,746,54,54,0
"C13LD",435,86,"1200x900",600,1,600,400,"False",692,388,458,70,70,1
"C13LD",436,162,"1200x900",600,2,600,400,"True",849,279,366,87,87,0
"C13LD",437,164,"1200x900",600,2,600,400,"True",1051,268,259,-9,9,0
"C13LD",438,284,"1200x900",800,0,600,400,"True",135,293,337,44,44,1
"C13LD",439,40,"1200x900",600,0,600,400,"False",143,513,426,-87,87,0
"C13LD",440,189,"1200x900",600,2,600,400,"True",881,397,475,78,78,0
"C13LD",441,576,"1200x900",1000,1,600,400,"False",376,713,626,-87,87,0
"C13LD",442,634,"1200x900",1000,2,600,400,"False",735,313,629,316,316,0
"C13LD",443,172,"1200x900",600,2,600,400,"True",912,444,426,-18,18,0
"C13LD",444,375,"1200x900",800,2,600,400,"True",716,384,363,-21,21,0
"C13LD",445,611,"1200x900",1000,2,600,400,"True",414,511,466,-45,45,0
"C13LD",446,208,"1200x900",600,2,600,400,"False",946,399,598,199,199,0
"C13LD",447,396,"1200x900",800,2,600,400,"True",678,663,629,-34,34,0
"C13LD",448,7,"1200x900",600,0,600,400,"True",431,654,722,68,68,1
"C13LD",449,595,"1200x900",1000,2,600,400,"False",687,640,520,-120,120,0
"C13LD",450,571,"1200x900",1000,1,600,400,"True",239,522,553,31,31,1
"C13LD",451,470,"1200x900",1000,0,600,400,"True",91,666,702,36,36,1
"C13LD",452,318,"1200x900",800,1,600,400,"False",788,534,784,250,250,0
"C13LD",453,622,"1200x900",1000,2,600,400,"True",307,683,731,48,48,0
"C13LD",454,566,"1200x900",1000,1,600,400,"True",378,472,533,61,61,1
"C13LD",455,124,"1200x900",600,1,600,400,"True",345,467,557,90,90,0
"C13LD",456,607,"1200x900",1000,2,600,400,"False",900,573,659,86,86,1
"C13LD",457,537,"1200x900",1000,1,600,400,"False",621,412,535,123,123,1
"C13LD",458,99,"1200x900",600,1,600,400,"True",811,407,466,59,59,0
"C13LD",459,534,"1200x900",1000,1,600,400,"True",328,504,467,-37,37,1
"C13LD",460,264,"1200x900",800,0,600,400,"True",198,660,722,62,62,1
"C13LD",461,48,"1200x900",600,0,600,400,"True",323,645,581,-64,64,1
"C13LD",462,249,"1200x900",800,0,600,400,"False",126,306,413,107,107,1
"C13LD",463,467,"1200x900",1000,0,600,400,"False",74,712,577,-135,135,1
"C13LD",464,564,"1200x900",1000,1,600,400,"False",215,264,369,105,105,0
"C13LD",465,131,"1200x900",600,1,600,400,"False",531,367,611,244,244,0
"C13LD",466,532,"1200x900",1000,1,600,400,"True",215,207,261,54,54,0
"C13LD",467,552,"1200x900",1000,1,600,400,"False",255,412,512,100,100,0
"C13LD",468,559,"1200x900",1000,1,600,400,"True",641,244,210,-34,34,0
"C13LD",470,295,"1200x900",800,1,600,400,"True",471,334,361,27,27,0
"C13LD",471,513,"1200x900",1000,1,600,400,"False",235,602,229,-373,373,0
"C13LD",472,371,"1200x900",800,2,600,400,"True",730,560,580,20,20,0
"C13LD",473,643,"1200x900",1000,2,600,400,"True",740,325,379,54,54,0
"C13LD",474,575,"1200x900",1000,1,600,400,"True",272,693,634,-59,59,0
"C13LD",475,539,"1200x900",1000,1,600,400,"True",510,383,350,-33,33,0
"C13LD",476,28,"1200x900",600,0,600,400,"True",336,410,426,16,16,1
"C13LD",477,360,"1200x900",800,1,600,400,"True",203,608,602,-6,6,0
"C13LD",478,325,"1200x900",800,1,600,400,"True",105,394,410,16,16,0
"C13LD",479,132,"1200x900",600,1,600,400,"False",333,185,338,153,153,0
"C13LD",480,525,"1200x900",1000,1,600,400,"False",123,690,534,-156,156,0
"C13LD",481,43,"1200x900",600,0,600,400,"False",277,446,589,143,143,1
"C13LD",482,355,"1200x900",800,1,600,400,"False",77,386,553,167,167,0
"C13LD",483,509,"1200x900",1000,1,600,400,"True",509,434,382,-52,52,0
"C13LD",484,241,"1200x900",800,0,600,400,"False",129,227,149,-78,78,1
"C13LD",485,448,"1200x900",1000,0,600,400,"True",107,641,694,53,53,1
"C13LD",486,278,"1200x900",800,0,600,400,"True",251,711,707,-4,4,1
"C13LD",487,473,"1200x900",1000,0,600,400,"False",75,323,409,86,86,1
"C13LD",488,217,"1200x900",800,0,600,400,"True",85,573,595,22,22,1
"C13LD",489,227,"1200x900",800,0,600,400,"True",196,551,499,-52,52,1
"C13LD",490,387,"1200x900",800,2,600,400,"False",990,444,333,-111,111,0
"C13LD",491,83,"1200x900",600,1,600,400,"True",763,568,519,-49,49,1
"C13LD",492,297,"1200x900",800,1,600,400,"False",625,244,338,94,94,0
"C13LD",493,403,"1200x900",800,2,600,400,"True",625,704,631,-73,73,0
"C13LD",494,382,"1200x900",800,2,600,400,"False",870,523,447,-76,76,0
"C13LD",495,42,"1200x900",600,0,600,400,"False",233,479,569,90,90,0
"C13LD",496,561,"1200x900",1000,1,600,400,"True",231,406,411,5,5,0
"C13LD",497,386,"1200x900",800,2,600,400,"True",774,301,329,28,28,0
"C13LD",498,244,"1200x900",800,0,600,400,"True",194,203,223,20,20,1
"C13LD",499,148,"1200x900",600,2,600,400,"True",907,330,418,88,88,0
"C13LD",500,512,"1200x900",1000,1,600,400,"False",139,261,500,239,239,0
"C13LD",501,286,"1200x900",800,0,600,400,"False",105,378,286,-92,92,1
"C13LD",502,64,"1200x900",600,0,600,400,"True",102,339,390,51,51,0
"C13LD",503,17,"1200x900",600,0,600,400,"True",402,496,464,-32,32,1
"C13LD",504,498,"1200x900",1000,0,600,400,"False",100,260,377,117,117,1
"C13LD",505,456,"1200x900",1000,0,600,400,"True",91,257,259,2,2,1
"C13LD",506,500,"1200x900",1000,0,600,400,"False",105,700,477,-223,223,1
"C13LD",507,421,"1200x900",800,2,600,400,"True",898,394,375,-19,19,0
"C13LD",508,633,"1200x900",1000,2,600,400,"False",564,253,571,318,318,0
"C13LD",509,385,"1200x900",800,2,600,400,"False",740,456,371,-85,85,0
"C13LD",510,368,"1200x900",800,2,600,400,"True",778,515,531,16,16,0
"C13LD",511,369,"1200x900",800,2,600,400,"True",903,594,541,-53,53,0
"C13LD",512,186,"1200x900",600,2,600,400,"False",997,197,388,191,191,0
"C13LD",513,451,"1200x900",1000,0,600,400,"False",110,702,634,-68,68,1
"C13LD",514,204,"1200x900",600,2,600,400,"False",1053,432,576,144,144,0
"C13LD",515,555,"1200x900",1000,1,600,400,"False",444,556,630,74,74,0
"C13LD",516,253,"1200x900",800,0,600,400,"False",177,424,504,80,80,1
"C13LD",517,116,"1200x900",600,1,600,400,"True",767,289,374,85,85,0
"C13LD",518,462,"1200x900",1000,0,600,400,"False",102,672,588,-84,84,1
"C13LD",519,491,"1200x900",1000,0,600,400,"False",108,198,371,173,173,1
"C13LD",520,543,"1200x900",1000,1,600,400,"False",88,202,609,407,407,0
"C13LD",521,187,"1200x900",600,2,600,400,"False",857,639,393,-246,246,0
"C13LD",522,463,"1200x900",1000,0,600,400,"False",115,693,563,-130,130,1
"C13LD",523,528,"1200x900",1000,1,600,400,"False",839,227,633,406,406,1
"C13LD",524,632,"1200x900",1000,2,600,400,"False",984,227,440,213,213,0
"C13LD",525,398,"1200x900",800,2,600,400,"False",944,698,419,-279,279,0
"C13LD",526,77,"1200x900",600,1,600,400,"False",780,525,425,-100,100,0
"C13LD",527,531,"1200x900",1000,1,600,400,"False",233,362,503,141,141,0
"C13LD",528,374,"1200x900",800,2,600,400,"False",755,450,360,-90,90,0
"C13LD",529,202,"1200x900",600,2,600,400,"False",966,460,577,117,117,0
"C13LD",530,37,"1200x900",600,0,600,400,"True",258,403,426,23,23,1
"C13LD",531,14,"1200x900",600,0,600,400,"True",399,224,282,58,58,1
"C13LD",532,391,"1200x900",800,2,600,400,"False",895,521,421,-100,100,0
"C13LD",533,319,"1200x900",800,1,600,400,"False",494,587,416,-171,171,1
"C13LD",534,173,"1200x900",600,2,600,400,"True",948,693,689,-4,4,0
"C13LD",535,106,"1200x900",600,1,600,400,"False",803,659,577,-82,82,1
"C13LD",536,316,"1200x900",800,1,600,400,"False",362,319,645,326,326,0
"C13LD",537,115,"1200x900",600,1,600,400,"False",545,307,530,223,223,0
"C13LD",538,628,"1200x900",1000,2,600,400,"False",768,410,344,-66,66,0
"C13LD",539,457,"1200x900",1000,0,600,400,"False",97,630,551,-79,79,1
"C13LD",540,142,"1200x900",600,1,600,400,"True",286,474,429,-45,45,0
"C13LD",541,82,"1200x900",600,1,600,400,"False",108,213,304,91,91,0
"C13LD",542,138,"1200x900",600,1,600,400,"True",844,580,650,70,70,1
"C13LD",543,35,"1200x900",600,0,600,400,"True",366,555,600,45,45,1
"C13LD",544,363,"1200x900",800,2,600,400,"False",800,218,337,119,119,0
"C13LD",545,134,"1200x900",600,1,600,400,"False",300,188,383,195,195,0
"C13LD",546,226,"1200x900",800,0,600,400,"True",187,229,204,-25,25,1
"C13LD",547,293,"1200x900",800,1,600,400,"False",561,396,485,89,89,0
"C13LD",548,190,"1200x900",600,2,600,400,"True",977,238,246,8,8,0
"C13LD",549,151,"1200x900",600,2,600,400,"True",828,680,621,-59,59,0
"C13LD",550,215,"1200x900",600,2,600,400,"True",939,596,601,5,5,0
"C13LD",551,41,"1200x900",600,0,600,400,"True",370,452,463,11,11,1
"C13LD",553,362,"1200x900",800,2,600,400,"False",819,338,586,248,248,0
"C13LD",554,179,"1200x900",600,2,600,400,"True",908,602,600,-2,2,0
"C13LD",555,38,"1200x900",600,0,600,400,"True",120,628,572,-56,56,1
"C13LD",556,274,"1200x900",800,0,600,400,"True",146,497,484,-13,13,1
"C13LD",557,606,"1200x900",1000,2,600,400,"True",653,627,625,-2,2,0
"C13LD",558,477,"1200x900",1000,0,600,400,"False",88,640,548,-92,92,1
"C13LD",559,468,"1200x900",1000,0,600,400,"False",121,219,402,183,183,1
"C13LD",560,587,"1200x900",1000,2,600,400,"False",741,686,333,-353,353,0
"C13LD",561,431,"1200x900",800,2,600,400,"False",694,382,608,226,226,0
"C13LD",562,338,"1200x900",800,1,600,400,"False",813,253,318,65,65,1
"C13LD",563,201,"1200x900",600,2,600,400,"False",1005,462,291,-171,171,0
"C13LD",564,426,"1200x900",800,2,600,400,"False",830,263,583,320,320,0
"C13LD",565,19,"1200x900",600,0,600,400,"True",286,686,709,23,23,0
"C13LD",566,23,"1200x900",600,0,600,400,"True",308,463,449,-14,14,1
"C13LD",567,540,"1200x900",1000,1,600,400,"True",389,568,605,37,37,1
"C13LD",568,1,"1200x900",600,0,600,400,"True",136,502,516,14,14,0
"C13LD",569,352,"1200x900",800,1,600,400,"False",235,717,610,-107,107,0
"C13LD",570,489,"1200x900",1000,0,600,400,"True",88,604,679,75,75,1
"C13LD",571,358,"1200x900",800,1,600,400,"False",263,635,288,-347,347,0
"C13LD",572,492,"1200x900",1000,0,600,400,"True",76,692,673,-19,19,1
"C13LD",573,260,"1200x900",800,0,600,400,"False",103,525,696,171,171,1
"C13LD",574,579,"1200x900",1000,2,600,400,"True",803,394,443,49,49,0
"C13LD",575,250,"1200x900",800,0,600,400,"True",290,248,256,8,8,1
"C13LD",576,354,"1200x900",800,1,600,400,"True",118,236,280,44,44,0
"C13LD",577,198,"1200x900",600,2,600,400,"True",976,500,442,-58,58,0
"C13LD",578,618,"1200x900",1000,2,600,400,"True",276,671,612,-59,59,0
"C13LD",579,11,"1200x900",600,0,600,400,"True",372,670,662,-8,8,1
"C13LD",580,170,"1200x900",600,2,600,400,"False",996,468,346,-122,122,0
"C13LD",581,93,"1200x900",600,1,600,400,"True",139,540,578,38,38,0
"C13LD",582,100,"1200x900",600,1,600,400,"False",453,511,379,-132,132,0
"C13LD",583,359,"1200x900",800,1,600,400,"False",653,241,396,155,155,0
"C13LD",584,85,"1200x900",600,1,600,400,"True",434,347,385,38,38,0
"C13LD",585,341,"1200x900",800,1,600,400,"False",735,632,522,-110,110,1
"C13LD",586,236,"1200x900",800,0,600,400,"True",162,350,408,58,58,1
"C13LD",587,428,"1200x900",800,2,600,400,"True",732,665,600,-65,65,0
"C13LD",588,18,"1200x900",600,0,600,400,"True",400,318,328,10,10,1
"C13LD",589,144,"1200x900",600,1,600,400,"True",718,371,362,-9,9,0
"C13LD",590,44,"1200x900",600,0,600,400,"False",305,554,470,-84,84,1
"C13LD",591,59,"1200x900",600,0,600,400,"True",391,692,675,-17,17,1
"C13LD",593,46,"1200x900",600,0,600,400,"False",193,355,436,81,81,1
"C13LD",594,469,"1200x900",1000,0,600,400,"False",73,227,296,69,69,1
"C13LD",595,324,"1200x900",800,1,600,400,"False",719,712,420,-292,292,1
"C13LD",596,75,"1200x900",600,1,600,400,"True",635,558,543,-15,15,0
"C13LD",597,222,"1200x900",800,0,600,400,"False",152,206,300,94,94,1
"C13LD",598,436,"1200x900",1000,0,600,400,"False",82,617,521,-96,96,1
"C13LD",599,493,"1200x900",1000,0,600,400,"False",80,582,458,-124,124,1
"C13LD",600,150,"1200x900",600,2,600,400,"True",897,345,348,3,3,0
"C13LD",601,90,"1200x900",600,1,600,400,"False",560,474,244,-230,230,0
"C13LD",602,5,"1200x900",600,0,600,400,"True",228,587,574,-13,13,0
"C13LD",603,228,"1200x900",800,0,600,400,"True",174,687,683,-4,4,1
"C13LD",604,514,"1200x900",1000,1,600,400,"True",539,690,713,23,23,0
"C13LD",605,597,"1200x900",1000,2,600,400,"False",352,239,386,147,147,0
"C13LD",606,381,"1200x900",800,2,600,400,"False",705,408,547,139,139,0
"C13LD",607,365,"1200x900",800,2,600,400,"False",1055,305,475,170,170,0
"C13LD",608,154,"1200x900",600,2,600,400,"False",941,454,609,155,155,0
"C13LD",609,548,"1200x900",1000,1,600,400,"False",103,278,499,221,221,0
"C13LD",610,585,"1200x900",1000,2,600,400,"False",698,688,416,-272,272,1
"C13LD",611,221,"1200x900",800,0,600,400,"True",132,520,528,8,8,1
"C13LD",612,218,"1200x900",800,0,600,400,"True",106,397,419,22,22,1
"C13LD",613,562,"1200x900",1000,1,600,400,"False",347,540,460,-80,80,0
"C13LD",614,45,"1200x900",600,0,600,400,"False",487,678,610,-68,68,1
"C13LD",616,159,"1200x900",600,2,600,400,"False",992,309,432,123,123,0
"C13LD",617,20,"1200x900",600,0,600,400,"False",204,545,642,97,97,1
"C13LD",618,237,"1200x900",800,0,600,400,"True",204,481,492,11,11,1
"C13LD",619,128,"1200x900",600,1,600,400,"False",661,258,361,103,103,1
"C13LD",620,29,"1200x900",600,0,600,400,"True",385,533,500,-33,33,1
"C13LD",621,294,"1200x900",800,1,600,400,"False",262,287,388,101,101,0
"C13LD",622,441,"1200x900",1000,0,600,400,"True",85,684,746,62,62,1
"C13LD",623,174,"1200x900",600,2,600,400,"True",998,457,456,-1,1,0
"C13LD",624,87,"1200x900",600,1,600,400,"False",231,604,509,-95,95,0
"C13LD",625,135,"1200x900",600,1,600,400,"True",759,569,540,-29,29,0
"C13LD",626,483,"1200x900",1000,0,600,400,"False",93,191,334,143,143,1
"C13LD",627,458,"1200x900",1000,0,600,400,"False",78,624,534,-90,90,1
"C13LD",628,422,"1200x900",800,2,600,400,"False",712,558,407,-151,151,0
"C13LD",629,402,"1200x900",800,2,600,400,"False",878,234,352,118,118,0
"C13LD",630,240,"1200x900",800,0,600,400,"True",330,656,619,-37,37,1
"C13LD",631,605,"1200x900",1000,2,600,400,"False",493,665,584,-81,81,0
"C13LD",632,466,"1200x900",1000,0,600,400,"False",82,205,357,152,152,1
"C13LD",633,79,"1200x900",600,1,600,400,"True",731,289,317,28,28,0
"C13LD",634,452,"1200x900",1000,0,600,400,"True",97,273,275,2,2,1
"C13LD",635,255,"1200x900",800,0,600,400,"False",93,709,597,-112,112,1
"C13LD",636,570,"1200x900",1000,1,600,400,"False",315,352,453,101,101,0
"C13LD",637,334,"1200x900",800,1,600,400,"False",481,665,551,-114,114,0
"C13LD",638,175,"1200x900",600,2,600,400,"False",1028,432,367,-65,65,0
"C13LD",639,238,"1200x900",800,0,600,400,"False",162,283,366,83,83,1
"C13LD",640,631,"1200x900",1000,2,600,400,"True",699,479,506,27,27,0
"C13LD",641,3,"1200x900",600,0,600,400,"True",298,443,482,39,39,1
"C13LD",642,52,"1200x900",600,0,600,400,"True",171,188,131,-57,57,0
"C13LD",643,248,"1200x900",800,0,600,400,"True",94,240,219,-21,21,1
"C13LD",644,143,"1200x900",600,1,600,400,"True",479,284,289,5,5,1
"C13LD",645,305,"1200x900",800,1,600,400,"False",471,716,521,-195,195,0
"C13LD",646,593,"1200x900",1000,2,600,400,"True",246,719,702,-17,17,0
"C13LD",647,414,"1200x900",800,2,600,400,"False",831,592,501,-91,91,0
"C13LD",648,475,"1200x900",1000,0,600,400,"True",101,715,680,-35,35,1
"C14LR",1,322,"1200x900",800,1,600,400,"False",703,206,313,107,107,1
"C14LR",2,438,"1200x900",1000,0,600,400,"False",77,713,352,-361,361,1
"C14LR",3,560,"1200x900",1000,1,600,400,"False",516,693,402,-291,291,0
"C14LR",4,336,"1200x900",800,1,600,400,"False",251,587,435,-152,152,0
"C14LR",5,1,"1200x900",600,0,600,400,"True",136,502,489,-13,13,0
"C14LR",6,454,"1200x900",1000,0,600,400,"False",78,687,469,-218,218,1
"C14LR",7,82,"1200x900",600,1,600,400,"False",108,213,367,154,154,0
"C14LR",8,302,"1200x900",800,1,600,400,"False",479,467,267,-200,200,1
"C14LR",9,633,"1200x900",1000,2,600,400,"False",564,253,479,226,226,0
"C14LR",10,200,"1200x900",600,2,600,400,"False",897,302,69,-233,233,0
"C14LR",11,611,"1200x900",1000,2,600,400,"False",414,511,369,-142,142,0
"C14LR",12,447,"1200x900",1000,0,600,400,"False",71,339,219,-120,120,1
"C14LR",13,62,"1200x900",600,0,600,400,"True",345,346,364,18,18,1
"C14LR",14,415,"1200x900",800,2,600,400,"False",823,684,459,-225,225,0
"C14LR",15,20,"1200x900",600,0,600,400,"False",204,545,465,-80,80,1
"C14LR",16,301,"1200x900",800,1,600,400,"False",162,574,412,-162,162,0
"C14LR",17,55,"1200x900",600,0,600,400,"True",211,305,355,50,50,1
"C14LR",18,31,"1200x900",600,0,600,400,"True",365,338,344,6,6,1
"C14LR",19,612,"1200x900",1000,2,600,400,"False",706,198,286,88,88,0
"C14LR",20,549,"1200x900",1000,1,600,400,"True",657,366,356,-10,10,0
"C14LR",21,466,"1200x900",1000,0,600,400,"False",82,205,343,138,138,1
"C14LR",22,377,"1200x900",800,2,600,400,"True",683,388,429,41,41,0
"C14LR",23,185,"1200x900",600,2,600,400,"False",907,212,314,102,102,0
"C14LR",24,379,"1200x900",800,2,600,400,"False",994,325,547,222,222,0
"C14LR",25,607,"1200x900",1000,2,600,400,"False",900,573,731,158,158,1
"C14LR",26,109,"1200x900",600,1,600,400,"True",691,589,527,-62,62,0
"C14LR",27,212,"1200x900",600,2,600,400,"False",841,206,429,223,223,0
"C14LR",28,202,"1200x900",600,2,600,400,"True",966,460,428,-32,32,0
"C14LR",29,309,"1200x900",800,1,600,400,"False",186,225,463,238,238,0
"C14LR",31,271,"1200x900",800,0,600,400,"True",74,360,367,7,7,1
"C14LR",32,199,"1200x900",600,2,600,400,"False",992,467,306,-161,161,0
"C14LR",33,408,"1200x900",800,2,600,400,"False",758,567,423,-144,144,0
"C14LR",34,85,"1200x900",600,1,600,400,"False",434,347,708,361,361,0
"C14LR",35,586,"1200x900",1000,2,600,400,"False",802,262,433,171,171,0
"C14LR",36,285,"1200x900",800,0,600,400,"True",237,396,390,-6,6,1
"C14LR",37,254,"1200x900",800,0,600,400,"False",136,583,473,-110,110,1
"C14LR",38,602,"1200x900",1000,2,600,400,"False",865,452,362,-90,90,0
"C14LR",39,9,"1200x900",600,0,600,400,"False",509,654,526,-128,128,1
"C14LR",40,340,"1200x900",800,1,600,400,"False",226,240,338,98,98,0
"C14LR",41,351,"1200x900",800,1,600,400,"False",122,581,423,-158,158,0
"C14LR",42,458,"1200x900",1000,0,600,400,"False",78,624,495,-129,129,1
"C14LR",43,14,"1200x900",600,0,600,400,"False",399,224,347,123,123,1
"C14LR",44,374,"1200x900",800,2,600,400,"False",755,450,259,-191,191,0
"C14LR",45,592,"1200x900",1000,2,600,400,"False",492,392,579,187,187,0
"C14LR",46,372,"1200x900",800,2,600,400,"False",833,620,389,-231,231,0
"C14LR",47,609,"1200x900",1000,2,600,400,"False",697,627,513,-114,114,0
"C14LR",48,26,"1200x900",600,0,600,400,"True",70,712,649,-63,63,0
"C14LR",49,616,"1200x900",1000,2,600,400,"False",854,357,198,-159,159,1
"C14LR",50,194,"1200x900",600,2,600,400,"False",896,236,443,207,207,0
"C14LR",51,578,"1200x900",1000,2,600,400,"False",966,276,573,297,297,0
"C14LR",52,87,"1200x900",600,1,600,400,"False",231,604,786,182,182,0
"C14LR",53,49,"1200x900",600,0,600,400,"True",109,380,396,16,16,0
"C14LR",54,484,"1200x900",1000,0,600,400,"False",100,223,350,127,127,1
"C14LR",55,208,"1200x900",600,2,600,400,"True",946,399,392,-7,7,0
"C14LR",56,45,"1200x900",600,0,600,400,"True",487,678,632,-46,46,1
"C14LR",57,193,"1200x900",600,2,600,400,"False",874,588,491,-97,97,0
"C14LR",58,459,"1200x900",1000,0,600,400,"False",70,645,578,-67,67,1
"C14LR",59,593,"1200x900",1000,2,600,400,"False",246,719,312,-407,407,0
"C14LR",60,463,"1200x900",1000,0,600,400,"True",115,693,678,-15,15,1
"C14LR",61,110,"1200x900",600,1,600,400,"True",776,550,457,-93,93,1
"C14LR",62,266,"1200x900",800,0,600,400,"True",126,303,330,27,27,1
"C14LR",63,127,"1200x900",600,1,600,400,"False",309,691,274,-417,417,0
"C14LR",64,150,"1200x900",600,2,600,400,"False",897,345,509,164,164,0
"C14LR",65,133,"1200x900",600,1,600,400,"True",345,551,511,-40,40,0
"C14LR",67,294,"1200x900",800,1,600,400,"False",262,287,478,191,191,0
"C14LR",68,173,"1200x900",600,2,600,400,"True",948,693,636,-57,57,0
"C14LR",69,477,"1200x900",1000,0,600,400,"True",88,640,601,-39,39,1
"C14LR",70,412,"1200x900",800,2,600,400,"False",842,280,414,134,134,0
"C14LR",71,80,"1200x900",600,1,600,400,"False",616,423,645,222,222,1
"C14LR",72,541,"1200x900",1000,1,600,400,"True",339,478,471,-7,7,0
"C14LR",73,33,"1200x900",600,0,600,400,"True",198,533,514,-19,19,1
"C14LR",74,346,"1200x900",800,1,600,400,"True",269,635,617,-18,18,0
"C14LR",75,320,"1200x900",800,1,600,400,"False",644,376,502,126,126,0
"C14LR",76,635,"1200x900",1000,2,600,400,"False",833,402,555,153,153,0
"C14LR",77,395,"1200x900",800,2,600,400,"False",743,334,580,246,246,0
"C14LR",78,376,"1200x900",800,2,600,400,"False",788,275,544,269,269,0
"C14LR",79,233,"1200x900",800,0,600,400,"True",164,700,673,-27,27,1
"C14LR",80,525,"1200x900",1000,1,600,400,"False",123,690,459,-231,231,0
"C14LR",81,318,"1200x900",800,1,600,400,"True",788,534,503,-31,31,0
"C14LR",82,381,"1200x900",800,2,600,400,"False",705,408,563,155,155,0
"C14LR",83,621,"1200x900",1000,2,600,400,"True",540,478,531,53,53,0
"C14LR",84,634,"1200x900",1000,2,600,400,"False",735,313,382,69,69,0
"C14LR",85,221,"1200x900",800,0,600,400,"True",132,520,471,-49,49,1
"C14LR",86,273,"1200x900",800,0,600,400,"True",180,309,317,8,8,1
"C14LR",87,643,"1200x900",1000,2,600,400,"False",740,325,213,-112,112,0
"C14LR",88,371,"1200x900",800,2,600,400,"True",730,560,564,4,4,0
"C14LR",89,8,"1200x900",600,0,600,400,"True",156,679,673,-6,6,0
"C14LR",90,359,"1200x900",800,1,600,400,"False",653,241,363,122,122,0
"C14LR",91,37,"1200x900",600,0,600,400,"False",258,403,334,-69,69,1
"C14LR",92,398,"1200x900",800,2,600,400,"True",944,698,608,-90,90,0
"C14LR",93,16,"1200x900",600,0,600,400,"True",297,514,543,29,29,1
"C14LR",94,450,"1200x900",1000,0,600,400,"False",130,204,325,121,121,1
"C14LR",95,119,"1200x900",600,1,600,400,"False",168,563,711,148,148,0
"C14LR",96,303,"1200x900",800,1,600,400,"True",241,431,502,71,71,0
"C14LR",97,312,"1200x900",800,1,600,400,"False",238,683,420,-263,263,0
"C14LR",98,93,"1200x900",600,1,600,400,"False",139,540,643,103,103,0
"C14LR",99,439,"1200x900",1000,0,600,400,"False",110,229,323,94,94,1
"C14LR",100,557,"1200x900",1000,1,600,400,"False",677,505,788,283,283,1
"C14LR",101,574,"1200x900",1000,1,600,400,"False",614,194,435,241,241,0
"C14LR",102,99,"1200x900",600,1,600,400,"False",811,407,558,151,151,0
"C14LR",103,253,"1200x900",800,0,600,400,"True",177,424,401,-23,23,1
"C14LR",104,638,"1200x900",1000,2,600,400,"True",385,198,235,37,37,0
"C14LR",105,369,"1200x900",800,2,600,400,"False",903,594,412,-182,182,0
"C14LR",106,149,"1200x900",600,2,600,400,"False",890,289,446,157,157,0
"C14LR",107,207,"1200x900",600,2,600,400,"False",838,235,428,193,193,0
"C14LR",108,304,"1200x900",800,1,600,400,"False",667,605,400,-205,205,0
"C14LR",109,480,"1200x900",1000,0,600,400,"True",100,231,272,41,41,1
"C14LR",110,229,"1200x900",800,0,600,400,"True",117,697,631,-66,66,1
"C14LR",111,223,"1200x900",800,0,600,400,"True",179,191,229,38,38,1
"C14LR",112,427,"1200x900",800,2,600,400,"True",812,380,342,-38,38,0
"C14LR",113,475,"1200x900",1000,0,600,400,"False",101,715,579,-136,136,1
"C14LR",114,423,"1200x900",800,2,600,400,"False",1051,710,481,-229,229,1
"C14LR",115,514,"1200x900",1000,1,600,400,"False",539,690,591,-99,99,0
"C14LR",116,144,"1200x900",600,1,600,400,"True",718,371,336,-35,35,0
"C14LR",117,29,"1200x900",600,0,600,400,"True",385,533,588,55,55,1
"C14LR",118,568,"1200x900",1000,1,600,400,"False",286,475,576,101,101,1
"C14LR",119,248,"1200x900",800,0,600,400,"True",94,240,278,38,38,1
"C14LR",120,81,"1200x900",600,1,600,400,"True",696,225,252,27,27,0
"C14LR",121,91,"1200x900",600,1,600,400,"False",417,630,282,-348,348,1
"C14LR",122,98,"1200x900",600,1,600,400,"True",625,530,565,35,35,0
"C14LR",123,345,"1200x900",800,1,600,400,"False",841,566,648,82,82,1
"C14LR",124,401,"1200x900",800,2,600,400,"True",821,260,246,-14,14,0
"C14LR",125,136,"1200x900",600,1,600,400,"True",264,205,249,44,44,0
"C14LR",126,313,"1200x900",800,1,600,400,"True",588,421,400,-21,21,0
"C14LR",127,277,"1200x900",800,0,600,400,"True",140,310,305,-5,5,1
"C14LR",128,615,"1200x900",1000,2,600,400,"False",736,634,518,-116,116,0
"C14LR",129,582,"1200x900",1000,2,600,400,"False",554,347,623,276,276,0
"C14LR",130,504,"1200x900",1000,0,600,400,"False",107,699,557,-142,142,1
"C14LR",131,198,"1200x900",600,2,600,400,"False",976,500,705,205,205,0
"C14LR",132,380,"1200x900",800,2,600,400,"False",942,228,359,131,131,0
"C14LR",133,508,"1200x900",1000,1,600,400,"True",596,485,454,-31,31,0
"C14LR",134,234,"1200x900",800,0,600,400,"True",72,344,321,-23,23,1
"C14LR",135,187,"1200x900",600,2,600,400,"False",857,639,514,-125,125,0
"C14LR",136,236,"1200x900",800,0,600,400,"True",162,350,347,-3,3,1
"C14LR",138,43,"1200x900",600,0,600,400,"True",277,446,446,0,0,1
"C14LR",139,522,"1200x900",1000,1,600,400,"False",223,379,629,250,250,0
"C14LR",140,485,"1200x900",1000,0,600,400,"False",121,694,502,-192,192,1
"C14LR",141,394,"1200x900",800,2,600,400,"False",847,292,640,348,348,0
"C14LR",142,231,"1200x900",800,0,600,400,"True",251,718,672,-46,46,1
"C14LR",143,41,"1200x900",600,0,600,400,"True",370,452,455,3,3,1
"C14LR",144,307,"1200x900",800,1,600,400,"False",716,247,349,102,102,0
"C14LR",145,90,"1200x900",600,1,600,400,"False",560,474,292,-182,182,0
"C14LR",146,105,"1200x900",600,1,600,400,"False",527,440,593,153,153,0
"C14LR",147,155,"1200x900",600,2,600,400,"False",940,269,442,173,173,0
"C14LR",148,605,"1200x900",1000,2,600,400,"True",493,665,606,-59,59,0
"C14LR",149,280,"1200x900",800,0,600,400,"False",104,302,406,104,104,1
"C14LR",150,257,"1200x900",800,0,600,400,"False",97,219,327,108,108,1
"C14LR",151,402,"1200x900",800,2,600,400,"False",878,234,424,190,190,0
"C14LR",152,77,"1200x900",600,1,600,400,"True",780,525,542,17,17,0
"C14LR",153,489,"1200x900",1000,0,600,400,"True",88,604,639,35,35,1
"C14LR",154,315,"1200x900",800,1,600,400,"False",105,211,342,131,131,0
"C14LR",155,576,"1200x900",1000,1,600,400,"False",376,713,471,-242,242,0
"C14LR",156,128,"1200x900",600,1,600,400,"True",661,258,279,21,21,1
"C14LR",157,596,"1200x900",1000,2,600,400,"False",706,513,646,133,133,0
"C14LR",158,362,"1200x900",800,2,600,400,"False",819,338,534,196,196,0
"C14LR",159,535,"1200x900",1000,1,600,400,"True",372,410,403,-7,7,0
"C14LR",160,363,"1200x900",800,2,600,400,"False",800,218,316,98,98,0
"C14LR",161,430,"1200x900",800,2,600,400,"False",922,254,153,-101,101,0
"C14LR",162,337,"1200x900",800,1,600,400,"True",299,622,633,11,11,0
"C14LR",163,19,"1200x900",600,0,600,400,"False",286,686,510,-176,176,0
"C14LR",164,2,"1200x900",600,0,600,400,"True",159,323,351,28,28,0
"C14LR",165,349,"1200x900",800,1,600,400,"False",402,665,568,-97,97,0
"C14LR",166,138,"1200x900",600,1,600,400,"False",844,580,638,58,58,1
"C14LR",167,94,"1200x900",600,1,600,400,"False",729,482,611,129,129,0
"C14LR",168,516,"1200x900",1000,1,600,400,"True",440,559,536,-23,23,0
"C14LR",169,114,"1200x900",600,1,600,400,"True",183,697,663,-34,34,0
"C14LR",170,74,"1200x900",600,1,600,400,"True",115,358,341,-17,17,0
"C14LR",171,180,"1200x900",600,2,600,400,"False",929,270,170,-100,100,0
"C14LR",172,424,"1200x900",800,2,600,400,"False",903,545,343,-202,202,0
"C14LR",173,639,"1200x900",1000,2,600,400,"True",504,456,496,40,40,0
"C14LR",174,491,"1200x900",1000,0,600,400,"True",108,198,158,-40,40,1
"C14LR",175,642,"1200x900",1000,2,600,400,"False",776,316,476,160,160,0
"C14LR",176,406,"1200x900",800,2,600,400,"False",971,233,459,226,226,0
"C14LR",177,517,"1200x900",1000,1,600,400,"True",548,182,238,56,56,0
"C14LR",178,530,"1200x900",1000,1,600,400,"False",584,405,286,-119,119,1
"C14LR",179,391,"1200x900",800,2,600,400,"False",895,521,211,-310,310,0
"C14LR",180,479,"1200x900",1000,0,600,400,"False",74,705,612,-93,93,1
"C14LR",181,498,"1200x900",1000,0,600,400,"False",100,260,424,164,164,1
"C14LR",182,375,"1200x900",800,2,600,400,"True",716,384,351,-33,33,0
"C14LR",183,267,"1200x900",800,0,600,400,"True",145,665,639,-26,26,1
"C14LR",184,48,"1200x900",600,0,600,400,"True",323,645,659,14,14,1
"C14LR",185,325,"1200x900",800,1,600,400,"True",105,394,364,-30,30,0
"C14LR",186,161,"1200x900",600,2,600,400,"False",939,553,721,168,168,0
"C14LR",187,496,"1200x900",1000,0,600,400,"True",70,639,636,-3,3,1
"C14LR",188,251,"1200x900",800,0,600,400,"True",88,352,397,45,45,1
"C14LR",189,334,"1200x900",800,1,600,400,"False",481,665,545,-120,120,0
"C14LR",190,585,"1200x900",1000,2,600,400,"True",698,688,675,-13,13,1
"C14LR",191,42,"1200x900",600,0,600,400,"False",233,479,597,118,118,0
"C14LR",192,272,"1200x900",800,0,600,400,"False",200,181,271,90,90,1
"C14LR",193,145,"1200x900",600,2,600,400,"True",1004,630,593,-37,37,0
"C14LR",194,214,"1200x900",600,2,600,400,"False",1046,305,223,-82,82,0
"C14LR",195,219,"1200x900",800,0,600,400,"False",202,502,377,-125,125,1
"C14LR",196,632,"1200x900",1000,2,600,400,"False",984,227,724,497,497,0
"C14LR",197,22,"1200x900",600,0,600,400,"True",398,591,632,41,41,1
"C14LR",198,196,"1200x900",600,2,600,400,"True",1030,397,437,40,40,0
"C14LR",199,24,"1200x900",600,0,600,400,"True",430,538,511,-27,27,1
"C14LR",200,389,"1200x900",800,2,600,400,"False",843,530,332,-198,198,0
"C14LR",201,96,"1200x900",600,1,600,400,"False",433,458,550,92,92,0
"C14LR",202,620,"1200x900",1000,2,600,400,"False",832,649,456,-193,193,0
"C14LR",203,160,"1200x900",600,2,600,400,"True",863,606,566,-40,40,0
"C14LR",204,59,"1200x900",600,0,600,400,"True",391,692,624,-68,68,1
"C14LR",205,204,"1200x900",600,2,600,400,"True",1053,432,453,21,21,0
"C14LR",206,122,"1200x900",600,1,600,400,"False",817,709,570,-139,139,0
"C14LR",207,566,"1200x900",1000,1,600,400,"False",378,472,270,-202,202,1
"C14LR",208,125,"1200x900",600,1,600,400,"False",750,531,448,-83,83,0
"C14LR",209,470,"1200x900",1000,0,600,400,"False",91,666,593,-73,73,1
"C14LR",210,383,"1200x900",800,2,600,400,"False",855,407,492,85,85,0
"C14LR",211,344,"1200x900",800,1,600,400,"True",589,408,389,-19,19,0
"C14LR",212,296,"1200x900",800,1,600,400,"False",89,279,406,127,127,0
"C14LR",213,314,"1200x900",800,1,600,400,"False",277,616,381,-235,235,1
"C14LR",214,482,"1200x900",1000,0,600,400,"True",79,686,658,-28,28,1
"C14LR",215,603,"1200x900",1000,2,600,400,"False",693,280,151,-129,129,0
"C14LR",216,562,"1200x900",1000,1,600,400,"True",347,540,485,-55,55,0
"C14LR",217,181,"1200x900",600,2,600,400,"True",1018,223,305,82,82,0
"C14LR",218,331,"1200x900",800,1,600,400,"False",240,620,264,-356,356,0
"C14LR",219,528,"1200x900",1000,1,600,400,"False",839,227,676,449,449,1
"C14LR",220,121,"1200x900",600,1,600,400,"False",884,364,461,97,97,0
"C14LR",221,613,"1200x900",1000,2,600,400,"True",690,374,413,39,39,0
"C14LR",222,242,"1200x900",800,0,600,400,"True",117,448,476,28,28,1
"C14LR",223,217,"1200x900",800,0,600,400,"True",85,573,509,-64,64,1
"C14LR",224,538,"1200x900",1000,1,600,400,"False",308,457,600,143,143,1
"C14LR",225,520,"1200x900",1000,1,600,400,"False",564,260,339,79,79,0
"C14LR",226,131,"1200x900",600,1,600,400,"False",531,367,627,260,260,0
"C14LR",227,129,"1200x900",600,1,600,400,"False",859,482,180,-302,302,1
"C14LR",228,165,"1200x900",600,2,600,400,"True",912,554,544,-10,10,0
"C14LR",229,420,"1200x900",800,2,600,400,"False",519,223,433,210,210,0
"C14LR",230,532,"1200x900",1000,1,600,400,"False",215,207,497,290,290,0
"C14LR",231,120,"1200x900",600,1,600,400,"True",690,655,620,-35,35,0
"C14LR",232,206,"1200x900",600,2,600,400,"False",975,223,154,-69,69,0
"C14LR",233,599,"1200x900",1000,2,600,400,"False",316,570,397,-173,173,0
"C14LR",234,343,"1200x900",800,1,600,400,"False",407,557,209,-348,348,0
"C14LR",235,66,"1200x900",600,0,600,400,"True",155,673,629,-44,44,0
"C14LR",236,507,"1200x900",1000,1,600,400,"True",608,583,536,-47,47,1
"C14LR",237,36,"1200x900",600,0,600,400,"True",128,346,347,1,1,1
"C14LR",238,449,"1200x900",1000,0,600,400,"False",105,683,528,-155,155,1
"C14LR",239,61,"1200x900",600,0,600,400,"True",272,670,618,-52,52,1
"C14LR",240,268,"1200x900",800,0,600,400,"True",148,400,403,3,3,1
"C14LR",241,211,"1200x900",600,2,600,400,"False",986,407,185,-222,222,0
"C14LR",242,426,"1200x900",800,2,600,400,"False",830,263,430,167,167,0
"C14LR",243,531,"1200x900",1000,1,600,400,"False",233,362,634,272,272,0
"C14LR",244,513,"1200x900",1000,1,600,400,"False",235,602,235,-367,367,0
"C14LR",245,534,"1200x900",1000,1,600,400,"False",328,504,616,112,112,1
"C14LR",246,546,"1200x900",1000,1,600,400,"True",305,374,398,24,24,0
"C14LR",247,431,"1200x900",800,2,600,400,"False",694,382,535,153,153,0
"C14LR",248,396,"1200x900",800,2,600,400,"True",678,663,630,-33,33,0
"C14LR",249,460,"1200x900",1000,0,600,400,"True",155,189,243,54,54,1
"C14LR",250,25,"1200x900",600,0,600,400,"True",263,403,357,-46,46,1
"C14LR",251,564,"1200x900",1000,1,600,400,"False",215,264,334,70,70,0
"C14LR",252,606,"1200x900",1000,2,600,400,"True",653,627,674,47,47,0
"C14LR",253,378,"1200x900",800,2,600,400,"False",1018,708,421,-287,287,0
"C14LR",254,413,"1200x900",800,2,600,400,"False",849,506,585,79,79,0
"C14LR",255,237,"1200x900",800,0,600,400,"True",204,481,470,-11,11,1
"C14LR",256,112,"1200x900",600,1,600,400,"False",681,490,377,-113,113,0
"C14LR",257,627,"1200x900",1000,2,600,400,"False",760,510,616,106,106,0
"C14LR",258,441,"1200x900",1000,0,600,400,"False",85,684,587,-97,97,1
"C14LR",259,316,"1200x900",800,1,600,400,"False",362,319,472,153,153,0
"C14LR",260,445,"1200x900",1000,0,600,400,"True",78,302,324,22,22,1
"C14LR",261,614,"1200x900",1000,2,600,400,"True",823,563,565,2,2,0
"C14LR",262,249,"1200x900",800,0,600,400,"False",126,306,376,70,70,1
"C14LR",263,299,"1200x900",800,1,600,400,"False",779,274,696,422,422,0
"C14LR",264,147,"1200x900",600,2,600,400,"False",942,418,579,161,161,0
"C14LR",265,386,"1200x900",800,2,600,400,"False",774,301,158,-143,143,0
"C14LR",266,47,"1200x900",600,0,600,400,"True",303,499,514,15,15,1
"C14LR",267,512,"1200x900",1000,1,600,400,"False",139,261,379,118,118,0
"C14LR",268,305,"1200x900",800,1,600,400,"False",471,716,628,-88,88,0
"C14LR",269,501,"1200x900",1000,0,600,400,"False",96,323,441,118,118,1
"C14LR",270,519,"1200x900",1000,1,600,400,"False",319,565,648,83,83,1
"C14LR",271,240,"1200x900",800,0,600,400,"True",330,656,647,-9,9,1
"C14LR",272,148,"1200x900",600,2,600,400,"True",907,330,301,-29,29,0
"C14LR",273,577,"1200x900",1000,2,600,400,"True",455,420,403,-17,17,0
"C14LR",274,6,"1200x900",600,0,600,400,"False",217,689,542,-147,147,1
"C14LR",275,288,"1200x900",800,0,600,400,"True",180,547,591,44,44,1
"C14LR",276,230,"1200x900",800,0,600,400,"True",99,678,642,-36,36,1
"C14LR",277,411,"1200x900",800,2,600,400,"False",805,361,512,151,151,0
"C14LR",278,35,"1200x900",600,0,600,400,"True",366,555,571,16,16,1
"C14LR",280,373,"1200x900",800,2,600,400,"False",694,326,427,101,101,0
"C14LR",281,178,"1200x900",600,2,600,400,"False",1041,510,589,79,79,0
"C14LR",282,556,"1200x900",1000,1,600,400,"True",415,420,456,36,36,0
"C14LR",283,289,"1200x900",800,1,600,400,"False",421,703,580,-123,123,1
"C14LR",284,552,"1200x900",1000,1,600,400,"False",255,412,506,94,94,0
"C14LR",285,215,"1200x900",600,2,600,400,"True",939,596,563,-33,33,0
"C14LR",286,418,"1200x900",800,2,600,400,"True",754,507,570,63,63,0
"C14LR",287,628,"1200x900",1000,2,600,400,"False",768,410,500,90,90,0
"C14LR",288,333,"1200x900",800,1,600,400,"False",521,548,398,-150,150,0
"C14LR",289,440,"1200x900",1000,0,600,400,"True",71,237,187,-50,50,1
"C14LR",291,464,"1200x900",1000,0,600,400,"True",82,222,224,2,2,1
"C14LR",292,89,"1200x900",600,1,600,400,"True",917,366,357,-9,9,1
"C14LR",294,108,"1200x900",600,1,600,400,"True",830,239,298,59,59,0
"C14LR",295,382,"1200x900",800,2,600,400,"False",870,523,222,-301,301,0
"C14LR",296,182,"1200x900",600,2,600,400,"True",933,389,373,-16,16,0
"C14LR",297,18,"1200x900",600,0,600,400,"True",400,318,324,6,6,1
"C14LR",298,203,"1200x900",600,2,600,400,"False",938,603,512,-91,91,0
"C14LR",299,590,"1200x900",1000,2,600,400,"False",636,278,428,150,150,0
"C14LR",300,15,"1200x900",600,0,600,400,"True",473,352,373,21,21,1
"C14LR",301,274,"1200x900",800,0,600,400,"True",146,497,459,-38,38,1
"C14LR",302,526,"1200x900",1000,1,600,400,"False",497,710,477,-233,233,0
"C14LR",303,435,"1200x900",1000,0,600,400,"False",119,200,355,155,155,1
"C14LR",304,442,"1200x900",1000,0,600,400,"False",87,183,268,85,85,1
"C14LR",305,68,"1200x900",600,0,600,400,"True",165,367,319,-48,48,0
"C14LR",306,241,"1200x900",800,0,600,400,"True",129,227,287,60,60,1
"C14LR",307,4,"1200x900",600,0,600,400,"False",602,200,271,71,71,1
"C14LR",308,227,"1200x900",800,0,600,400,"False",196,551,473,-78,78,1
"C14LR",309,247,"1200x900",800,0,600,400,"True",160,424,483,59,59,1
"C14LR",310,341,"1200x900",800,1,600,400,"True",735,632,600,-32,32,1
"C14LR",311,347,"1200x900",800,1,600,400,"False",757,295,555,260,260,1
"C14LR",312,103,"1200x900",600,1,600,400,"False",528,320,419,99,99,1
"C14LR",313,53,"1200x900",600,0,600,400,"False",177,189,287,98,98,0
"C14LR",314,623,"1200x900",1000,2,600,400,"False",636,527,279,-248,248,0
"C14LR",315,646,"1200x900",1000,2,600,400,"False",829,227,330,103,103,1
"C14LR",316,356,"1200x900",800,1,600,400,"False",123,484,607,123,123,0
"C14LR",317,626,"1200x900",1000,2,600,400,"False",329,449,531,82,82,0
"C14LR",318,500,"1200x900",1000,0,600,400,"True",105,700,640,-60,60,1
"C14LR",319,171,"1200x900",600,2,600,400,"False",909,200,542,342,342,0
"C14LR",320,256,"1200x900",800,0,600,400,"True",192,656,697,41,41,1
"C14LR",321,38,"1200x900",600,0,600,400,"True",120,628,642,14,14,1
"C14LR",322,473,"1200x900",1000,0,600,400,"True",75,323,268,-55,55,1
"C14LR",323,123,"1200x900",600,1,600,400,"True",761,365,336,-29,29,1
"C14LR",324,40,"1200x900",600,0,600,400,"True",143,513,453,-60,60,0
"C14LR",325,598,"1200x900",1000,2,600,400,"True",706,559,593,34,34,0
"C14LR",326,510,"1200x900",1000,1,600,400,"True",486,338,355,17,17,1
"C14LR",327,317,"1200x900",800,1,600,400,"True",185,564,579,15,15,0
"C14LR",328,544,"1200x900",1000,1,600,400,"True",602,620,673,53,53,0
"C14LR",329,587,"1200x900",1000,2,600,400,"False",741,686,454,-232,232,0
"C14LR",330,321,"1200x900",800,1,600,400,"False",601,190,380,190,190,0
"C14LR",331,448,"1200x900",1000,0,600,400,"True",107,641,598,-43,43,1
"C14LR",332,433,"1200x900",1000,0,600,400,"True",76,222,278,56,56,1
"C14LR",333,13,"1200x900",600,0,600,400,"True",296,211,172,-39,39,1
"C14LR",334,140,"1200x900",600,1,600,400,"False",700,523,311,-212,212,0
"C14LR",335,278,"1200x900",800,0,600,400,"True",251,711,682,-29,29,1
"C14LR",336,195,"1200x900",600,2,600,400,"False",942,249,361,112,112,0
"C14LR",337,617,"1200x900",1000,2,600,400,"False",294,180,519,339,339,0
"C14LR",338,428,"1200x900",800,2,600,400,"False",732,665,490,-175,175,0
"C14LR",339,640,"1200x900",1000,2,600,400,"False",361,334,767,433,433,0
"C14LR",340,306,"1200x900",800,1,600,400,"False",164,524,680,156,156,0
"C14LR",341,561,"1200x900",1000,1,600,400,"False",231,406,587,181,181,0
"C14LR",342,329,"1200x900",800,1,600,400,"False",517,239,431,192,192,0
"C14LR",343,130,"1200x900",600,1,600,400,"False",741,428,549,121,121,0
"C14LR",344,95,"1200x900",600,1,600,400,"False",749,425,523,98,98,1
"C14LR",345,414,"1200x900",800,2,600,400,"False",831,592,487,-105,105,0
"C14LR",346,488,"1200x900",1000,0,600,400,"False",129,687,569,-118,118,1
"C14LR",347,624,"1200x900",1000,2,600,400,"False",693,501,611,110,110,0
"C14LR",348,625,"1200x900",1000,2,600,400,"False",279,228,544,316,316,0
"C14LR",349,186,"1200x900",600,2,600,400,"False",997,197,375,178,178,0
"C14LR",350,540,"1200x900",1000,1,600,400,"True",389,568,515,-53,53,1
"C14LR",351,63,"1200x900",600,0,600,400,"True",311,188,173,-15,15,1
"C14LR",353,641,"1200x900",1000,2,600,400,"False",897,272,467,195,195,0
"C14LR",354,631,"1200x900",1000,2,600,400,"False",699,479,384,-95,95,0
"C14LR",355,370,"1200x900",800,2,600,400,"False",874,336,141,-195,195,0
"C14LR",357,604,"1200x900",1000,2,600,400,"False",459,593,445,-148,148,0
"C14LR",359,361,"1200x900",800,2,600,400,"True",931,328,354,26,26,0
"C14LR",360,503,"1200x900",1000,0,600,400,"True",86,279,277,-2,2,1
"C14LR",361,360,"1200x900",800,1,600,400,"True",203,608,605,-3,3,0
"C14LR",362,30,"1200x900",600,0,600,400,"False",107,353,277,-76,76,0
"C14LR",363,158,"1200x900",600,2,600,400,"True",939,300,333,33,33,0
"C14LR",364,476,"1200x900",1000,0,600,400,"True",76,359,374,15,15,1
"C14LR",365,597,"1200x900",1000,2,600,400,"False",352,239,441,202,202,0
"C14LR",366,595,"1200x900",1000,2,600,400,"False",687,640,354,-286,286,0
"C14LR",367,153,"1200x900",600,2,600,400,"True",1037,601,548,-53,53,0
"C14LR",368,474,"1200x900",1000,0,600,400,"False",85,339,491,152,152,1
"C14LR",369,570,"1200x900",1000,1,600,400,"False",315,352,615,263,263,0
"C14LR",370,335,"1200x900",800,1,600,400,"False",124,360,536,176,176,0
"C14LR",371,197,"1200x900",600,2,600,400,"False",903,212,466,254,254,0
"C14LR",372,417,"1200x900",800,2,600,400,"True",750,280,313,33,33,0
"C14LR",373,164,"1200x900",600,2,600,400,"True",1051,268,256,-12,12,0
"C14LR",374,648,"1200x900",1000,2,600,400,"False",557,394,217,-177,177,0
"C14LR",375,64,"1200x900",600,0,600,400,"True",102,339,296,-43,43,0
"C14LR",376,327,"1200x900",800,1,600,400,"True",152,339,347,8,8,0
"C14LR",377,115,"1200x900",600,1,600,400,"True",545,307,344,37,37,0
"C14LR",378,416,"1200x900",800,2,600,400,"False",748,617,317,-300,300,0
"C14LR",380,569,"1200x900",1000,1,600,400,"False",494,720,500,-220,220,0
"C14LR",381,34,"1200x900",600,0,600,400,"True",361,242,212,-30,30,1
"C14LR",382,502,"1200x900",1000,0,600,400,"False",111,639,396,-243,243,1
"C14LR",383,384,"1200x900",800,2,600,400,"False",821,707,621,-86,86,0
"C14LR",384,84,"1200x900",600,1,600,400,"False",144,184,293,109,109,0
"C14LR",385,367,"1200x900",800,2,600,400,"False",613,464,563,99,99,0
"C14LR",386,32,"1200x900",600,0,600,400,"False",152,563,491,-72,72,1
"C14LR",388,7,"1200x900",600,0,600,400,"False",431,654,556,-98,98,1
"C14LR",389,358,"1200x900",800,1,600,400,"False",263,635,187,-448,448,0
"C14LR",390,446,"1200x900",1000,0,600,400,"True",72,298,236,-62,62,1
"C14LR",391,190,"1200x900",600,2,600,400,"True",977,238,184,-54,54,0
"C14LR",392,104,"1200x900",600,1,600,400,"False",448,584,693,109,109,0
"C14LR",393,521,"1200x900",1000,1,600,400,"False",111,303,426,123,123,1
"C14LR",394,167,"1200x900",600,2,600,400,"False",956,241,523,282,282,0
"C14LR",395,113,"1200x900",600,1,600,400,"False",897,657,369,-288,288,0
"C14LR",396,261,"1200x900",800,0,600,400,"True",86,713,726,13,13,1
"C14LR",397,637,"1200x900",1000,2,600,400,"True",750,460,495,35,35,0
"C14LR",398,132,"1200x900",600,1,600,400,"False",333,185,350,165,165,0
"C14LR",399,275,"1200x900",800,0,600,400,"True",120,594,588,-6,6,0
"C14LR",400,141,"1200x900",600,1,600,400,"True",671,582,531,-51,51,0
"C14LR",401,644,"1200x900",1000,2,600,400,"False",495,486,559,73,73,0
"C14LR",402,151,"1200x900",600,2,600,400,"False",828,680,574,-106,106,0
"C14LR",403,92,"1200x900",600,1,600,400,"True",624,605,630,25,25,0
"C14LR",404,429,"1200x900",800,2,600,400,"True",682,692,669,-23,23,0
"C14LR",405,328,"1200x900",800,1,600,400,"False",104,649,563,-86,86,0
"C14LR",406,72,"1200x900",600,0,600,400,"True",158,537,544,7,7,0
"C14LR",407,228,"1200x900",800,0,600,400,"False",174,687,618,-69,69,1
"C14LR",408,281,"1200x900",800,0,600,400,"True",112,611,599,-12,12,1
"C14LR",409,39,"1200x900",600,0,600,400,"True",210,609,571,-38,38,0
"C14LR",411,56,"1200x900",600,0,600,400,"True",148,491,476,-15,15,0
"C14LR",412,126,"1200x900",600,1,600,400,"False",849,354,493,139,139,0
"C14LR",413,385,"1200x900",800,2,600,400,"True",740,456,429,-27,27,0
"C14LR",414,44,"1200x900",600,0,600,400,"True",305,554,510,-44,44,1
"C14LR",415,232,"1200x900",800,0,600,400,"True",84,511,485,-26,26,1
"C14LR",417,162,"1200x900",600,2,600,400,"False",849,279,458,179,179,0
"C14LR",418,452,"1200x900",1000,0,600,400,"True",97,273,288,15,15,1
"C14LR",419,21,"1200x900",600,0,600,400,"True",314,383,382,-1,1,1
"C14LR",420,364,"1200x900",800,2,600,400,"False",1018,204,614,410,410,0
"C14LR",421,51,"1200x900",600,0,600,400,"True",272,181,164,-17,17,1
"C14LR",422,487,"1200x900",1000,0,600,400,"False",78,670,485,-185,185,1
"C14LR",424,548,"1200x900",1000,1,600,400,"False",103,278,497,219,219,0
"C14LR",425,282,"1200x900",800,0,600,400,"True",109,246,234,-12,12,1
"C14LR",426,350,"1200x900",800,1,600,400,"False",182,566,306,-260,260,0
"C14LR",427,298,"1200x900",800,1,600,400,"False",311,457,357,-100,100,0
"C14LR",428,455,"1200x900",1000,0,600,400,"False",107,718,607,-111,111,1
"C14LR",429,279,"1200x900",800,0,600,400,"True",252,202,226,24,24,1
"C14LR",430,166,"1200x900",600,2,600,400,"True",896,274,335,61,61,0
"C14LR",431,563,"1200x900",1000,1,600,400,"False",201,696,454,-242,242,0
"C14LR",432,88,"1200x900",600,1,600,400,"True",186,554,517,-37,37,0
"C14LR",433,399,"1200x900",800,2,600,400,"False",603,602,486,-116,116,0
"C14LR",434,213,"1200x900",600,2,600,400,"True",822,275,320,45,45,0
"C14LR",435,70,"1200x900",600,0,600,400,"True",309,703,706,3,3,1
"C14LR",436,69,"1200x900",600,0,600,400,"True",322,268,214,-54,54,0
"C14LR",437,619,"1200x900",1000,2,600,400,"False",803,247,507,260,260,0
"C14LR",438,250,"1200x900",800,0,600,400,"True",290,248,249,1,1,1
"C14LR",439,573,"1200x900",1000,1,600,400,"False",486,615,409,-206,206,0
"C14LR",440,58,"1200x900",600,0,600,400,"True",353,655,664,9,9,1
"C14LR",441,467,"1200x900",1000,0,600,400,"True",74,712,675,-37,37,1
"C14LR",442,263,"1200x900",800,0,600,400,"True",82,396,443,47,47,1
"C14LR",443,97,"1200x900",600,1,600,400,"True",760,643,664,21,21,1
"C14LR",444,405,"1200x900",800,2,600,400,"False",790,307,590,283,283,0
"C14LR",445,565,"1200x900",1000,1,600,400,"False",451,562,631,69,69,0
"C14LR",446,297,"1200x900",800,1,600,400,"False",625,244,416,172,172,0
"C14LR",447,539,"1200x900",1000,1,600,400,"True",510,383,316,-67,67,0
"C14LR",448,118,"1200x900",600,1,600,400,"True",190,588,601,13,13,0
"C14LR",449,468,"1200x900",1000,0,600,400,"False",121,219,317,98,98,1
"C14LR",450,518,"1200x900",1000,1,600,400,"False",583,717,569,-148,148,0
"C14LR",451,116,"1200x900",600,1,600,400,"False",767,289,219,-70,70,0
"C14LR",452,515,"1200x900",1000,1,600,400,"False",307,217,435,218,218,0
"C14LR",453,332,"1200x900",800,1,600,400,"True",260,699,751,52,52,0
"C14LR",454,572,"1200x900",1000,1,600,400,"False",302,260,532,272,272,0
"C14LR",455,348,"1200x900",800,1,600,400,"False",764,294,487,193,193,0
"C14LR",456,152,"1200x900",600,2,600,400,"False",971,399,573,174,174,0
"C14LR",457,537,"1200x900",1000,1,600,400,"False",621,412,574,162,162,1
"C14LR",458,436,"1200x900",1000,0,600,400,"False",82,617,702,85,85,1
"C14LR",459,456,"1200x900",1000,0,600,400,"True",91,257,255,-2,2,1
"C14LR",460,368,"1200x900",800,2,600,400,"False",778,515,354,-161,161,0
"C14LR",461,174,"1200x900",600,2,600,400,"True",998,457,469,12,12,0
"C14LR",462,397,"1200x900",800,2,600,400,"False",817,692,442,-250,250,0
"C14LR",463,567,"1200x900",1000,1,600,400,"False",655,297,216,-81,81,1
"C14LR",464,75,"1200x900",600,1,600,400,"True",635,558,526,-32,32,0
"C14LR",465,451,"1200x900",1000,0,600,400,"False",110,702,545,-157,157,1
"C14LR",466,490,"1200x900",1000,0,600,400,"True",114,183,203,20,20,1
"C14LR",467,554,"1200x900",1000,1,600,400,"True",79,309,352,43,43,1
"C14LR",468,284,"1200x900",800,0,600,400,"True",135,293,325,32,32,1
"C14LR",469,407,"1200x900",800,2,600,400,"True",989,340,425,85,85,0
"C14LR",470,286,"1200x900",800,0,600,400,"False",105,378,293,-85,85,1
"C14LR",472,225,"1200x900",800,0,600,400,"True",178,423,453,30,30,1
"C14LR",473,86,"1200x900",600,1,600,400,"False",692,388,311,-77,77,1
"C14LR",474,83,"1200x900",600,1,600,400,"False",763,568,418,-150,150,1
"C14LR",475,601,"1200x900",1000,2,600,400,"False",735,697,535,-162,162,0
"C14LR",476,224,"1200x900",800,0,600,400,"True",161,474,465,-9,9,1
"C14LR",477,163,"1200x900",600,2,600,400,"True",1046,665,633,-32,32,0
"C14LR",478,244,"1200x900",800,0,600,400,"False",194,203,403,200,200,1
"C14LR",479,443,"1200x900",1000,0,600,400,"False",99,651,405,-246,246,1
"C14LR",480,547,"1200x900",1000,1,600,400,"False",369,384,256,-128,128,1
"C14LR",481,262,"1200x900",800,0,600,400,"True",196,481,415,-66,66,1
"C14LR",482,403,"1200x900",800,2,600,400,"False",625,704,506,-198,198,0
"C14LR",483,258,"1200x900",800,0,600,400,"True",126,664,694,30,30,1
"C14LR",484,469,"1200x900",1000,0,600,400,"True",73,227,245,18,18,1
"C14LR",485,276,"1200x900",800,0,600,400,"True",281,217,167,-50,50,1
"C14LR",486,533,"1200x900",1000,1,600,400,"False",355,483,349,-134,134,0
"C14LR",487,630,"1200x900",1000,2,600,400,"True",754,559,511,-48,48,0
"C14LR",489,218,"1200x900",800,0,600,400,"True",106,397,398,1,1,1
"C14LR",490,457,"1200x900",1000,0,600,400,"False",97,630,529,-101,101,1
"C14LR",491,220,"1200x900",800,0,600,400,"False",108,699,568,-131,131,1
"C14LR",492,159,"1200x900",600,2,600,400,"True",992,309,268,-41,41,0
"C14LR",493,600,"1200x900",1000,2,600,400,"False",765,207,442,235,235,0
"C14LR",494,330,"1200x900",800,1,600,400,"False",759,301,147,-154,154,1
"C14LR",495,283,"1200x900",800,0,600,400,"True",90,264,241,-23,23,1
"C14LR",496,618,"1200x900",1000,2,600,400,"False",276,671,569,-102,102,0
"C14LR",497,571,"1200x900",1000,1,600,400,"True",239,522,564,42,42,1
"C14LR",498,319,"1200x900",800,1,600,400,"False",494,587,661,74,74,1
"C14LR",499,545,"1200x900",1000,1,600,400,"True",358,562,579,17,17,0
"C14LR",501,483,"1200x900",1000,0,600,400,"True",93,191,225,34,34,1
"C14LR",502,287,"1200x900",800,0,600,400,"False",120,567,409,-158,158,1
"C14LR",503,295,"1200x900",800,1,600,400,"False",471,334,249,-85,85,0
"C14LR",504,290,"1200x900",800,1,600,400,"False",789,603,437,-166,166,0
"C14LR",505,559,"1200x900",1000,1,600,400,"True",641,244,269,25,25,0
"C14LR",506,594,"1200x900",1000,2,600,400,"False",537,637,416,-221,221,0
"C14LR",507,478,"1200x900",1000,0,600,400,"False",79,672,579,-93,93,1
"C14LR",509,505,"1200x900",1000,1,600,400,"False",191,484,353,-131,131,1
"C14LR",510,245,"1200x900",800,0,600,400,"True",296,235,255,20,20,1
"C14LR",511,323,"1200x900",800,1,600,400,"False",388,348,441,93,93,0
"C14LR",512,168,"1200x900",600,2,600,400,"False",1001,439,306,-133,133,0
"C14LR",513,421,"1200x900",800,2,600,400,"False",898,394,147,-247,247,0
"C14LR",514,222,"1200x900",800,0,600,400,"True",152,206,186,-20,20,1
"C14LR",516,647,"1200x900",1000,2,600,400,"False",560,637,354,-283,283,0
"C14LR",517,65,"1200x900",600,0,600,400,"False",442,645,585,-60,60,1
"C14LR",518,461,"1200x900",1000,0,600,400,"True",95,711,675,-36,36,1
"C14LR",519,434,"1200x900",1000,0,600,400,"False",89,657,382,-275,275,1
"C14LR",520,589,"1200x900",1000,2,600,400,"False",856,418,581,163,163,0
"C14LR",521,366,"1200x900",800,2,600,400,"False",931,464,380,-84,84,0
"C14LR",522,324,"1200x900",800,1,600,400,"False",719,712,424,-288,288,1
"C14LR",523,235,"1200x900",800,0,600,400,"True",146,646,618,-28,28,1
"C14LR",524,259,"1200x900",800,0,600,400,"False",156,180,250,70,70,1
"C14LR",525,179,"1200x900",600,2,600,400,"True",908,602,591,-11,11,0
"C14LR",526,355,"1200x900",800,1,600,400,"False",77,386,479,93,93,0
"C14LR",527,156,"1200x900",600,2,600,400,"True",913,197,265,68,68,0
"C14LR",528,425,"1200x900",800,2,600,400,"True",621,438,450,12,12,0
"C14LR",529,636,"1200x900",1000,2,600,400,"False",575,583,336,-247,247,0
"C14LR",530,419,"1200x900",800,2,600,400,"False",769,351,450,99,99,0
"C14LR",531,265,"1200x900",800,0,600,400,"False",229,353,205,-148,148,1
"C14LR",532,146,"1200x900",600,2,600,400,"False",989,492,278,-214,214,0
"C14LR",533,543,"1200x900",1000,1,600,400,"False",88,202,553,351,351,0
"C14LR",534,584,"1200x900",1000,2,600,400,"False",731,413,292,-121,121,0
"C14LR",535,139,"1200x900",600,1,600,400,"True",192,695,691,-4,4,0
"C14LR",536,353,"1200x900",800,1,600,400,"False",90,476,762,286,286,0
"C14LR",537,205,"1200x900",600,2,600,400,"False",1021,504,593,89,89,0
"C14LR",538,255,"1200x900",800,0,600,400,"True",93,709,684,-25,25,1
"C14LR",539,529,"1200x900",1000,1,600,400,"False",267,412,588,176,176,1
"C14LR",540,511,"1200x900",1000,1,600,400,"False",408,390,502,112,112,1
"C14LR",541,260,"1200x900",800,0,600,400,"True",103,525,510,-15,15,1
"C14LR",542,645,"1200x900",1000,2,600,400,"False",619,396,608,212,212,0
"C14LR",543,210,"1200x900",600,2,600,400,"False",835,506,338,-168,168,0
"C14LR",544,422,"1200x900",800,2,600,400,"False",712,558,262,-296,296,0
"C14LR",545,558,"1200x900",1000,1,600,400,"False",72,464,583,119,119,1
"C14LR",546,462,"1200x900",1000,0,600,400,"True",102,672,638,-34,34,1
"C14LR",547,192,"1200x900",600,2,600,400,"False",1064,320,657,337,337,0
"C14LR",548,506,"1200x900",1000,1,600,400,"False",559,567,300,-267,267,1
"C14LR",549,580,"1200x900",1000,2,600,400,"False",651,267,453,186,186,0
"C14LR",551,536,"1200x900",1000,1,600,400,"False",580,213,646,433,433,0
"C14LR",552,410,"1200x900",800,2,600,400,"False",916,477,193,-284,284,0
"C14LR",553,137,"1200x900",600,1,600,400,"False",789,577,493,-84,84,0
"C14LR",555,499,"1200x900",1000,0,600,400,"True",93,271,242,-29,29,1
"C14LR",556,509,"1200x900",1000,1,600,400,"False",509,434,322,-112,112,0
"C14LR",557,17,"1200x900",600,0,600,400,"True",402,496,447,-49,49,1
"C14LR",559,176,"1200x900",600,2,600,400,"True",1033,281,323,42,42,0
"C14LR",560,497,"1200x900",1000,0,600,400,"False",106,696,586,-110,110,1
"C14LR",561,107,"1200x900",600,1,600,400,"False",878,678,550,-128,128,0
"C14LR",562,238,"1200x900",800,0,600,400,"True",162,283,244,-39,39,1
"C14LR",563,143,"1200x900",600,1,600,400,"False",479,284,366,82,82,1
"C14LR",564,78,"1200x900",600,1,600,400,"True",885,684,673,-11,11,0
"C14LR",565,157,"1200x900",600,2,600,400,"False",1016,323,222,-101,101,0
"C14LR",566,189,"1200x900",600,2,600,400,"False",881,397,335,-62,62,0
"C14LR",568,201,"1200x900",600,2,600,400,"False",1005,462,397,-65,65,0
"C14LR",569,495,"1200x900",1000,0,600,400,"True",93,692,666,-26,26,1
"C14LR",570,71,"1200x900",600,0,600,400,"True",219,248,197,-51,51,0
"C14LR",571,291,"1200x900",800,1,600,400,"False",522,694,512,-182,182,0
"C14LR",572,326,"1200x900",800,1,600,400,"False",103,482,307,-175,175,0
"C14LR",573,101,"1200x900",600,1,600,400,"True",541,656,561,-95,95,0
"C14LR",574,73,"1200x900",600,1,600,400,"True",94,665,588,-77,77,0
"C14LR",575,300,"1200x900",800,1,600,400,"True",620,693,667,-26,26,0
"C14LR",576,352,"1200x900",800,1,600,400,"False",235,717,627,-90,90,0
"C14LR",577,437,"1200x900",1000,0,600,400,"False",74,667,525,-142,142,1
"C14LR",578,264,"1200x900",800,0,600,400,"True",198,660,682,22,22,1
"C14LR",579,583,"1200x900",1000,2,600,400,"True",949,284,314,30,30,1
"C14LR",580,106,"1200x900",600,1,600,400,"False",803,659,579,-80,80,1
"C14LR",581,124,"1200x900",600,1,600,400,"True",345,467,458,-9,9,0
"C14LR",582,432,"1200x900",800,2,600,400,"False",792,380,127,-253,253,0
"C14LR",583,388,"1200x900",800,2,600,400,"False",930,320,509,189,189,0
"C14LR",584,579,"1200x900",1000,2,600,400,"True",803,394,425,31,31,0
"C14LR",585,102,"1200x900",600,1,600,400,"True",861,603,582,-21,21,0
"C14LR",586,184,"1200x900",600,2,600,400,"False",1067,441,668,227,227,0
"C14LR",587,523,"1200x900",1000,1,600,400,"False",339,318,525,207,207,0
"C14LR",588,354,"1200x900",800,1,600,400,"False",118,236,336,100,100,0
"C14LR",589,453,"1200x900",1000,0,600,400,"True",71,393,354,-39,39,1
"C14LR",590,311,"1200x900",800,1,600,400,"False",710,261,443,182,182,0
"C14LR",591,342,"1200x900",800,1,600,400,"False",677,204,370,166,166,0
"C14LR",593,524,"1200x900",1000,1,600,400,"True",534,470,504,34,34,0
"C14LR",594,465,"1200x900",1000,0,600,400,"True",85,203,219,16,16,1
"C14LR",596,5,"1200x900",600,0,600,400,"True",228,587,539,-48,48,0
"C14LR",597,555,"1200x900",1000,1,600,400,"False",444,556,650,94,94,0
"C14LR",598,27,"1200x900",600,0,600,400,"False",373,309,211,-98,98,1
"C14LR",599,365,"1200x900",800,2,600,400,"False",1055,305,436,131,131,0
"C14LR",600,339,"1200x900",800,1,600,400,"False",273,545,305,-240,240,1
"C14LR",601,409,"1200x900",800,2,600,400,"True",501,659,607,-52,52,0
"C14LR",602,117,"1200x900",600,1,600,400,"False",711,456,264,-192,192,0
"C14LR",603,270,"1200x900",800,0,600,400,"False",192,418,263,-155,155,1
"C14LR",604,486,"1200x900",1000,0,600,400,"False",102,676,460,-216,216,1
"C14LR",605,28,"1200x900",600,0,600,400,"False",336,410,341,-69,69,1
"C14LR",606,76,"1200x900",600,1,600,400,"False",647,614,703,89,89,0
"C14LR",607,57,"1200x900",600,0,600,400,"True",354,508,501,-7,7,1
"C14LR",608,357,"1200x900",800,1,600,400,"False",109,594,414,-180,180,0
"C14LR",609,11,"1200x900",600,0,600,400,"True",372,670,608,-62,62,1
"C14LR",610,542,"1200x900",1000,1,600,400,"True",304,401,354,-47,47,0
"C14LR",611,492,"1200x900",1000,0,600,400,"False",76,692,521,-171,171,1
"C14LR",612,550,"1200x900",1000,1,600,400,"False",301,459,623,164,164,0
"C14LR",613,338,"1200x900",800,1,600,400,"True",813,253,286,33,33,1
"C14LR",615,209,"1200x900",600,2,600,400,"False",937,637,392,-245,245,0
"C14LR",616,177,"1200x900",600,2,600,400,"True",912,236,240,4,4,0
"C14LR",619,390,"1200x900",800,2,600,400,"True",982,674,580,-94,94,1
"C14LR",620,79,"1200x900",600,1,600,400,"False",731,289,467,178,178,0
"C14LR",621,170,"1200x900",600,2,600,400,"True",996,468,464,-4,4,0
"C14LR",622,553,"1200x900",1000,1,600,400,"False",116,712,206,-506,506,0
"C14LR",623,551,"1200x900",1000,1,600,400,"True",146,445,386,-59,59,1
"C14LR",624,591,"1200x900",1000,2,600,400,"False",698,336,493,157,157,0
"C14LR",625,494,"1200x900",1000,0,600,400,"True",127,692,694,2,2,1
"C14LR",626,269,"1200x900",800,0,600,400,"True",160,295,238,-57,57,1
"C14LR",628,243,"1200x900",800,0,600,400,"False",114,332,255,-77,77,1
"C14LR",629,50,"1200x900",600,0,600,400,"False",75,582,488,-94,94,0
"C14LR",630,183,"1200x900",600,2,600,400,"True",927,289,282,-7,7,0
"C14LR",631,393,"1200x900",800,2,600,400,"False",657,620,270,-350,350,0
"C14LR",632,292,"1200x900",800,1,600,400,"True",88,565,569,4,4,0
"C14LR",633,216,"1200x900",600,2,600,400,"False",1029,286,412,126,126,0
"C14LR",634,400,"1200x900",800,2,600,400,"False",733,297,431,134,134,0
"C14LR",635,142,"1200x900",600,1,600,400,"False",286,474,623,149,149,0
"C14LR",636,444,"1200x900",1000,0,600,400,"True",101,714,655,-59,59,1
"C14LR",637,154,"1200x900",600,2,600,400,"True",941,454,414,-40,40,0
"C14LR",638,100,"1200x900",600,1,600,400,"True",453,511,480,-31,31,0
"C14LR",639,308,"1200x900",800,1,600,400,"True",437,425,426,1,1,0
"C14LR",640,610,"1200x900",1000,2,600,400,"False",702,293,545,252,252,0
"C14LR",641,191,"1200x900",600,2,600,400,"True",962,396,349,-47,47,0
"C14LR",642,581,"1200x900",1000,2,600,400,"True",310,357,344,-13,13,0
"C14LR",643,134,"1200x900",600,1,600,400,"True",300,188,165,-23,23,0
"C14LR",644,3,"1200x900",600,0,600,400,"False",298,443,294,-149,149,1
"C14LR",645,588,"1200x900",1000,2,600,400,"True",585,350,403,53,53,0
"C14LR",646,46,"1200x900",600,0,600,400,"True",193,355,376,21,21,1
"C14LR",647,12,"1200x900",600,0,600,400,"True",365,336,317,-19,19,1
"C14LR",648,608,"1200x900",1000,2,600,400,"False",742,250,475,225,225,0
"C15SC",1,262,"1200x900",800,0,600,400,"True",196,481,426,-55,55,1
"C15SC",2,385,"1200x900",800,2,600,400,"True",740,456,432,-24,24,0
"C15SC",3,278,"1200x900",800,0,600,400,"False",251,711,602,-109,109,1
"C15SC",4,380,"1200x900",800,2,600,400,"True",942,228,230,2,2,0
"C15SC",5,115,"1200x900",600,1,600,400,"True",545,307,286,-21,21,0
"C15SC",6,295,"1200x900",800,1,600,400,"True",471,334,368,34,34,0
"C15SC",7,507,"1200x900",1000,1,600,400,"True",608,583,552,-31,31,1
"C15SC",8,229,"1200x900",800,0,600,400,"True",117,697,668,-29,29,1
"C15SC",9,640,"1200x900",1000,2,600,400,"False",361,334,513,179,179,0
"C15SC",10,77,"1200x900",600,1,600,400,"True",780,525,498,-27,27,0
"C15SC",11,308,"1200x900",800,1,600,400,"False",437,425,632,207,207,0
"C15SC",12,377,"1200x900",800,2,600,400,"False",683,388,309,-79,79,0
"C15SC",13,387,"1200x900",800,2,600,400,"False",990,444,181,-263,263,0
"C15SC",14,192,"1200x900",600,2,600,400,"False",1064,320,584,264,264,0
"C15SC",15,151,"1200x900",600,2,600,400,"False",828,680,558,-122,122,0
"C15SC",16,123,"1200x900",600,1,600,400,"True",761,365,341,-24,24,1
"C15SC",17,140,"1200x900",600,1,600,400,"True",700,523,504,-19,19,0
"C15SC",18,440,"1200x900",1000,0,600,400,"False",71,237,308,71,71,1
"C15SC",19,260,"1200x900",800,0,600,400,"True",103,525,502,-23,23,1
"C15SC",20,339,"1200x900",800,1,600,400,"False",273,545,615,70,70,1
"C15SC",21,80,"1200x900",600,1,600,400,"False",616,423,648,225,225,1
"C15SC",22,405,"1200x900",800,2,600,400,"False",790,307,450,143,143,0
"C15SC",23,36,"1200x900",600,0,600,400,"True",128,346,315,-31,31,1
"C15SC",24,351,"1200x900",800,1,600,400,"True",122,581,522,-59,59,0
"C15SC",25,310,"1200x900",800,1,600,400,"True",559,592,653,61,61,0
"C15SC",26,303,"1200x900",800,1,600,400,"True",241,431,426,-5,5,0
"C15SC",27,104,"1200x900",600,1,600,400,"True",448,584,640,56,56,0
"C15SC",28,449,"1200x900",1000,0,600,400,"False",105,683,511,-172,172,1
"C15SC",29,504,"1200x900",1000,0,600,400,"False",107,699,584,-115,115,1
"C15SC",30,549,"1200x900",1000,1,600,400,"True",657,366,404,38,38,0
"C15SC",31,543,"1200x900",1000,1,600,400,"False",88,202,443,241,241,0
"C15SC",32,286,"1200x900",800,0,600,400,"True",105,378,376,-2,2,1
"C15SC",33,2,"1200x900",600,0,600,400,"True",159,323,282,-41,41,0
"C15SC",34,471,"1200x900",1000,0,600,400,"False",122,200,264,64,64,1
"C15SC",35,200,"1200x900",600,2,600,400,"True",897,302,273,-29,29,0
"C15SC",36,25,"1200x900",600,0,600,400,"True",263,403,391,-12,12,1
"C15SC",37,298,"1200x900",800,1,600,400,"True",311,457,422,-35,35,0
"C15SC",38,355,"1200x900",800,1,600,400,"True",77,386,367,-19,19,0
"C15SC",39,122,"1200x900",600,1,600,400,"False",817,709,637,-72,72,0
"C15SC",40,607,"1200x900",1000,2,600,400,"False",900,573,476,-97,97,1
"C15SC",41,272,"1200x900",800,0,600,400,"True",200,181,183,2,2,1
"C15SC",42,450,"1200x900",1000,0,600,400,"True",130,204,253,49,49,1
"C15SC",43,227,"1200x900",800,0,600,400,"True",196,551,523,-28,28,1
"C15SC",44,293,"1200x900",800,1,600,400,"True",561,396,364,-32,32,0
"C15SC",45,553,"1200x900",1000,1,600,400,"False",116,712,599,-113,113,0
"C15SC",46,149,"1200x900",600,2,600,400,"False",890,289,387,98,98,0
"C15SC",47,365,"1200x900",800,2,600,400,"False",1055,305,446,141,141,0
"C15SC",48,361,"1200x900",800,2,600,400,"False",931,328,487,159,159,0
"C15SC",49,294,"1200x900",800,1,600,400,"False",262,287,406,119,119,0
"C15SC",50,217,"1200x900",800,0,600,400,"False",85,573,496,-77,77,1
"C15SC",51,441,"1200x900",1000,0,600,400,"False",85,684,575,-109,109,1
"C15SC",52,204,"1200x900",600,2,600,400,"False",1053,432,639,207,207,0
"C15SC",53,103,"1200x900",600,1,600,400,"True",528,320,347,27,27,1
"C15SC",54,392,"1200x900",800,2,600,400,"False",1031,618,243,-375,375,0
"C15SC",55,364,"1200x900",800,2,600,400,"False",1018,204,414,210,210,0
"C15SC",56,13,"1200x900",600,0,600,400,"True",296,211,204,-7,7,1
"C15SC",57,21,"1200x900",600,0,600,400,"True",314,383,330,-53,53,1
"C15SC",58,628,"1200x900",1000,2,600,400,"True",768,410,462,52,52,0
"C15SC",59,282,"1200x900",800,0,600,400,"True",109,246,293,47,47,1
"C15SC",60,416,"1200x900",800,2,600,400,"False",748,617,559,-58,58,0
"C15SC",61,642,"1200x900",1000,2,600,400,"True",776,316,315,-1,1,0
"C15SC",62,170,"1200x900",600,2,600,400,"True",996,468,471,3,3,0
"C15SC",63,163,"1200x900",600,2,600,400,"True",1046,665,633,-32,32,0
"C15SC",64,201,"1200x900",600,2,600,400,"True",1005,462,509,47,47,0
"C15SC",65,337,"1200x900",800,1,600,400,"True",299,622,619,-3,3,0
"C15SC",66,280,"1200x900",800,0,600,400,"True",104,302,325,23,23,1
"C15SC",67,88,"1200x900",600,1,600,400,"True",186,554,525,-29,29,0
"C15SC",68,548,"1200x900",1000,1,600,400,"False",103,278,351,73,73,0
"C15SC",69,267,"1200x900",800,0,600,400,"True",145,665,638,-27,27,1
"C15SC",70,75,"1200x900",600,1,600,400,"True",635,558,555,-3,3,0
"C15SC",71,568,"1200x900",1000,1,600,400,"True",286,475,515,40,40,1
"C15SC",72,601,"1200x900",1000,2,600,400,"False",735,697,594,-103,103,0
"C15SC",73,83,"1200x900",600,1,600,400,"True",763,568,568,0,0,1
"C15SC",74,190,"1200x900",600,2,600,400,"False",977,238,472,234,234,0
"C15SC",75,299,"1200x900",800,1,600,400,"False",779,274,450,176,176,0
"C15SC",76,58,"1200x900",600,0,600,400,"True",353,655,648,-7,7,1
"C15SC",77,594,"1200x900",1000,2,600,400,"True",537,637,650,13,13,0
"C15SC",78,248,"1200x900",800,0,600,400,"True",94,240,266,26,26,1
"C15SC",79,396,"1200x900",800,2,600,400,"True",678,663,630,-33,33,0
"C15SC",80,593,"1200x900",1000,2,600,400,"True",246,719,747,28,28,0
"C15SC",81,403,"1200x900",800,2,600,400,"True",625,704,658,-46,46,0
"C15SC",82,383,"1200x900",800,2,600,400,"False",855,407,508,101,101,0
"C15SC",83,598,"1200x900",1000,2,600,400,"True",706,559,549,-10,10,0
"C15SC",84,397,"1200x900",800,2,600,400,"True",817,692,692,0,0,0
"C15SC",85,290,"1200x900",800,1,600,400,"False",789,603,778,175,175,0
"C15SC",86,456,"1200x900",1000,0,600,400,"True",91,257,311,54,54,1
"C15SC",87,54,"1200x900",600,0,600,400,"False",474,564,491,-73,73,1
"C15SC",88,445,"1200x900",1000,0,600,400,"True",78,302,326,24,24,1
"C15SC",89,556,"1200x900",1000,1,600,400,"True",415,420,376,-44,44,0
"C15SC",90,401,"1200x900",800,2,600,400,"True",821,260,247,-13,13,0
"C15SC",91,477,"1200x900",1000,0,600,400,"True",88,640,593,-47,47,1
"C15SC",92,370,"1200x900",800,2,600,400,"True",874,336,313,-23,23,0
"C15SC",93,478,"1200x900",1000,0,600,400,"True",79,672,685,13,13,1
"C15SC",94,107,"1200x900",600,1,600,400,"False",878,678,606,-72,72,0
"C15SC",95,236,"1200x900",800,0,600,400,"True",162,350,364,14,14,1
"C15SC",96,219,"1200x900",800,0,600,400,"True",202,502,563,61,61,1
"C15SC",97,465,"1200x900",1000,0,600,400,"False",85,203,359,156,156,1
"C15SC",98,251,"1200x900",800,0,600,400,"True",88,352,375,23,23,1
"C15SC",99,143,"1200x900",600,1,600,400,"True",479,284,334,50,50,1
"C15SC",100,425,"1200x900",800,2,600,400,"True",621,438,389,-49,49,0
"C15SC",101,489,"1200x900",1000,0,600,400,"False",88,604,536,-68,68,1
"C15SC",102,131,"1200x900",600,1,600,400,"False",531,367,490,123,123,0
"C15SC",103,588,"1200x900",1000,2,600,400,"False",585,350,270,-80,80,0
"C15SC",104,574,"1200x900",1000,1,600,400,"True",614,194,244,50,50,0
"C15SC",105,292,"1200x900",800,1,600,400,"True",88,565,529,-36,36,0
"C15SC",106,257,"1200x900",800,0,600,400,"True",97,219,263,44,44,1
"C15SC",107,446,"1200x900",1000,0,600,400,"True",72,298,241,-57,57,1
"C15SC",108,472,"1200x900",1000,0,600,400,"False",77,685,587,-98,98,1
"C15SC",109,578,"1200x900",1000,2,600,400,"False",966,276,477,201,201,0
"C15SC",110,452,"1200x900",1000,0,600,400,"True",97,273,268,-5,5,1
"C15SC",111,563,"1200x900",1000,1,600,400,"False",201,696,552,-144,144,0
"C15SC",112,57,"1200x900",600,0,600,400,"True",354,508,518,10,10,1
"C15SC",113,634,"1200x900",1000,2,600,400,"True",735,313,309,-4,4,0
"C15SC",114,534,"1200x900",1000,1,600,400,"True",328,504,403,-101,101,1
"C15SC",115,524,"1200x900",1000,1,600,400,"True",534,470,418,-52,52,0
"C15SC",116,171,"1200x900",600,2,600,400,"False",909,200,348,148,148,0
"C15SC",117,544,"1200x900",1000,1,600,400,"False",602,620,513,-107,107,0
"C15SC",118,243,"1200x900",800,0,600,400,"True",114,332,291,-41,41,1
"C15SC",119,317,"1200x900",800,1,600,400,"True",185,564,503,-61,61,0
"C15SC",120,625,"1200x900",1000,2,600,400,"False",279,228,401,173,173,0
"C15SC",121,466,"1200x900",1000,0,600,400,"True",82,205,213,8,8,1
"C15SC",122,241,"1200x900",800,0,600,400,"True",129,227,198,-29,29,1
"C15SC",123,590,"1200x900",1000,2,600,400,"True",636,278,307,29,29,0
"C15SC",124,641,"1200x900",1000,2,600,400,"False",897,272,442,170,170,0
"C15SC",125,320,"1200x900",800,1,600,400,"True",644,376,320,-56,56,0
"C15SC",126,55,"1200x900",600,0,600,400,"True",211,305,317,12,12,1
"C15SC",128,560,"1200x900",1000,1,600,400,"False",516,693,595,-98,98,0
"C15SC",129,635,"1200x900",1000,2,600,400,"False",833,402,501,99,99,0
"C15SC",130,69,"1200x900",600,0,600,400,"True",322,268,227,-41,41,0
"C15SC",131,305,"1200x900",800,1,600,400,"False",471,716,631,-85,85,0
"C15SC",132,32,"1200x900",600,0,600,400,"True",152,563,548,-15,15,1
"C15SC",133,226,"1200x900",800,0,600,400,"True",187,229,252,23,23,1
"C15SC",134,386,"1200x900",800,2,600,400,"False",774,301,403,102,102,0
"C15SC",135,503,"1200x900",1000,0,600,400,"True",86,279,237,-42,42,1
"C15SC",136,422,"1200x900",800,2,600,400,"False",712,558,481,-77,77,0
"C15SC",137,356,"1200x900",800,1,600,400,"True",123,484,530,46,46,0
"C15SC",138,141,"1200x900",600,1,600,400,"True",671,582,545,-37,37,0
"C15SC",139,615,"1200x900",1000,2,600,400,"True",736,634,574,-60,60,0
"C15SC",140,249,"1200x900",800,0,600,400,"False",126,306,219,-87,87,1
"C15SC",141,195,"1200x900",600,2,600,400,"False",942,249,332,83,83,0
"C15SC",142,559,"1200x900",1000,1,600,400,"False",641,244,323,79,79,0
"C15SC",143,432,"1200x900",800,2,600,400,"True",792,380,351,-29,29,0
"C15SC",144,314,"1200x900",800,1,600,400,"True",277,616,561,-55,55,1
"C15SC",145,202,"1200x900",600,2,600,400,"True",966,460,546,86,86,0
"C15SC",146,411,"1200x900",800,2,600,400,"True",805,361,351,-10,10,0
"C15SC",147,109,"1200x900",600,1,600,400,"True",691,589,583,-6,6,0
"C15SC",148,264,"1200x900",800,0,600,400,"True",198,660,641,-19,19,1
"C15SC",149,110,"1200x900",600,1,600,400,"False",776,550,615,65,65,1
"C15SC",150,265,"1200x900",800,0,600,400,"True",229,353,295,-58,58,1
"C15SC",151,322,"1200x900",800,1,600,400,"False",703,206,319,113,113,1
"C15SC",152,570,"1200x900",1000,1,600,400,"True",315,352,401,49,49,0
"C15SC",153,329,"1200x900",800,1,600,400,"True",517,239,244,5,5,0
"C15SC",154,430,"1200x900",800,2,600,400,"True",922,254,249,-5,5,0
"C15SC",155,622,"1200x900",1000,2,600,400,"False",307,683,589,-94,94,0
"C15SC",156,632,"1200x900",1000,2,600,400,"False",984,227,458,231,231,0
"C15SC",157,626,"1200x900",1000,2,600,400,"False",329,449,357,-92,92,0
"C15SC",158,300,"1200x900",800,1,600,400,"True",620,693,692,-1,1,0
"C15SC",159,496,"1200x900",1000,0,600,400,"True",70,639,694,55,55,1
"C15SC",160,321,"1200x900",800,1,600,400,"True",601,190,224,34,34,0
"C15SC",161,533,"1200x900",1000,1,600,400,"True",355,483,412,-71,71,0
"C15SC",162,244,"1200x900",800,0,600,400,"True",194,203,236,33,33,1
"C15SC",163,159,"1200x900",600,2,600,400,"True",992,309,266,-43,43,0
"C15SC",164,156,"1200x900",600,2,600,400,"True",913,197,258,61,61,0
"C15SC",165,76,"1200x900",600,1,600,400,"False",647,614,725,111,111,0
"C15SC",166,461,"1200x900",1000,0,600,400,"True",95,711,651,-60,60,1
"C15SC",167,514,"1200x900",1000,1,600,400,"True",539,690,630,-60,60,0
"C15SC",168,644,"1200x900",1000,2,600,400,"False",495,486,588,102,102,0
"C15SC",169,164,"1200x900",600,2,600,400,"False",1051,268,410,142,142,0
"C15SC",170,297,"1200x900",800,1,600,400,"False",625,244,327,83,83,0
"C15SC",171,583,"1200x900",1000,2,600,400,"True",949,284,329,45,45,1
"C15SC",172,307,"1200x900",800,1,600,400,"True",716,247,223,-24,24,0
"C15SC",173,145,"1200x900",600,2,600,400,"False",1004,630,432,-198,198,0
"C15SC",174,283,"1200x900",800,0,600,400,"True",90,264,254,-10,10,1
"C15SC",175,459,"1200x900",1000,0,600,400,"False",70,645,564,-81,81,1
"C15SC",176,413,"1200x900",800,2,600,400,"False",849,506,403,-103,103,0
"C15SC",177,415,"1200x900",800,2,600,400,"False",823,684,520,-164,164,0
"C15SC",178,431,"1200x900",800,2,600,400,"False",694,382,633,251,251,0
"C15SC",179,26,"1200x900",600,0,600,400,"True",70,712,660,-52,52,0
"C15SC",180,462,"1200x900",1000,0,600,400,"True",102,672,686,14,14,1
"C15SC",181,179,"1200x900",600,2,600,400,"True",908,602,609,7,7,0
"C15SC",182,230,"1200x900",800,0,600,400,"True",99,678,618,-60,60,1
"C15SC",183,161,"1200x900",600,2,600,400,"True",939,553,596,43,43,0
"C15SC",184,50,"1200x900",600,0,600,400,"True",75,582,604,22,22,0
"C15SC",185,343,"1200x900",800,1,600,400,"True",407,557,553,-4,4,0
"C15SC",186,86,"1200x900",600,1,600,400,"True",692,388,347,-41,41,1
"C15SC",187,510,"1200x900",1000,1,600,400,"True",486,338,305,-33,33,1
"C15SC",188,529,"1200x900",1000,1,600,400,"False",267,412,293,-119,119,1
"C15SC",189,546,"1200x900",1000,1,600,400,"True",305,374,337,-37,37,0
"C15SC",190,284,"1200x900",800,0,600,400,"True",135,293,304,11,11,1
"C15SC",191,438,"1200x900",1000,0,600,400,"True",77,713,659,-54,54,1
"C15SC",192,627,"1200x900",1000,2,600,400,"True",760,510,471,-39,39,0
"C15SC",193,9,"1200x900",600,0,600,400,"True",509,654,612,-42,42,1
"C15SC",194,105,"1200x900",600,1,600,400,"False",527,440,564,124,124,0
"C15SC",195,589,"1200x900",1000,2,600,400,"True",856,418,463,45,45,0
"C15SC",196,451,"1200x900",1000,0,600,400,"True",110,702,677,-25,25,1
"C15SC",197,404,"1200x900",800,2,600,400,"False",842,396,528,132,132,0
"C15SC",198,240,"1200x900",800,0,600,400,"True",330,656,610,-46,46,1
"C15SC",199,348,"1200x900",800,1,600,400,"True",764,294,343,49,49,0
"C15SC",200,646,"1200x900",1000,2,600,400,"False",829,227,388,161,161,1
"C15SC",201,162,"1200x900",600,2,600,400,"True",849,279,285,6,6,0
"C15SC",202,35,"1200x900",600,0,600,400,"True",366,555,529,-26,26,1
"C15SC",204,242,"1200x900",800,0,600,400,"True",117,448,442,-6,6,1
"C15SC",205,542,"1200x900",1000,1,600,400,"False",304,401,329,-72,72,0
"C15SC",206,347,"1200x900",800,1,600,400,"False",757,295,444,149,149,1
"C15SC",207,231,"1200x900",800,0,600,400,"True",251,718,665,-53,53,1
"C15SC",208,53,"1200x900",600,0,600,400,"True",177,189,242,53,53,0
"C15SC",209,64,"1200x900",600,0,600,400,"True",102,339,277,-62,62,0
"C15SC",210,592,"1200x900",1000,2,600,400,"False",492,392,487,95,95,0
"C15SC",211,34,"1200x900",600,0,600,400,"True",361,242,295,53,53,1
"C15SC",212,374,"1200x900",800,2,600,400,"True",755,450,408,-42,42,0
"C15SC",213,256,"1200x900",800,0,600,400,"False",192,656,410,-246,246,1
"C15SC",214,561,"1200x900",1000,1,600,400,"False",231,406,475,69,69,0
"C15SC",215,178,"1200x900",600,2,600,400,"True",1041,510,416,-94,94,0
"C15SC",216,491,"1200x900",1000,0,600,400,"False",108,198,301,103,103,1
"C15SC",217,126,"1200x900",600,1,600,400,"True",849,354,359,5,5,0
"C15SC",218,63,"1200x900",600,0,600,400,"True",311,188,219,31,31,1
"C15SC",219,223,"1200x900",800,0,600,400,"True",179,191,207,16,16,1
"C15SC",220,558,"1200x900",1000,1,600,400,"False",72,464,336,-128,128,1
"C15SC",221,565,"1200x900",1000,1,600,400,"False",451,562,474,-88,88,0
"C15SC",222,618,"1200x900",1000,2,600,400,"True",276,671,638,-33,33,0
"C15SC",223,584,"1200x900",1000,2,600,400,"False",731,413,594,181,181,0
"C15SC",224,5,"1200x900",600,0,600,400,"True",228,587,567,-20,20,0
"C15SC",225,513,"1200x900",1000,1,600,400,"True",235,602,562,-40,40,0
"C15SC",226,648,"1200x900",1000,2,600,400,"False",557,394,579,185,185,0
"C15SC",227,527,"1200x900",1000,1,600,400,"True",565,601,556,-45,45,0
"C15SC",228,259,"1200x900",800,0,600,400,"True",156,180,212,32,32,1
"C15SC",229,40,"1200x900",600,0,600,400,"True",143,513,451,-62,62,0
"C15SC",230,218,"1200x900",800,0,600,400,"True",106,397,421,24,24,1
"C15SC",231,596,"1200x900",1000,2,600,400,"True",706,513,545,32,32,0
"C15SC",232,350,"1200x900",800,1,600,400,"True",182,566,557,-9,9,0
"C15SC",233,448,"1200x900",1000,0,600,400,"True",107,641,681,40,40,1
"C15SC",234,47,"1200x900",600,0,600,400,"True",303,499,527,28,28,1
"C15SC",235,487,"1200x900",1000,0,600,400,"True",78,670,627,-43,43,1
"C15SC",236,427,"1200x900",800,2,600,400,"True",812,380,390,10,10,0
"C15SC",237,599,"1200x900",1000,2,600,400,"False",316,570,477,-93,93,0
"C15SC",238,276,"1200x900",800,0,600,400,"False",281,217,289,72,72,1
"C15SC",239,271,"1200x900",800,0,600,400,"True",74,360,344,-16,16,1
"C15SC",240,358,"1200x900",800,1,600,400,"False",263,635,511,-124,124,0
"C15SC",241,395,"1200x900",800,2,600,400,"False",743,334,567,233,233,0
"C15SC",242,60,"1200x900",600,0,600,400,"True",365,213,272,59,59,1
"C15SC",243,442,"1200x900",1000,0,600,400,"True",87,183,211,28,28,1
"C15SC",244,182,"1200x900",600,2,600,400,"False",933,389,256,-133,133,0
"C15SC",245,121,"1200x900",600,1,600,400,"True",884,364,403,39,39,0
"C15SC",246,136,"1200x900",600,1,600,400,"True",264,205,261,56,56,0
"C15SC",247,181,"1200x900",600,2,600,400,"True",1018,223,247,24,24,0
"C15SC",248,225,"1200x900",800,0,600,400,"False",178,423,351,-72,72,1
"C15SC",249,196,"1200x900",600,2,600,400,"False",1030,397,341,-56,56,0
"C15SC",250,238,"1200x900",800,0,600,400,"True",162,283,300,17,17,1
"C15SC",251,334,"1200x900",800,1,600,400,"True",481,665,645,-20,20,0
"C15SC",252,117,"1200x900",600,1,600,400,"True",711,456,455,-1,1,0
"C15SC",253,384,"1200x900",800,2,600,400,"False",821,707,600,-107,107,0
"C15SC",254,426,"1200x900",800,2,600,400,"False",830,263,418,155,155,0
"C15SC",255,344,"1200x900",800,1,600,400,"True",589,408,396,-12,12,0
"C15SC",256,309,"1200x900",800,1,600,400,"False",186,225,485,260,260,0
"C15SC",257,11,"1200x900",600,0,600,400,"True",372,670,607,-63,63,1
"C15SC",258,519,"1200x900",1000,1,600,400,"True",319,565,570,5,5,1
"C15SC",259,301,"1200x900",800,1,600,400,"True",162,574,611,37,37,0
"C15SC",260,132,"1200x900",600,1,600,400,"True",333,185,163,-22,22,0
"C15SC",261,376,"1200x900",800,2,600,400,"True",788,275,270,-5,5,0
"C15SC",262,234,"1200x900",800,0,600,400,"True",72,344,282,-62,62,1
"C15SC",263,381,"1200x900",800,2,600,400,"True",705,408,355,-53,53,0
"C15SC",264,479,"1200x900",1000,0,600,400,"True",74,705,649,-56,56,1
"C15SC",265,23,"1200x900",600,0,600,400,"True",308,463,426,-37,37,1
"C15SC",266,367,"1200x900",800,2,600,400,"True",613,464,518,54,54,0
"C15SC",267,531,"1200x900",1000,1,600,400,"False",233,362,437,75,75,0
"C15SC",268,536,"1200x900",1000,1,600,400,"True",580,213,229,16,16,0
"C15SC",269,562,"1200x900",1000,1,600,400,"True",347,540,539,-1,1,0
"C15SC",270,522,"1200x900",1000,1,600,400,"False",223,379,618,239,239,0
"C15SC",271,61,"1200x900",600,0,600,400,"False",272,670,503,-167,167,1
"C15SC",272,359,"1200x900",800,1,600,400,"False",653,241,330,89,89,0
"C15SC",273,604,"1200x900",1000,2,600,400,"False",459,593,503,-90,90,0
"C15SC",274,65,"1200x900",600,0,600,400,"False",442,645,516,-129,129,1
"C15SC",275,624,"1200x900",1000,2,600,400,"True",693,501,550,49,49,0
"C15SC",276,144,"1200x900",600,1,600,400,"True",718,371,437,66,66,0
"C15SC",277,585,"1200x900",1000,2,600,400,"False",698,688,556,-132,132,1
"C15SC",278,516,"1200x900",1000,1,600,400,"True",440,559,527,-32,32,0
"C15SC",279,394,"1200x900",800,2,600,400,"False",847,292,400,108,108,0
"C15SC",280,43,"1200x900",600,0,600,400,"True",277,446,416,-30,30,1
"C15SC",281,437,"1200x900",1000,0,600,400,"True",74,667,628,-39,39,1
"C15SC",282,150,"1200x900",600,2,600,400,"False",897,345,508,163,163,0
"C15SC",283,492,"1200x900",1000,0,600,400,"False",76,692,599,-93,93,1
"C15SC",284,340,"1200x900",800,1,600,400,"False",226,240,393,153,153,0
"C15SC",285,288,"1200x900",800,0,600,400,"True",180,547,542,-5,5,1
"C15SC",286,29,"1200x900",600,0,600,400,"True",385,533,569,36,36,1
"C15SC",287,518,"1200x900",1000,1,600,400,"False",583,717,608,-109,109,0
"C15SC",288,281,"1200x900",800,0,600,400,"True",112,611,658,47,47,1
"C15SC",289,421,"1200x900",800,2,600,400,"True",898,394,420,26,26,0
"C15SC",290,619,"1200x900",1000,2,600,400,"True",803,247,317,70,70,0
"C15SC",291,96,"1200x900",600,1,600,400,"True",433,458,502,44,44,0
"C15SC",292,511,"1200x900",1000,1,600,400,"False",408,390,475,85,85,1
"C15SC",293,482,"1200x900",1000,0,600,400,"True",79,686,635,-51,51,1
"C15SC",294,220,"1200x900",800,0,600,400,"True",108,699,645,-54,54,1
"C15SC",295,614,"1200x900",1000,2,600,400,"True",823,563,635,72,72,0
"C15SC",296,133,"1200x900",600,1,600,400,"False",345,551,471,-80,80,0
"C15SC",297,12,"1200x900",600,0,600,400,"False",365,336,187,-149,149,1
"C15SC",298,206,"1200x900",600,2,600,400,"True",975,223,204,-19,19,0
"C15SC",299,557,"1200x900",1000,1,600,400,"True",677,505,543,38,38,1
"C15SC",300,616,"1200x900",1000,2,600,400,"True",854,357,325,-32,32,1
"C15SC",301,8,"1200x900",600,0,600,400,"False",156,679,539,-140,140,0
"C15SC",302,532,"1200x900",1000,1,600,400,"False",215,207,332,125,125,0
"C15SC",303,212,"1200x900",600,2,600,400,"False",841,206,291,85,85,0
"C15SC",304,311,"1200x900",800,1,600,400,"False",710,261,432,171,171,0
"C15SC",305,180,"1200x900",600,2,600,400,"True",929,270,256,-14,14,0
"C15SC",306,473,"1200x900",1000,0,600,400,"True",75,323,275,-48,48,1
"C15SC",307,139,"1200x900",600,1,600,400,"True",192,695,691,-4,4,0
"C15SC",308,330,"1200x900",800,1,600,400,"True",759,301,252,-49,49,1
"C15SC",309,506,"1200x900",1000,1,600,400,"False",559,567,487,-80,80,1
"C15SC",310,357,"1200x900",800,1,600,400,"True",109,594,638,44,44,0
"C15SC",311,494,"1200x900",1000,0,600,400,"True",127,692,693,1,1,1
"C15SC",312,402,"1200x900",800,2,600,400,"False",878,234,340,106,106,0
"C15SC",313,575,"1200x900",1000,1,600,400,"True",272,693,664,-29,29,0
"C15SC",314,28,"1200x900",600,0,600,400,"True",336,410,362,-48,48,1
"C15SC",315,33,"1200x900",600,0,600,400,"True",198,533,506,-27,27,1
"C15SC",316,125,"1200x900",600,1,600,400,"True",750,531,549,18,18,0
"C15SC",317,573,"1200x900",1000,1,600,400,"True",486,615,619,4,4,0
"C15SC",318,51,"1200x900",600,0,600,400,"True",272,181,199,18,18,1
"C15SC",319,484,"1200x900",1000,0,600,400,"True",100,223,204,-19,19,1
"C15SC",320,252,"1200x900",800,0,600,400,"True",224,673,614,-59,59,1
"C15SC",321,18,"1200x900",600,0,600,400,"True",400,318,323,5,5,1
"C15SC",322,636,"1200x900",1000,2,600,400,"False",575,583,419,-164,164,0
"C15SC",323,48,"1200x900",600,0,600,400,"True",323,645,596,-49,49,1
"C15SC",324,20,"1200x900",600,0,600,400,"True",204,545,562,17,17,1
"C15SC",325,207,"1200x900",600,2,600,400,"False",838,235,334,99,99,0
"C15SC",326,127,"1200x900",600,1,600,400,"True",309,691,663,-28,28,0
"C15SC",327,608,"1200x900",1000,2,600,400,"True",742,250,278,28,28,0
"C15SC",328,239,"1200x900",800,0,600,400,"True",114,231,244,13,13,1
"C15SC",329,42,"1200x900",600,0,600,400,"False",233,479,397,-82,82,0
"C15SC",330,447,"1200x900",1000,0,600,400,"True",71,339,327,-12,12,1
"C15SC",331,39,"1200x900",600,0,600,400,"False",210,609,526,-83,83,0
"C15SC",332,102,"1200x900",600,1,600,400,"False",861,603,681,78,78,0
"C15SC",333,493,"1200x900",1000,0,600,400,"True",80,582,649,67,67,1
"C15SC",334,84,"1200x900",600,1,600,400,"True",144,184,163,-21,21,0
"C15SC",335,165,"1200x900",600,2,600,400,"True",912,554,590,36,36,0
"C15SC",336,535,"1200x900",1000,1,600,400,"True",372,410,377,-33,33,0
"C15SC",337,49,"1200x900",600,0,600,400,"True",109,380,358,-22,22,0
"C15SC",338,312,"1200x900",800,1,600,400,"False",238,683,544,-139,139,0
"C15SC",339,199,"1200x900",600,2,600,400,"False",992,467,575,108,108,0
"C15SC",340,470,"1200x900",1000,0,600,400,"True",91,666,698,32,32,1
"C15SC",341,189,"1200x900",600,2,600,400,"True",881,397,380,-17,17,0
"C15SC",342,371,"1200x900",800,2,600,400,"False",730,560,378,-182,182,0
"C15SC",343,6,"1200x900",600,0,600,400,"True",217,689,660,-29,29,1
"C15SC",344,154,"1200x900",600,2,600,400,"True",941,454,539,85,85,0
"C15SC",345,433,"1200x900",1000,0,600,400,"True",76,222,265,43,43,1
"C15SC",346,112,"1200x900",600,1,600,400,"True",681,490,536,46,46,0
"C15SC",347,545,"1200x900",1000,1,600,400,"True",358,562,523,-39,39,0
"C15SC",348,167,"1200x900",600,2,600,400,"False",956,241,431,190,190,0
"C15SC",349,268,"1200x900",800,0,600,400,"True",148,400,393,-7,7,1
"C15SC",350,595,"1200x900",1000,2,600,400,"False",687,640,420,-220,220,0
"C15SC",351,423,"1200x900",800,2,600,400,"False",1051,710,580,-130,130,1
"C15SC",352,613,"1200x900",1000,2,600,400,"True",690,374,389,15,15,0
"C15SC",353,208,"1200x900",600,2,600,400,"True",946,399,360,-39,39,0
"C15SC",354,497,"1200x900",1000,0,600,400,"True",106,696,716,20,20,1
"C15SC",355,373,"1200x900",800,2,600,400,"False",694,326,438,112,112,0
"C15SC",356,261,"1200x900",800,0,600,400,"True",86,713,663,-50,50,1
"C15SC",357,7,"1200x900",600,0,600,400,"True",431,654,726,72,72,1
"C15SC",358,369,"1200x900",800,2,600,400,"True",903,594,511,-83,83,0
"C15SC",359,277,"1200x900",800,0,600,400,"True",140,310,320,10,10,1
"C15SC",360,498,"1200x900",1000,0,600,400,"True",100,260,199,-61,61,1
"C15SC",361,185,"1200x900",600,2,600,400,"True",907,212,281,69,69,0
"C15SC",362,444,"1200x900",1000,0,600,400,"True",101,714,686,-28,28,1
"C15SC",363,488,"1200x900",1000,0,600,400,"True",129,687,689,2,2,1
"C15SC",364,71,"1200x900",600,0,600,400,"True",219,248,261,13,13,0
"C15SC",365,453,"1200x900",1000,0,600,400,"True",71,393,379,-14,14,1
"C15SC",366,623,"1200x900",1000,2,600,400,"True",636,527,542,15,15,0
"C15SC",367,333,"1200x900",800,1,600,400,"True",521,548,517,-31,31,0
"C15SC",368,639,"1200x900",1000,2,600,400,"True",504,456,392,-64,64,0
"C15SC",369,16,"1200x900",600,0,600,400,"True",297,514,512,-2,2,1
"C15SC",370,572,"1200x900",1000,1,600,400,"False",302,260,334,74,74,0
"C15SC",371,633,"1200x900",1000,2,600,400,"False",564,253,499,246,246,0
"C15SC",372,210,"1200x900",600,2,600,400,"False",835,506,417,-89,89,0
"C15SC",373,508,"1200x900",1000,1,600,400,"True",596,485,445,-40,40,0
"C15SC",374,247,"1200x900",800,0,600,400,"True",160,424,369,-55,55,1
"C15SC",375,638,"1200x900",1000,2,600,400,"False",385,198,354,156,156,0
"C15SC",376,270,"1200x900",800,0,600,400,"True",192,418,388,-30,30,1
"C15SC",377,142,"1200x900",600,1,600,400,"True",286,474,521,47,47,0
"C15SC",378,580,"1200x900",1000,2,600,400,"False",651,267,470,203,203,0
"C15SC",379,328,"1200x900",800,1,600,400,"True",104,649,579,-70,70,0
"C15SC",380,19,"1200x900",600,0,600,400,"False",286,686,617,-69,69,0
"C15SC",381,439,"1200x900",1000,0,600,400,"True",110,229,199,-30,30,1
"C15SC",382,621,"1200x900",1000,2,600,400,"True",540,478,445,-33,33,0
"C15SC",383,113,"1200x900",600,1,600,400,"True",897,657,595,-62,62,0
"C15SC",384,521,"1200x900",1000,1,600,400,"True",111,303,362,59,59,1
"C15SC",385,538,"1200x900",1000,1,600,400,"True",308,457,518,61,61,1
"C15SC",386,429,"1200x900",800,2,600,400,"False",682,692,603,-89,89,0
"C15SC",387,406,"1200x900",800,2,600,400,"False",971,233,498,265,265,0
"C15SC",388,90,"1200x900",600,1,600,400,"True",560,474,431,-43,43,0
"C15SC",389,81,"1200x900",600,1,600,400,"True",696,225,248,23,23,0
"C15SC",390,279,"1200x900",800,0,600,400,"True",252,202,231,29,29,1
"C15SC",391,579,"1200x900",1000,2,600,400,"False",803,394,559,165,165,0
"C15SC",392,313,"1200x900",800,1,600,400,"True",588,421,387,-34,34,0
"C15SC",393,73,"1200x900",600,1,600,400,"True",94,665,650,-15,15,0
"C15SC",394,331,"1200x900",800,1,600,400,"True",240,620,660,40,40,0
"C15SC",395,82,"1200x900",600,1,600,400,"True",108,213,238,25,25,0
"C15SC",396,530,"1200x900",1000,1,600,400,"False",584,405,327,-78,78,1
"C15SC",397,325,"1200x900",800,1,600,400,"True",105,394,423,29,29,0
"C15SC",398,645,"1200x900",1000,2,600,400,"False",619,396,482,86,86,0
"C15SC",399,78,"1200x900",600,1,600,400,"False",885,684,528,-156,156,0
"C15SC",400,160,"1200x900",600,2,600,400,"True",863,606,642,36,36,0
"C15SC",401,483,"1200x900",1000,0,600,400,"False",93,191,316,125,125,1
"C15SC",402,258,"1200x900",800,0,600,400,"False",126,664,598,-66,66,1
"C15SC",403,130,"1200x900",600,1,600,400,"False",741,428,510,82,82,0
"C15SC",404,463,"1200x900",1000,0,600,400,"True",115,693,733,40,40,1
"C15SC",405,541,"1200x900",1000,1,600,400,"False",339,478,575,97,97,0
"C15SC",406,177,"1200x900",600,2,600,400,"True",912,236,329,93,93,0
"C15SC",407,255,"1200x900",800,0,600,400,"False",93,709,608,-101,101,1
"C15SC",408,464,"1200x900",1000,0,600,400,"True",82,222,282,60,60,1
"C15SC",409,10,"1200x900",600,0,600,400,"False",400,499,426,-73,73,1
"C15SC",410,436,"1200x900",1000,0,600,400,"False",82,617,549,-68,68,1
"C15SC",411,91,"1200x900",600,1,600,400,"False",417,630,716,86,86,1
"C15SC",412,612,"1200x900",1000,2,600,400,"False",706,198,384,186,186,0
"C15SC",413,399,"1200x900",800,2,600,400,"False",603,602,710,108,108,0
"C15SC",414,68,"1200x900",600,0,600,400,"True",165,367,350,-17,17,0
"C15SC",415,232,"1200x900",800,0,600,400,"False",84,511,446,-65,65,1
"C15SC",416,188,"1200x900",600,2,600,400,"False",900,195,334,139,139,0
"C15SC",417,349,"1200x900",800,1,600,400,"True",402,665,609,-56,56,0
"C15SC",418,237,"1200x900",800,0,600,400,"False",204,481,555,74,74,1
"C15SC",419,523,"1200x900",1000,1,600,400,"False",339,318,484,166,166,0
"C15SC",420,205,"1200x900",600,2,600,400,"True",1021,504,513,9,9,0
"C15SC",421,52,"1200x900",600,0,600,400,"True",171,188,204,16,16,0
"C15SC",422,428,"1200x900",800,2,600,400,"True",732,665,626,-39,39,0
"C15SC",423,316,"1200x900",800,1,600,400,"False",362,319,581,262,262,0
"C15SC",424,460,"1200x900",1000,0,600,400,"True",155,189,258,69,69,1
"C15SC",425,501,"1200x900",1000,0,600,400,"True",96,323,263,-60,60,1
"C15SC",426,285,"1200x900",800,0,600,400,"True",237,396,381,-15,15,1
"C15SC",427,222,"1200x900",800,0,600,400,"True",152,206,234,28,28,1
"C15SC",428,417,"1200x900",800,2,600,400,"True",750,280,286,6,6,0
"C15SC",429,486,"1200x900",1000,0,600,400,"True",102,676,672,-4,4,1
"C15SC",430,586,"1200x900",1000,2,600,400,"False",802,262,401,139,139,0
"C15SC",431,148,"1200x900",600,2,600,400,"False",907,330,424,94,94,0
"C15SC",432,379,"1200x900",800,2,600,400,"False",994,325,405,80,80,0
"C15SC",433,224,"1200x900",800,0,600,400,"True",161,474,441,-33,33,1
"C15SC",434,420,"1200x900",800,2,600,400,"False",519,223,451,228,228,0
"C15SC",435,617,"1200x900",1000,2,600,400,"False",294,180,402,222,222,0
"C15SC",436,93,"1200x900",600,1,600,400,"True",139,540,466,-74,74,0
"C15SC",437,512,"1200x900",1000,1,600,400,"True",139,261,277,16,16,0
"C15SC",438,480,"1200x900",1000,0,600,400,"True",100,231,245,14,14,1
"C15SC",439,147,"1200x900",600,2,600,400,"False",942,418,298,-120,120,0
"C15SC",440,576,"1200x900",1000,1,600,400,"False",376,713,600,-113,113,0
"C15SC",442,30,"1200x900",600,0,600,400,"True",107,353,391,38,38,0
"C15SC",443,235,"1200x900",800,0,600,400,"False",146,646,559,-87,87,1
"C15SC",444,37,"1200x900",600,0,600,400,"True",258,403,387,-16,16,1
"C15SC",445,306,"1200x900",800,1,600,400,"True",164,524,496,-28,28,0
"C15SC",446,564,"1200x900",1000,1,600,400,"True",215,264,313,49,49,0
"C15SC",447,582,"1200x900",1000,2,600,400,"False",554,347,239,-108,108,0
"C15SC",449,89,"1200x900",600,1,600,400,"True",917,366,377,11,11,1
"C15SC",450,606,"1200x900",1000,2,600,400,"False",653,627,493,-134,134,0
"C15SC",451,603,"1200x900",1000,2,600,400,"True",693,280,324,44,44,0
"C15SC",452,38,"1200x900",600,0,600,400,"True",120,628,620,-8,8,1
"C15SC",453,382,"1200x900",800,2,600,400,"False",870,523,374,-149,149,0
"C15SC",454,539,"1200x900",1000,1,600,400,"True",510,383,430,47,47,0
"C15SC",455,152,"1200x900",600,2,600,400,"False",971,399,318,-81,81,0
"C15SC",456,551,"1200x900",1000,1,600,400,"True",146,445,432,-13,13,1
"C15SC",458,56,"1200x900",600,0,600,400,"True",148,491,428,-63,63,0
"C15SC",459,419,"1200x900",800,2,600,400,"True",769,351,406,55,55,0
"C15SC",460,469,"1200x900",1000,0,600,400,"True",73,227,237,10,10,1
"C15SC",461,577,"1200x900",1000,2,600,400,"True",455,420,450,30,30,0
"C15SC",462,215,"1200x900",600,2,600,400,"True",939,596,573,-23,23,0
"C15SC",463,526,"1200x900",1000,1,600,400,"True",497,710,721,11,11,0
"C15SC",464,324,"1200x900",800,1,600,400,"True",719,712,748,36,36,1
"C15SC",465,194,"1200x900",600,2,600,400,"True",896,236,235,-1,1,0
"C15SC",466,400,"1200x900",800,2,600,400,"True",733,297,305,8,8,0
"C15SC",467,458,"1200x900",1000,0,600,400,"True",78,624,654,30,30,1
"C15SC",468,17,"1200x900",600,0,600,400,"True",402,496,524,28,28,1
"C15SC",469,138,"1200x900",600,1,600,400,"True",844,580,513,-67,67,1
"C15SC",470,520,"1200x900",1000,1,600,400,"False",564,260,338,78,78,0
"C15SC",471,193,"1200x900",600,2,600,400,"False",874,588,653,65,65,0
"C15SC",472,567,"1200x900",1000,1,600,400,"True",655,297,259,-38,38,1
"C15SC",473,92,"1200x900",600,1,600,400,"True",624,605,589,-16,16,0
"C15SC",474,346,"1200x900",800,1,600,400,"True",269,635,625,-10,10,0
"C15SC",475,609,"1200x900",1000,2,600,400,"True",697,627,665,38,38,0
"C15SC",476,253,"1200x900",800,0,600,400,"False",177,424,518,94,94,1
"C15SC",477,467,"1200x900",1000,0,600,400,"False",74,712,599,-113,113,1
"C15SC",478,153,"1200x900",600,2,600,400,"False",1037,601,672,71,71,0
"C15SC",479,214,"1200x900",600,2,600,400,"False",1046,305,225,-80,80,0
"C15SC",480,528,"1200x900",1000,1,600,400,"False",839,227,294,67,67,1
"C15SC",481,135,"1200x900",600,1,600,400,"True",759,569,552,-17,17,0
"C15SC",482,555,"1200x900",1000,1,600,400,"True",444,556,584,28,28,0
"C15SC",483,269,"1200x900",800,0,600,400,"True",160,295,304,9,9,1
"C15SC",484,291,"1200x900",800,1,600,400,"False",522,694,560,-134,134,0
"C15SC",485,15,"1200x900",600,0,600,400,"True",473,352,369,17,17,1
"C15SC",486,175,"1200x900",600,2,600,400,"False",1028,432,317,-115,115,0
"C15SC",487,79,"1200x900",600,1,600,400,"True",731,289,347,58,58,0
"C15SC",488,3,"1200x900",600,0,600,400,"True",298,443,414,-29,29,1
"C15SC",489,273,"1200x900",800,0,600,400,"True",180,309,326,17,17,1
"C15SC",490,318,"1200x900",800,1,600,400,"True",788,534,556,22,22,0
"C15SC",491,410,"1200x900",800,2,600,400,"False",916,477,417,-60,60,0
"C15SC",492,424,"1200x900",800,2,600,400,"False",903,545,406,-139,139,0
"C15SC",493,169,"1200x900",600,2,600,400,"False",924,290,474,184,184,0
"C15SC",494,500,"1200x900",1000,0,600,400,"False",105,700,627,-73,73,1
"C15SC",495,414,"1200x900",800,2,600,400,"True",831,592,544,-48,48,0
"C15SC",496,490,"1200x900",1000,0,600,400,"True",114,183,245,62,62,1
"C15SC",497,128,"1200x900",600,1,600,400,"True",661,258,238,-20,20,1
"C15SC",498,146,"1200x900",600,2,600,400,"False",989,492,385,-107,107,0
"C15SC",499,108,"1200x900",600,1,600,400,"False",830,239,369,130,130,0
"C15SC",500,22,"1200x900",600,0,600,400,"True",398,591,580,-11,11,1
"C15SC",501,571,"1200x900",1000,1,600,400,"False",239,522,692,170,170,1
"C15SC",502,197,"1200x900",600,2,600,400,"False",903,212,349,137,137,0
"C15SC",503,187,"1200x900",600,2,600,400,"True",857,639,626,-13,13,0
"C15SC",504,418,"1200x900",800,2,600,400,"False",754,507,278,-229,229,0
"C15SC",505,643,"1200x900",1000,2,600,400,"True",740,325,367,42,42,0
"C15SC",506,341,"1200x900",800,1,600,400,"True",735,632,619,-13,13,1
"C15SC",507,233,"1200x900",800,0,600,400,"True",164,700,674,-26,26,1
"C15SC",508,155,"1200x900",600,2,600,400,"False",940,269,470,201,201,0
"C15SC",509,390,"1200x900",800,2,600,400,"True",982,674,684,10,10,1
"C15SC",510,611,"1200x900",1000,2,600,400,"True",414,511,480,-31,31,0
"C15SC",511,101,"1200x900",600,1,600,400,"True",541,656,623,-33,33,0
"C15SC",512,407,"1200x900",800,2,600,400,"False",989,340,181,-159,159,0
"C15SC",513,363,"1200x900",800,2,600,400,"True",800,218,264,46,46,0
"C15SC",515,597,"1200x900",1000,2,600,400,"True",352,239,315,76,76,0
"C15SC",516,502,"1200x900",1000,0,600,400,"False",111,639,501,-138,138,1
"C15SC",517,336,"1200x900",800,1,600,400,"True",251,587,617,30,30,0
"C15SC",518,378,"1200x900",800,2,600,400,"False",1018,708,568,-140,140,0
"C15SC",519,517,"1200x900",1000,1,600,400,"False",548,182,394,212,212,0
"C15SC",520,100,"1200x900",600,1,600,400,"True",453,511,506,-5,5,0
"C15SC",521,360,"1200x900",800,1,600,400,"True",203,608,633,25,25,0
"C15SC",522,74,"1200x900",600,1,600,400,"True",115,358,407,49,49,0
"C15SC",523,31,"1200x900",600,0,600,400,"True",365,338,359,21,21,1
"C15SC",524,85,"1200x900",600,1,600,400,"True",434,347,360,13,13,0
"C15SC",525,166,"1200x900",600,2,600,400,"True",896,274,301,27,27,0
"C15SC",526,266,"1200x900",800,0,600,400,"False",126,303,216,-87,87,1
"C15SC",527,1,"1200x900",600,0,600,400,"False",136,502,388,-114,114,0
"C15SC",528,468,"1200x900",1000,0,600,400,"True",121,219,204,-15,15,1
"C15SC",529,525,"1200x900",1000,1,600,400,"False",123,690,603,-87,87,0
"C15SC",530,97,"1200x900",600,1,600,400,"True",760,643,674,31,31,1
"C15SC",531,332,"1200x900",800,1,600,400,"True",260,699,695,-4,4,0
"C15SC",532,540,"1200x900",1000,1,600,400,"True",389,568,543,-25,25,1
"C15SC",533,354,"1200x900",800,1,600,400,"False",118,236,350,114,114,0
"C15SC",534,391,"1200x900",800,2,600,400,"False",895,521,436,-85,85,0
"C15SC",535,116,"1200x900",600,1,600,400,"True",767,289,313,24,24,0
"C15SC",536,95,"1200x900",600,1,600,400,"False",749,425,252,-173,173,1
"C15SC",537,409,"1200x900",800,2,600,400,"False",501,659,499,-160,160,0
"C15SC",538,485,"1200x900",1000,0,600,400,"True",121,694,675,-19,19,1
"C15SC",539,120,"1200x900",600,1,600,400,"True",690,655,645,-10,10,0
"C15SC",540,129,"1200x900",600,1,600,400,"True",859,482,557,75,75,1
"C15SC",541,569,"1200x900",1000,1,600,400,"False",494,720,638,-82,82,0
"C15SC",542,254,"1200x900",800,0,600,400,"True",136,583,651,68,68,1
"C15SC",543,198,"1200x900",600,2,600,400,"False",976,500,580,80,80,0
"C15SC",544,454,"1200x900",1000,0,600,400,"True",78,687,744,57,57,1
"C15SC",545,457,"1200x900",1000,0,600,400,"True",97,630,685,55,55,1
"C15SC",546,443,"1200x900",1000,0,600,400,"True",99,651,670,19,19,1
"C15SC",547,41,"1200x900",600,0,600,400,"True",370,452,519,67,67,1
"C15SC",549,315,"1200x900",800,1,600,400,"False",105,211,359,148,148,0
"C15SC",550,67,"1200x900",600,0,600,400,"True",289,308,296,-12,12,1
"C15SC",551,274,"1200x900",800,0,600,400,"True",146,497,456,-41,41,1
"C15SC",552,509,"1200x900",1000,1,600,400,"True",509,434,432,-2,2,0
"C15SC",553,499,"1200x900",1000,0,600,400,"True",93,271,281,10,10,1
"C15SC",554,630,"1200x900",1000,2,600,400,"True",754,559,599,40,40,0
"C15SC",555,44,"1200x900",600,0,600,400,"True",305,554,547,-7,7,1
"C15SC",556,629,"1200x900",1000,2,600,400,"False",681,257,326,69,69,0
"C15SC",557,191,"1200x900",600,2,600,400,"True",962,396,412,16,16,0
"C15SC",558,505,"1200x900",1000,1,600,400,"True",191,484,454,-30,30,1
"C15SC",559,637,"1200x900",1000,2,600,400,"False",750,460,320,-140,140,0
"C15SC",560,246,"1200x900",800,0,600,400,"True",196,418,405,-13,13,1
"C15SC",561,393,"1200x900",800,2,600,400,"False",657,620,476,-144,144,0
"C15SC",562,245,"1200x900",800,0,600,400,"True",296,235,290,55,55,1
"C15SC",563,345,"1200x900",800,1,600,400,"True",841,566,487,-79,79,1
"C15SC",564,137,"1200x900",600,1,600,400,"True",789,577,577,0,0,0
"C15SC",565,408,"1200x900",800,2,600,400,"True",758,567,541,-26,26,0
"C15SC",566,319,"1200x900",800,1,600,400,"False",494,587,438,-149,149,1
"C15SC",567,353,"1200x900",800,1,600,400,"False",90,476,561,85,85,0
"C15SC",568,388,"1200x900",800,2,600,400,"True",930,320,373,53,53,0
"C15SC",569,250,"1200x900",800,0,600,400,"True",290,248,229,-19,19,1
"C15SC",570,118,"1200x900",600,1,600,400,"False",190,588,362,-226,226,0
"C15SC",571,275,"1200x900",800,0,600,400,"True",120,594,588,-6,6,0
"C15SC",572,14,"1200x900",600,0,600,400,"True",399,224,251,27,27,1
"C15SC",573,647,"1200x900",1000,2,600,400,"True",560,637,575,-62,62,0
"C15SC",574,119,"1200x900",600,1,600,400,"True",168,563,601,38,38,0
"C15SC",575,59,"1200x900",600,0,600,400,"True",391,692,699,7,7,1
"C15SC",576,474,"1200x900",1000,0,600,400,"True",85,339,380,41,41,1
"C15SC",577,203,"1200x900",600,2,600,400,"True",938,603,607,4,4,0
"C15SC",578,323,"1200x900",800,1,600,400,"False",388,348,539,191,191,0
"C15SC",579,216,"1200x900",600,2,600,400,"False",1029,286,396,110,110,0
"C15SC",580,70,"1200x900",600,0,600,400,"True",309,703,672,-31,31,1
"C15SC",581,176,"1200x900",600,2,600,400,"True",1033,281,352,71,71,0
"C15SC",582,174,"1200x900",600,2,600,400,"True",998,457,411,-46,46,0
"C15SC",583,46,"1200x900",600,0,600,400,"True",193,355,321,-34,34,1
"C15SC",584,327,"1200x900",800,1,600,400,"False",152,339,448,109,109,0
"C15SC",585,338,"1200x900",800,1,600,400,"True",813,253,310,57,57,1
"C15SC",586,481,"1200x900",1000,0,600,400,"True",80,185,183,-2,2,1
"C15SC",587,111,"1200x900",600,1,600,400,"False",922,552,480,-72,72,1
"C15SC",588,389,"1200x900",800,2,600,400,"True",843,530,516,-14,14,0
"C15SC",589,375,"1200x900",800,2,600,400,"True",716,384,451,67,67,0
"C15SC",590,398,"1200x900",800,2,600,400,"True",944,698,667,-31,31,0
"C15SC",591,550,"1200x900",1000,1,600,400,"True",301,459,486,27,27,0
"C15SC",592,547,"1200x900",1000,1,600,400,"False",369,384,305,-79,79,1
"C15SC",593,304,"1200x900",800,1,600,400,"False",667,605,376,-229,229,0
"C15SC",594,27,"1200x900",600,0,600,400,"True",373,309,281,-28,28,1
"C15SC",595,631,"1200x900",1000,2,600,400,"True",699,479,521,42,42,0
"C15SC",596,600,"1200x900",1000,2,600,400,"False",765,207,326,119,119,0
"C15SC",597,172,"1200x900",600,2,600,400,"True",912,444,475,31,31,0
"C15SC",598,168,"1200x900",600,2,600,400,"True",1001,439,522,83,83,0
"C15SC",599,45,"1200x900",600,0,600,400,"True",487,678,667,-11,11,1
"C15SC",600,183,"1200x900",600,2,600,400,"True",927,289,349,60,60,0
"C15SC",601,114,"1200x900",600,1,600,400,"False",183,697,533,-164,164,0
"C15SC",602,186,"1200x900",600,2,600,400,"True",997,197,305,108,108,0
"C15SC",603,173,"1200x900",600,2,600,400,"True",948,693,670,-23,23,0
"C15SC",604,587,"1200x900",1000,2,600,400,"False",741,686,502,-184,184,0
"C15SC",605,476,"1200x900",1000,0,600,400,"True",76,359,374,15,15,1
"C15SC",606,66,"1200x900",600,0,600,400,"True",155,673,636,-37,37,0
"C15SC",607,263,"1200x900",800,0,600,400,"True",82,396,398,2,2,1
"C15SC",608,605,"1200x900",1000,2,600,400,"True",493,665,630,-35,35,0
"C15SC",609,610,"1200x900",1000,2,600,400,"True",702,293,376,83,83,0
"C15SC",610,124,"1200x900",600,1,600,400,"True",345,467,476,9,9,0
"C15SC",611,352,"1200x900",800,1,600,400,"True",235,717,689,-28,28,0
"C15SC",612,296,"1200x900",800,1,600,400,"True",89,279,261,-18,18,0
"C15SC",613,537,"1200x900",1000,1,600,400,"False",621,412,524,112,112,1
"C15SC",614,4,"1200x900",600,0,600,400,"False",602,200,298,98,98,1
"C15SC",615,591,"1200x900",1000,2,600,400,"False",698,336,481,145,145,0
"C15SC",616,326,"1200x900",800,1,600,400,"False",103,482,561,79,79,0
"C15SC",617,24,"1200x900",600,0,600,400,"True",430,538,484,-54,54,1
"C15SC",618,495,"1200x900",1000,0,600,400,"False",93,692,605,-87,87,1
"C15SC",619,98,"1200x900",600,1,600,400,"True",625,530,533,3,3,0
"C15SC",620,566,"1200x900",1000,1,600,400,"False",378,472,301,-171,171,1
"C15SC",621,455,"1200x900",1000,0,600,400,"True",107,718,715,-3,3,1
"C15SC",622,475,"1200x900",1000,0,600,400,"True",101,715,722,7,7,1
"C15SC",623,99,"1200x900",600,1,600,400,"True",811,407,471,64,64,0
"C15SC",624,554,"1200x900",1000,1,600,400,"False",79,309,212,-97,97,1
"C15SC",625,158,"1200x900",600,2,600,400,"False",939,300,211,-89,89,0
"C15SC",626,302,"1200x900",800,1,600,400,"False",479,467,571,104,104,1
"C15SC",627,342,"1200x900",800,1,600,400,"False",677,204,290,86,86,0
"C15SC",628,289,"1200x900",800,1,600,400,"True",421,703,649,-54,54,1
"C15SC",629,184,"1200x900",600,2,600,400,"False",1067,441,585,144,144,0
"C15SC",630,552,"1200x900",1000,1,600,400,"False",255,412,491,79,79,0
"C15SC",631,106,"1200x900",600,1,600,400,"False",803,659,594,-65,65,1
"C15SC",632,620,"1200x900",1000,2,600,400,"False",832,649,565,-84,84,0
"C15SC",633,412,"1200x900",800,2,600,400,"False",842,280,426,146,146,0
"C15SC",634,581,"1200x900",1000,2,600,400,"False",310,357,293,-64,64,0
"C15SC",635,157,"1200x900",600,2,600,400,"True",1016,323,350,27,27,0
"C15SC",636,211,"1200x900",600,2,600,400,"True",986,407,376,-31,31,0
"C15SC",637,602,"1200x900",1000,2,600,400,"False",865,452,355,-97,97,0
"C15SC",638,515,"1200x900",1000,1,600,400,"True",307,217,267,50,50,0
"C15SC",639,287,"1200x900",800,0,600,400,"True",120,567,498,-69,69,1
"C15SC",640,228,"1200x900",800,0,600,400,"True",174,687,632,-55,55,1
"C15SC",641,335,"1200x900",800,1,600,400,"False",124,360,473,113,113,0
"C15SC",642,366,"1200x900",800,2,600,400,"False",931,464,285,-179,179,0
"C15SC",643,435,"1200x900",1000,0,600,400,"True",119,200,192,-8,8,1
"C15SC",644,368,"1200x900",800,2,600,400,"False",778,515,441,-74,74,0
"C15SC",645,221,"1200x900",800,0,600,400,"True",132,520,512,-8,8,1
"C15SC",646,209,"1200x900",600,2,600,400,"True",937,637,559,-78,78,0
"C15SC",647,434,"1200x900",1000,0,600,400,"True",89,657,718,61,61,1
"C15SC",648,94,"1200x900",600,1,600,400,"True",729,482,494,12,12,0
"C16RO",1,415,"1200x900",800,2,600,400,"False",823,684,595,-89,89,0
"C16RO",2,169,"1200x900",600,2,600,400,"True",924,290,315,25,25,0
"C16RO",3,506,"1200x900",1000,1,600,400,"True",559,567,519,-48,48,1
"C16RO",4,499,"1200x900",1000,0,600,400,"False",93,271,456,185,185,1
"C16RO",5,588,"1200x900",1000,2,600,400,"True",585,350,357,7,7,0
"C16RO",6,110,"1200x900",600,1,600,400,"False",776,550,616,66,66,1
"C16RO",7,321,"1200x900",800,1,600,400,"True",601,190,223,33,33,0
"C16RO",8,221,"1200x900",800,0,600,400,"False",132,520,357,-163,163,1
"C16RO",9,76,"1200x900",600,1,600,400,"True",647,614,614,0,0,0
"C16RO",10,142,"1200x900",600,1,600,400,"True",286,474,531,57,57,0
"C16RO",11,15,"1200x900",600,0,600,400,"True",473,352,382,30,30,1
"C16RO",12,386,"1200x900",800,2,600,400,"True",774,301,335,34,34,0
"C16RO",13,277,"1200x900",800,0,600,400,"True",140,310,342,32,32,1
"C16RO",14,372,"1200x900",800,2,600,400,"False",833,620,540,-80,80,0
"C16RO",15,462,"1200x900",1000,0,600,400,"False",102,672,528,-144,144,1
"C16RO",16,565,"1200x900",1000,1,600,400,"True",451,562,522,-40,40,0
"C16RO",17,26,"1200x900",600,0,600,400,"False",70,712,638,-74,74,0
"C16RO",18,23,"1200x900",600,0,600,400,"True",308,463,524,61,61,1
"C16RO",19,569,"1200x900",1000,1,600,400,"False",494,720,632,-88,88,0
"C16RO",20,597,"1200x900",1000,2,600,400,"False",352,239,335,96,96,0
"C16RO",21,418,"1200x900",800,2,600,400,"False",754,507,399,-108,108,0
"C16RO",22,269,"1200x900",800,0,600,400,"True",160,295,335,40,40,1
"C16RO",23,601,"1200x900",1000,2,600,400,"False",735,697,457,-240,240,0
"C16RO",24,70,"1200x900",600,0,600,400,"True",309,703,685,-18,18,1
"C16RO",25,515,"1200x900",1000,1,600,400,"False",307,217,342,125,125,0
"C16RO",26,43,"1200x900",600,0,600,400,"False",277,446,373,-73,73,1
"C16RO",27,435,"1200x900",1000,0,600,400,"False",119,200,360,160,160,1
"C16RO",28,290,"1200x900",800,1,600,400,"True",789,603,584,-19,19,0
"C16RO",29,637,"1200x900",1000,2,600,400,"True",750,460,483,23,23,0
"C16RO",30,590,"1200x900",1000,2,600,400,"False",636,278,385,107,107,0
"C16RO",31,219,"1200x900",800,0,600,400,"True",202,502,474,-28,28,1
"C16RO",32,544,"1200x900",1000,1,600,400,"True",602,620,630,10,10,0
"C16RO",33,387,"1200x900",800,2,600,400,"True",990,444,450,6,6,0
"C16RO",34,570,"1200x900",1000,1,600,400,"True",315,352,420,68,68,0
"C16RO",35,291,"1200x900",800,1,600,400,"False",522,694,605,-89,89,0
"C16RO",36,134,"1200x900",600,1,600,400,"True",300,188,174,-14,14,0
"C16RO",37,91,"1200x900",600,1,600,400,"True",417,630,602,-28,28,1
"C16RO",38,263,"1200x900",800,0,600,400,"True",82,396,402,6,6,1
"C16RO",39,189,"1200x900",600,2,600,400,"True",881,397,365,-32,32,0
"C16RO",40,95,"1200x900",600,1,600,400,"True",749,425,443,18,18,1
"C16RO",41,281,"1200x900",800,0,600,400,"True",112,611,570,-41,41,1
"C16RO",42,385,"1200x900",800,2,600,400,"True",740,456,469,13,13,0
"C16RO",43,369,"1200x900",800,2,600,400,"True",903,594,588,-6,6,0
"C16RO",44,381,"1200x900",800,2,600,400,"False",705,408,329,-79,79,0
"C16RO",45,408,"1200x900",800,2,600,400,"True",758,567,623,56,56,0
"C16RO",46,394,"1200x900",800,2,600,400,"False",847,292,455,163,163,0
"C16RO",47,631,"1200x900",1000,2,600,400,"True",699,479,398,-81,81,0
"C16RO",48,527,"1200x900",1000,1,600,400,"True",565,601,568,-33,33,0
"C16RO",49,199,"1200x900",600,2,600,400,"False",992,467,339,-128,128,0
"C16RO",50,283,"1200x900",800,0,600,400,"False",90,264,346,82,82,1
"C16RO",51,526,"1200x900",1000,1,600,400,"True",497,710,642,-68,68,0
"C16RO",52,392,"1200x900",800,2,600,400,"True",1031,618,636,18,18,0
"C16RO",53,377,"1200x900",800,2,600,400,"True",683,388,380,-8,8,0
"C16RO",54,71,"1200x900",600,0,600,400,"True",219,248,295,47,47,0
"C16RO",55,347,"1200x900",800,1,600,400,"False",757,295,471,176,176,1
"C16RO",56,174,"1200x900",600,2,600,400,"False",998,457,315,-142,142,0
"C16RO",57,41,"1200x900",600,0,600,400,"True",370,452,428,-24,24,1
"C16RO",58,578,"1200x900",1000,2,600,400,"False",966,276,497,221,221,0
"C16RO",59,4,"1200x900",600,0,600,400,"True",602,200,204,4,4,1
"C16RO",60,147,"1200x900",600,2,600,400,"False",942,418,347,-71,71,0
"C16RO",61,1,"1200x900",600,0,600,400,"True",136,502,492,-10,10,0
"C16RO",62,143,"1200x900",600,1,600,400,"True",479,284,271,-13,13,1
"C16RO",63,520,"1200x900",1000,1,600,400,"True",564,260,295,35,35,0
"C16RO",64,303,"1200x900",800,1,600,400,"True",241,431,467,36,36,0
"C16RO",65,86,"1200x900",600,1,600,400,"True",692,388,385,-3,3,1
"C16RO",66,428,"1200x900",800,2,600,400,"False",732,665,463,-202,202,0
"C16RO",67,158,"1200x900",600,2,600,400,"False",939,300,95,-205,205,0
"C16RO",68,411,"1200x900",800,2,600,400,"True",805,361,360,-1,1,0
"C16RO",69,177,"1200x900",600,2,600,400,"False",912,236,159,-77,77,0
"C16RO",70,46,"1200x900",600,0,600,400,"True",193,355,380,25,25,1
"C16RO",71,460,"1200x900",1000,0,600,400,"False",155,189,297,108,108,1
"C16RO",72,246,"1200x900",800,0,600,400,"True",196,418,382,-36,36,1
"C16RO",73,195,"1200x900",600,2,600,400,"False",942,249,160,-89,89,0
"C16RO",74,434,"1200x900",1000,0,600,400,"False",89,657,510,-147,147,1
"C16RO",75,220,"1200x900",800,0,600,400,"True",108,699,688,-11,11,1
"C16RO",76,139,"1200x900",600,1,600,400,"True",192,695,699,4,4,0
"C16RO",77,235,"1200x900",800,0,600,400,"True",146,646,652,6,6,1
"C16RO",78,243,"1200x900",800,0,600,400,"True",114,332,389,57,57,1
"C16RO",79,612,"1200x900",1000,2,600,400,"True",706,198,261,63,63,0
"C16RO",80,599,"1200x900",1000,2,600,400,"True",316,570,614,44,44,0
"C16RO",81,625,"1200x900",1000,2,600,400,"False",279,228,147,-81,81,0
"C16RO",82,456,"1200x900",1000,0,600,400,"True",91,257,274,17,17,1
"C16RO",83,647,"1200x900",1000,2,600,400,"True",560,637,595,-42,42,0
"C16RO",84,639,"1200x900",1000,2,600,400,"True",504,456,483,27,27,0
"C16RO",85,296,"1200x900",800,1,600,400,"True",89,279,238,-41,41,0
"C16RO",86,121,"1200x900",600,1,600,400,"True",884,364,345,-19,19,0
"C16RO",87,397,"1200x900",800,2,600,400,"True",817,692,750,58,58,0
"C16RO",88,196,"1200x900",600,2,600,400,"False",1030,397,211,-186,186,0
"C16RO",89,348,"1200x900",800,1,600,400,"True",764,294,303,9,9,0
"C16RO",90,229,"1200x900",800,0,600,400,"True",117,697,708,11,11,1
"C16RO",91,300,"1200x900",800,1,600,400,"True",620,693,666,-27,27,0
"C16RO",92,141,"1200x900",600,1,600,400,"True",671,582,603,21,21,0
"C16RO",93,617,"1200x900",1000,2,600,400,"True",294,180,199,19,19,0
"C16RO",94,138,"1200x900",600,1,600,400,"False",844,580,645,65,65,1
"C16RO",95,561,"1200x900",1000,1,600,400,"True",231,406,395,-11,11,0
"C16RO",96,376,"1200x900",800,2,600,400,"False",788,275,205,-70,70,0
"C16RO",97,145,"1200x900",600,2,600,400,"True",1004,630,570,-60,60,0
"C16RO",98,131,"1200x900",600,1,600,400,"False",531,367,473,106,106,0
"C16RO",99,455,"1200x900",1000,0,600,400,"True",107,718,673,-45,45,1
"C16RO",100,626,"1200x900",1000,2,600,400,"False",329,449,349,-100,100,0
"C16RO",101,102,"1200x900",600,1,600,400,"True",861,603,604,1,1,0
"C16RO",102,367,"1200x900",800,2,600,400,"True",613,464,493,29,29,0
"C16RO",103,389,"1200x900",800,2,600,400,"True",843,530,498,-32,32,0
"C16RO",104,65,"1200x900",600,0,600,400,"False",442,645,572,-73,73,1
"C16RO",105,217,"1200x900",800,0,600,400,"True",85,573,619,46,46,1
"C16RO",106,470,"1200x900",1000,0,600,400,"False",91,666,562,-104,104,1
"C16RO",107,155,"1200x900",600,2,600,400,"True",940,269,210,-59,59,0
"C16RO",108,340,"1200x900",800,1,600,400,"True",226,240,290,50,50,0
"C16RO",109,604,"1200x900",1000,2,600,400,"True",459,593,539,-54,54,0
"C16RO",110,225,"1200x900",800,0,600,400,"True",178,423,376,-47,47,1
"C16RO",111,480,"1200x900",1000,0,600,400,"False",100,231,312,81,81,1
"C16RO",112,109,"1200x900",600,1,600,400,"False",691,589,514,-75,75,0
"C16RO",113,175,"1200x900",600,2,600,400,"False",1028,432,267,-165,165,0
"C16RO",114,406,"1200x900",800,2,600,400,"False",971,233,416,183,183,0
"C16RO",115,363,"1200x900",800,2,600,400,"True",800,218,290,72,72,0
"C16RO",116,416,"1200x900",800,2,600,400,"False",748,617,427,-190,190,0
"C16RO",117,87,"1200x900",600,1,600,400,"True",231,604,588,-16,16,0
"C16RO",118,154,"1200x900",600,2,600,400,"False",941,454,255,-199,199,0
"C16RO",119,264,"1200x900",800,0,600,400,"False",198,660,508,-152,152,1
"C16RO",120,585,"1200x900",1000,2,600,400,"False",698,688,511,-177,177,1
"C16RO",121,593,"1200x900",1000,2,600,400,"True",246,719,723,4,4,0
"C16RO",122,412,"1200x900",800,2,600,400,"False",842,280,148,-132,132,0
"C16RO",123,633,"1200x900",1000,2,600,400,"False",564,253,641,388,388,0
"C16RO",124,330,"1200x900",800,1,600,400,"True",759,301,246,-55,55,1
"C16RO",125,609,"1200x900",1000,2,600,400,"True",697,627,616,-11,11,0
"C16RO",126,547,"1200x900",1000,1,600,400,"False",369,384,460,76,76,1
"C16RO",127,468,"1200x900",1000,0,600,400,"True",121,219,214,-5,5,1
"C16RO",128,634,"1200x900",1000,2,600,400,"False",735,313,423,110,110,0
"C16RO",129,36,"1200x900",600,0,600,400,"True",128,346,338,-8,8,1
"C16RO",130,279,"1200x900",800,0,600,400,"True",252,202,252,50,50,1
"C16RO",131,203,"1200x900",600,2,600,400,"True",938,603,534,-69,69,0
"C16RO",132,77,"1200x900",600,1,600,400,"True",780,525,495,-30,30,0
"C16RO",133,116,"1200x900",600,1,600,400,"False",767,289,218,-71,71,0
"C16RO",134,212,"1200x900",600,2,600,400,"False",841,206,285,79,79,0
"C16RO",135,512,"1200x900",1000,1,600,400,"True",139,261,265,4,4,0
"C16RO",136,498,"1200x900",1000,0,600,400,"True",100,260,219,-41,41,1
"C16RO",137,453,"1200x900",1000,0,600,400,"False",71,393,307,-86,86,1
"C16RO",138,68,"1200x900",600,0,600,400,"True",165,367,345,-22,22,0
"C16RO",139,173,"1200x900",600,2,600,400,"True",948,693,650,-43,43,0
"C16RO",140,239,"1200x900",800,0,600,400,"False",114,231,308,77,77,1
"C16RO",141,301,"1200x900",800,1,600,400,"True",162,574,579,5,5,0
"C16RO",142,306,"1200x900",800,1,600,400,"False",164,524,358,-166,166,0
"C16RO",143,293,"1200x900",800,1,600,400,"True",561,396,429,33,33,0
"C16RO",144,583,"1200x900",1000,2,600,400,"True",949,284,268,-16,16,1
"C16RO",145,214,"1200x900",600,2,600,400,"False",1046,305,205,-100,100,0
"C16RO",146,136,"1200x900",600,1,600,400,"True",264,205,209,4,4,0
"C16RO",147,100,"1200x900",600,1,600,400,"False",453,511,292,-219,219,0
"C16RO",148,3,"1200x900",600,0,600,400,"False",298,443,352,-91,91,1
"C16RO",149,564,"1200x900",1000,1,600,400,"True",215,264,293,29,29,0
"C16RO",150,487,"1200x900",1000,0,600,400,"False",78,670,512,-158,158,1
"C16RO",151,108,"1200x900",600,1,600,400,"True",830,239,279,40,40,0
"C16RO",152,166,"1200x900",600,2,600,400,"False",896,274,186,-88,88,0
"C16RO",153,429,"1200x900",800,2,600,400,"True",682,692,653,-39,39,0
"C16RO",154,537,"1200x900",1000,1,600,400,"True",621,412,449,37,37,1
"C16RO",155,29,"1200x900",600,0,600,400,"True",385,533,498,-35,35,1
"C16RO",156,616,"1200x900",1000,2,600,400,"False",854,357,117,-240,240,1
"C16RO",157,27,"1200x900",600,0,600,400,"True",373,309,285,-24,24,1
"C16RO",158,259,"1200x900",800,0,600,400,"True",156,180,236,56,56,1
"C16RO",159,549,"1200x900",1000,1,600,400,"True",657,366,372,6,6,0
"C16RO",160,163,"1200x900",600,2,600,400,"True",1046,665,700,35,35,0
"C16RO",161,490,"1200x900",1000,0,600,400,"False",114,183,318,135,135,1
"C16RO",162,509,"1200x900",1000,1,600,400,"True",509,434,405,-29,29,0
"C16RO",163,533,"1200x900",1000,1,600,400,"True",355,483,455,-28,28,0
"C16RO",164,495,"1200x900",1000,0,600,400,"False",93,692,570,-122,122,1
"C16RO",165,33,"1200x900",600,0,600,400,"True",198,533,547,14,14,1
"C16RO",166,153,"1200x900",600,2,600,400,"True",1037,601,614,13,13,0
"C16RO",167,482,"1200x900",1000,0,600,400,"True",79,686,684,-2,2,1
"C16RO",168,573,"1200x900",1000,1,600,400,"False",486,615,689,74,74,0
"C16RO",169,448,"1200x900",1000,0,600,400,"True",107,641,596,-45,45,1
"C16RO",170,146,"1200x900",600,2,600,400,"False",989,492,428,-64,64,0
"C16RO",171,457,"1200x900",1000,0,600,400,"True",97,630,583,-47,47,1
"C16RO",172,390,"1200x900",800,2,600,400,"True",982,674,615,-59,59,1
"C16RO",173,396,"1200x900",800,2,600,400,"True",678,663,627,-36,36,0
"C16RO",174,443,"1200x900",1000,0,600,400,"True",99,651,628,-23,23,1
"C16RO",175,261,"1200x900",800,0,600,400,"False",86,713,643,-70,70,1
"C16RO",176,557,"1200x900",1000,1,600,400,"False",677,505,344,-161,161,1
"C16RO",177,354,"1200x900",800,1,600,400,"True",118,236,210,-26,26,0
"C16RO",178,538,"1200x900",1000,1,600,400,"True",308,457,498,41,41,1
"C16RO",179,78,"1200x900",600,1,600,400,"True",885,684,654,-30,30,0
"C16RO",180,528,"1200x900",1000,1,600,400,"False",839,227,474,247,247,1
"C16RO",181,627,"1200x900",1000,2,600,400,"True",760,510,551,41,41,0
"C16RO",182,224,"1200x900",800,0,600,400,"True",161,474,451,-23,23,1
"C16RO",183,200,"1200x900",600,2,600,400,"True",897,302,249,-53,53,0
"C16RO",184,222,"1200x900",800,0,600,400,"True",152,206,190,-16,16,1
"C16RO",185,438,"1200x900",1000,0,600,400,"False",77,713,541,-172,172,1
"C16RO",186,640,"1200x900",1000,2,600,400,"True",361,334,294,-40,40,0
"C16RO",187,257,"1200x900",800,0,600,400,"True",97,219,212,-7,7,1
"C16RO",188,325,"1200x900",800,1,600,400,"True",105,394,441,47,47,0
"C16RO",189,40,"1200x900",600,0,600,400,"True",143,513,475,-38,38,0
"C16RO",190,30,"1200x900",600,0,600,400,"True",107,353,389,36,36,0
"C16RO",191,320,"1200x900",800,1,600,400,"True",644,376,359,-17,17,0
"C16RO",192,589,"1200x900",1000,2,600,400,"False",856,418,557,139,139,0
"C16RO",193,628,"1200x900",1000,2,600,400,"True",768,410,398,-12,12,0
"C16RO",194,630,"1200x900",1000,2,600,400,"False",754,559,624,65,65,0
"C16RO",195,635,"1200x900",1000,2,600,400,"False",833,402,313,-89,89,0
"C16RO",196,580,"1200x900",1000,2,600,400,"True",651,267,287,20,20,0
"C16RO",197,288,"1200x900",800,0,600,400,"True",180,547,506,-41,41,1
"C16RO",198,615,"1200x900",1000,2,600,400,"True",736,634,591,-43,43,0
"C16RO",199,236,"1200x900",800,0,600,400,"False",162,350,423,73,73,1
"C16RO",200,183,"1200x900",600,2,600,400,"False",927,289,218,-71,71,0
"C16RO",201,103,"1200x900",600,1,600,400,"True",528,320,352,32,32,1
"C16RO",202,311,"1200x900",800,1,600,400,"False",710,261,398,137,137,0
"C16RO",203,646,"1200x900",1000,2,600,400,"True",829,227,225,-2,2,1
"C16RO",204,130,"1200x900",600,1,600,400,"True",741,428,411,-17,17,0
"C16RO",205,228,"1200x900",800,0,600,400,"True",174,687,679,-8,8,1
"C16RO",206,571,"1200x900",1000,1,600,400,"True",239,522,465,-57,57,1
"C16RO",207,393,"1200x900",800,2,600,400,"True",657,620,545,-75,75,0
"C16RO",208,542,"1200x900",1000,1,600,400,"False",304,401,290,-111,111,0
"C16RO",209,165,"1200x900",600,2,600,400,"True",912,554,605,51,51,0
"C16RO",210,50,"1200x900",600,0,600,400,"False",75,582,519,-63,63,0
"C16RO",211,519,"1200x900",1000,1,600,400,"False",319,565,363,-202,202,1
"C16RO",212,198,"1200x900",600,2,600,400,"True",976,500,555,55,55,0
"C16RO",213,185,"1200x900",600,2,600,400,"True",907,212,190,-22,22,0
"C16RO",214,420,"1200x900",800,2,600,400,"True",519,223,222,-1,1,0
"C16RO",215,223,"1200x900",800,0,600,400,"True",179,191,170,-21,21,1
"C16RO",216,28,"1200x900",600,0,600,400,"True",336,410,348,-62,62,1
"C16RO",217,171,"1200x900",600,2,600,400,"True",909,200,164,-36,36,0
"C16RO",218,98,"1200x900",600,1,600,400,"True",625,530,565,35,35,0
"C16RO",219,563,"1200x900",1000,1,600,400,"True",201,696,717,21,21,0
"C16RO",220,398,"1200x900",800,2,600,400,"True",944,698,683,-15,15,0
"C16RO",221,400,"1200x900",800,2,600,400,"True",733,297,287,-10,10,0
"C16RO",222,312,"1200x900",800,1,600,400,"False",238,683,450,-233,233,0
"C16RO",223,618,"1200x900",1000,2,600,400,"True",276,671,609,-62,62,0
"C16RO",224,5,"1200x900",600,0,600,400,"True",228,587,597,10,10,0
"C16RO",225,80,"1200x900",600,1,600,400,"False",616,423,483,60,60,1
"C16RO",226,253,"1200x900",800,0,600,400,"True",177,424,392,-32,32,1
"C16RO",227,208,"1200x900",600,2,600,400,"False",946,399,463,64,64,0
"C16RO",228,297,"1200x900",800,1,600,400,"True",625,244,309,65,65,0
"C16RO",229,205,"1200x900",600,2,600,400,"False",1021,504,570,66,66,0
"C16RO",230,339,"1200x900",800,1,600,400,"True",273,545,484,-61,61,1
"C16RO",231,318,"1200x900",800,1,600,400,"True",788,534,506,-28,28,0
"C16RO",232,231,"1200x900",800,0,600,400,"True",251,718,728,10,10,1
"C16RO",233,73,"1200x900",600,1,600,400,"False",94,665,498,-167,167,0
"C16RO",234,562,"1200x900",1000,1,600,400,"True",347,540,527,-13,13,0
"C16RO",235,553,"1200x900",1000,1,600,400,"False",116,712,409,-303,303,0
"C16RO",236,249,"1200x900",800,0,600,400,"True",126,306,282,-24,24,1
"C16RO",237,299,"1200x900",800,1,600,400,"False",779,274,461,187,187,0
"C16RO",238,507,"1200x900",1000,1,600,400,"True",608,583,557,-26,26,1
"C16RO",239,522,"1200x900",1000,1,600,400,"True",223,379,400,21,21,0
"C16RO",240,327,"1200x900",800,1,600,400,"True",152,339,348,9,9,0
"C16RO",241,140,"1200x900",600,1,600,400,"True",700,523,535,12,12,0
"C16RO",242,452,"1200x900",1000,0,600,400,"True",97,273,333,60,60,1
"C16RO",243,357,"1200x900",800,1,600,400,"True",109,594,557,-37,37,0
"C16RO",244,511,"1200x900",1000,1,600,400,"False",408,390,532,142,142,1
"C16RO",245,276,"1200x900",800,0,600,400,"False",281,217,315,98,98,1
"C16RO",246,517,"1200x900",1000,1,600,400,"False",548,182,253,71,71,0
"C16RO",247,271,"1200x900",800,0,600,400,"True",74,360,334,-26,26,1
"C16RO",248,341,"1200x900",800,1,600,400,"True",735,632,592,-40,40,1
"C16RO",249,437,"1200x900",1000,0,600,400,"False",74,667,596,-71,71,1
"C16RO",250,159,"1200x900",600,2,600,400,"False",992,309,202,-107,107,0
"C16RO",251,12,"1200x900",600,0,600,400,"True",365,336,262,-74,74,1
"C16RO",252,606,"1200x900",1000,2,600,400,"True",653,627,624,-3,3,0
"C16RO",253,535,"1200x900",1000,1,600,400,"False",372,410,500,90,90,0
"C16RO",254,399,"1200x900",800,2,600,400,"True",603,602,579,-23,23,0
"C16RO",255,57,"1200x900",600,0,600,400,"True",354,508,527,19,19,1
"C16RO",256,477,"1200x900",1000,0,600,400,"True",88,640,587,-53,53,1
"C16RO",257,129,"1200x900",600,1,600,400,"False",859,482,374,-108,108,1
"C16RO",258,440,"1200x900",1000,0,600,400,"True",71,237,237,0,0,1
"C16RO",259,302,"1200x900",800,1,600,400,"True",479,467,384,-83,83,1
"C16RO",260,374,"1200x900",800,2,600,400,"True",755,450,475,25,25,0
"C16RO",261,62,"1200x900",600,0,600,400,"True",345,346,356,10,10,1
"C16RO",262,514,"1200x900",1000,1,600,400,"False",539,690,593,-97,97,0
"C16RO",263,574,"1200x900",1000,1,600,400,"False",614,194,360,166,166,0
"C16RO",264,503,"1200x900",1000,0,600,400,"True",86,279,211,-68,68,1
"C16RO",265,335,"1200x900",800,1,600,400,"True",124,360,402,42,42,0
"C16RO",266,14,"1200x900",600,0,600,400,"True",399,224,255,31,31,1
"C16RO",267,209,"1200x900",600,2,600,400,"True",937,637,604,-33,33,0
"C16RO",268,216,"1200x900",600,2,600,400,"True",1029,286,264,-22,22,0
"C16RO",269,636,"1200x900",1000,2,600,400,"False",575,583,475,-108,108,0
"C16RO",270,18,"1200x900",600,0,600,400,"True",400,318,361,43,43,1
"C16RO",271,432,"1200x900",800,2,600,400,"False",792,380,213,-167,167,0
"C16RO",272,484,"1200x900",1000,0,600,400,"True",100,223,185,-38,38,1
"C16RO",273,474,"1200x900",1000,0,600,400,"True",85,339,342,3,3,1
"C16RO",274,252,"1200x900",800,0,600,400,"False",224,673,558,-115,115,1
"C16RO",275,473,"1200x900",1000,0,600,400,"False",75,323,394,71,71,1
"C16RO",276,193,"1200x900",600,2,600,400,"False",874,588,662,74,74,0
"C16RO",277,22,"1200x900",600,0,600,400,"True",398,591,624,33,33,1
"C16RO",278,180,"1200x900",600,2,600,400,"True",929,270,240,-30,30,0
"C16RO",279,476,"1200x900",1000,0,600,400,"True",76,359,395,36,36,1
"C16RO",280,194,"1200x900",600,2,600,400,"True",896,236,248,12,12,0
"C16RO",281,210,"1200x900",600,2,600,400,"False",835,506,630,124,124,0
"C16RO",282,371,"1200x900",800,2,600,400,"True",730,560,577,17,17,0
"C16RO",283,317,"1200x900",800,1,600,400,"True",185,564,474,-90,90,0
"C16RO",284,518,"1200x900",1000,1,600,400,"True",583,717,710,-7,7,0
"C16RO",285,250,"1200x900",800,0,600,400,"False",290,248,361,113,113,1
"C16RO",286,292,"1200x900",800,1,600,400,"False",88,565,454,-111,111,0
"C16RO",287,451,"1200x900",1000,0,600,400,"False",110,702,563,-139,139,1
"C16RO",288,25,"1200x900",600,0,600,400,"True",263,403,440,37,37,1
"C16RO",289,89,"1200x900",600,1,600,400,"False",917,366,469,103,103,1
"C16RO",290,197,"1200x900",600,2,600,400,"False",903,212,337,125,125,0
"C16RO",291,13,"1200x900",600,0,600,400,"True",296,211,218,7,7,1
"C16RO",292,63,"1200x900",600,0,600,400,"True",311,188,204,16,16,1
"C16RO",293,322,"1200x900",800,1,600,400,"False",703,206,322,116,116,1
"C16RO",294,38,"1200x900",600,0,600,400,"False",120,628,505,-123,123,1
"C16RO",295,156,"1200x900",600,2,600,400,"True",913,197,264,67,67,0
"C16RO",296,384,"1200x900",800,2,600,400,"False",821,707,603,-104,104,0
"C16RO",297,645,"1200x900",1000,2,600,400,"False",619,396,277,-119,119,0
"C16RO",298,192,"1200x900",600,2,600,400,"False",1064,320,641,321,321,0
"C16RO",299,543,"1200x900",1000,1,600,400,"False",88,202,298,96,96,0
"C16RO",300,445,"1200x900",1000,0,600,400,"False",78,302,199,-103,103,1
"C16RO",301,201,"1200x900",600,2,600,400,"False",1005,462,305,-157,157,0
"C16RO",302,532,"1200x900",1000,1,600,400,"True",215,207,222,15,15,0
"C16RO",303,594,"1200x900",1000,2,600,400,"True",537,637,592,-45,45,0
"C16RO",304,379,"1200x900",800,2,600,400,"False",994,325,532,207,207,0
"C16RO",305,39,"1200x900",600,0,600,400,"False",210,609,531,-78,78,0
"C16RO",306,151,"1200x900",600,2,600,400,"True",828,680,600,-80,80,0
"C16RO",307,55,"1200x900",600,0,600,400,"False",211,305,411,106,106,1
"C16RO",308,362,"1200x900",800,2,600,400,"False",819,338,459,121,121,0
"C16RO",309,227,"1200x900",800,0,600,400,"False",196,551,428,-123,123,1
"C16RO",310,307,"1200x900",800,1,600,400,"False",716,247,325,78,78,0
"C16RO",311,45,"1200x900",600,0,600,400,"False",487,678,558,-120,120,1
"C16RO",312,190,"1200x900",600,2,600,400,"True",977,238,187,-51,51,0
"C16RO",313,608,"1200x900",1000,2,600,400,"False",742,250,343,93,93,0
"C16RO",314,275,"1200x900",800,0,600,400,"True",120,594,581,-13,13,0
"C16RO",315,338,"1200x900",800,1,600,400,"False",813,253,385,132,132,1
"C16RO",316,405,"1200x900",800,2,600,400,"False",790,307,376,69,69,0
"C16RO",317,79,"1200x900",600,1,600,400,"True",731,289,270,-19,19,0
"C16RO",318,486,"1200x900",1000,0,600,400,"False",102,676,567,-109,109,1
"C16RO",319,466,"1200x900",1000,0,600,400,"True",82,205,250,45,45,1
"C16RO",320,342,"1200x900",800,1,600,400,"True",677,204,180,-24,24,0
"C16RO",321,516,"1200x900",1000,1,600,400,"False",440,559,630,71,71,0
"C16RO",322,349,"1200x900",800,1,600,400,"True",402,665,579,-86,86,0
"C16RO",323,168,"1200x900",600,2,600,400,"False",1001,439,323,-116,116,0
"C16RO",324,144,"1200x900",600,1,600,400,"False",718,371,515,144,144,0
"C16RO",325,404,"1200x900",800,2,600,400,"False",842,396,317,-79,79,0
"C16RO",326,442,"1200x900",1000,0,600,400,"True",87,183,208,25,25,1
"C16RO",327,238,"1200x900",800,0,600,400,"True",162,283,267,-16,16,1
"C16RO",328,178,"1200x900",600,2,600,400,"True",1041,510,549,39,39,0
"C16RO",329,167,"1200x900",600,2,600,400,"True",956,241,305,64,64,0
"C16RO",330,182,"1200x900",600,2,600,400,"False",933,389,236,-153,153,0
"C16RO",331,242,"1200x900",800,0,600,400,"True",117,448,472,24,24,1
"C16RO",332,331,"1200x900",800,1,600,400,"True",240,620,549,-71,71,0
"C16RO",333,126,"1200x900",600,1,600,400,"True",849,354,403,49,49,0
"C16RO",334,149,"1200x900",600,2,600,400,"False",890,289,180,-109,109,0
"C16RO",335,493,"1200x900",1000,0,600,400,"True",80,582,644,62,62,1
"C16RO",336,152,"1200x900",600,2,600,400,"False",971,399,219,-180,180,0
"C16RO",337,500,"1200x900",1000,0,600,400,"True",105,700,661,-39,39,1
"C16RO",338,439,"1200x900",1000,0,600,400,"False",110,229,344,115,115,1
"C16RO",339,478,"1200x900",1000,0,600,400,"False",79,672,589,-83,83,1
"C16RO",340,215,"1200x900",600,2,600,400,"True",939,596,613,17,17,0
"C16RO",341,323,"1200x900",800,1,600,400,"True",388,348,349,1,1,0
"C16RO",342,450,"1200x900",1000,0,600,400,"True",130,204,213,9,9,1
"C16RO",343,529,"1200x900",1000,1,600,400,"False",267,412,324,-88,88,1
"C16RO",344,395,"1200x900",800,2,600,400,"False",743,334,191,-143,143,0
"C16RO",345,74,"1200x900",600,1,600,400,"True",115,358,375,17,17,0
"C16RO",346,461,"1200x900",1000,0,600,400,"True",95,711,702,-9,9,1
"C16RO",347,172,"1200x900",600,2,600,400,"False",912,444,356,-88,88,0
"C16RO",348,483,"1200x900",1000,0,600,400,"True",93,191,173,-18,18,1
"C16RO",349,54,"1200x900",600,0,600,400,"False",474,564,484,-80,80,1
"C16RO",350,523,"1200x900",1000,1,600,400,"False",339,318,398,80,80,0
"C16RO",351,642,"1200x900",1000,2,600,400,"True",776,316,367,51,51,0
"C16RO",352,621,"1200x900",1000,2,600,400,"False",540,478,335,-143,143,0
"C16RO",353,112,"1200x900",600,1,600,400,"True",681,490,492,2,2,0
"C16RO",354,329,"1200x900",800,1,600,400,"False",517,239,368,129,129,0
"C16RO",355,383,"1200x900",800,2,600,400,"False",855,407,521,114,114,0
"C16RO",356,343,"1200x900",800,1,600,400,"False",407,557,444,-113,113,0
"C16RO",357,541,"1200x900",1000,1,600,400,"False",339,478,564,86,86,0
"C16RO",358,64,"1200x900",600,0,600,400,"True",102,339,387,48,48,0
"C16RO",359,113,"1200x900",600,1,600,400,"True",897,657,664,7,7,0
"C16RO",360,611,"1200x900",1000,2,600,400,"True",414,511,538,27,27,0
"C16RO",361,464,"1200x900",1000,0,600,400,"True",82,222,243,21,21,1
"C16RO",362,605,"1200x900",1000,2,600,400,"False",493,665,508,-157,157,0
"C16RO",363,97,"1200x900",600,1,600,400,"True",760,643,567,-76,76,1
"C16RO",364,160,"1200x900",600,2,600,400,"True",863,606,647,41,41,0
"C16RO",365,319,"1200x900",800,1,600,400,"False",494,587,463,-124,124,1
"C16RO",366,521,"1200x900",1000,1,600,400,"True",111,303,284,-19,19,1
"C16RO",367,105,"1200x900",600,1,600,400,"False",527,440,508,68,68,0
"C16RO",368,123,"1200x900",600,1,600,400,"False",761,365,304,-61,61,1
"C16RO",369,545,"1200x900",1000,1,600,400,"True",358,562,576,14,14,0
"C16RO",370,47,"1200x900",600,0,600,400,"True",303,499,484,-15,15,1
"C16RO",371,423,"1200x900",800,2,600,400,"True",1051,710,624,-86,86,1
"C16RO",372,472,"1200x900",1000,0,600,400,"True",77,685,695,10,10,1
"C16RO",373,106,"1200x900",600,1,600,400,"False",803,659,588,-71,71,1
"C16RO",374,286,"1200x900",800,0,600,400,"True",105,378,357,-21,21,1
"C16RO",375,370,"1200x900",800,2,600,400,"False",874,336,228,-108,108,0
"C16RO",376,433,"1200x900",1000,0,600,400,"True",76,222,205,-17,17,1
"C16RO",377,267,"1200x900",800,0,600,400,"True",145,665,622,-43,43,1
"C16RO",378,551,"1200x900",1000,1,600,400,"False",146,445,361,-84,84,1
"C16RO",379,316,"1200x900",800,1,600,400,"False",362,319,532,213,213,0
"C16RO",380,430,"1200x900",800,2,600,400,"True",922,254,325,71,71,0
"C16RO",381,402,"1200x900",800,2,600,400,"True",878,234,213,-21,21,0
"C16RO",382,414,"1200x900",800,2,600,400,"False",831,592,668,76,76,0
"C16RO",383,584,"1200x900",1000,2,600,400,"True",731,413,378,-35,35,0
"C16RO",384,92,"1200x900",600,1,600,400,"True",624,605,613,8,8,0
"C16RO",385,388,"1200x900",800,2,600,400,"False",930,320,611,291,291,0
"C16RO",386,287,"1200x900",800,0,600,400,"True",120,567,576,9,9,1
"C16RO",387,285,"1200x900",800,0,600,400,"True",237,396,439,43,43,1
"C16RO",388,49,"1200x900",600,0,600,400,"True",109,380,357,-23,23,0
"C16RO",389,35,"1200x900",600,0,600,400,"True",366,555,521,-34,34,1
"C16RO",390,69,"1200x900",600,0,600,400,"True",322,268,302,34,34,0
"C16RO",391,555,"1200x900",1000,1,600,400,"False",444,556,471,-85,85,0
"C16RO",392,42,"1200x900",600,0,600,400,"True",233,479,459,-20,20,0
"C16RO",393,67,"1200x900",600,0,600,400,"True",289,308,305,-3,3,1
"C16RO",394,101,"1200x900",600,1,600,400,"True",541,656,595,-61,61,0
"C16RO",395,497,"1200x900",1000,0,600,400,"False",106,696,606,-90,90,1
"C16RO",396,56,"1200x900",600,0,600,400,"True",148,491,476,-15,15,0
"C16RO",397,575,"1200x900",1000,1,600,400,"True",272,693,672,-21,21,0
"C16RO",398,548,"1200x900",1000,1,600,400,"False",103,278,455,177,177,0
"C16RO",399,436,"1200x900",1000,0,600,400,"True",82,617,582,-35,35,1
"C16RO",400,458,"1200x900",1000,0,600,400,"True",78,624,608,-16,16,1
"C16RO",401,274,"1200x900",800,0,600,400,"True",146,497,525,28,28,1
"C16RO",402,550,"1200x900",1000,1,600,400,"False",301,459,541,82,82,0
"C16RO",403,380,"1200x900",800,2,600,400,"True",942,228,187,-41,41,0
"C16RO",404,268,"1200x900",800,0,600,400,"True",148,400,406,6,6,1
"C16RO",405,90,"1200x900",600,1,600,400,"False",560,474,341,-133,133,0
"C16RO",406,629,"1200x900",1000,2,600,400,"False",681,257,472,215,215,0
"C16RO",407,244,"1200x900",800,0,600,400,"True",194,203,225,22,22,1
"C16RO",408,247,"1200x900",800,0,600,400,"True",160,424,427,3,3,1
"C16RO",409,361,"1200x900",800,2,600,400,"False",931,328,231,-97,97,0
"C16RO",410,207,"1200x900",600,2,600,400,"False",838,235,156,-79,79,0
"C16RO",411,72,"1200x900",600,0,600,400,"True",158,537,524,-13,13,0
"C16RO",412,346,"1200x900",800,1,600,400,"False",269,635,466,-169,169,0
"C16RO",413,289,"1200x900",800,1,600,400,"False",421,703,541,-162,162,1
"C16RO",414,427,"1200x900",800,2,600,400,"True",812,380,370,-10,10,0
"C16RO",415,332,"1200x900",800,1,600,400,"False",260,699,298,-401,401,0
"C16RO",416,407,"1200x900",800,2,600,400,"False",989,340,204,-136,136,0
"C16RO",417,298,"1200x900",800,1,600,400,"False",311,457,358,-99,99,0
"C16RO",418,181,"1200x900",600,2,600,400,"True",1018,223,179,-44,44,0
"C16RO",419,157,"1200x900",600,2,600,400,"False",1016,323,243,-80,80,0
"C16RO",420,118,"1200x900",600,1,600,400,"False",190,588,475,-113,113,0
"C16RO",421,232,"1200x900",800,0,600,400,"True",84,511,518,7,7,1
"C16RO",422,581,"1200x900",1000,2,600,400,"True",310,357,314,-43,43,0
"C16RO",423,587,"1200x900",1000,2,600,400,"False",741,686,280,-406,406,0
"C16RO",424,336,"1200x900",800,1,600,400,"False",251,587,398,-189,189,0
"C16RO",425,52,"1200x900",600,0,600,400,"True",171,188,200,12,12,0
"C16RO",426,375,"1200x900",800,2,600,400,"False",716,384,199,-185,185,0
"C16RO",427,491,"1200x900",1000,0,600,400,"True",108,198,164,-34,34,1
"C16RO",428,485,"1200x900",1000,0,600,400,"True",121,694,651,-43,43,1
"C16RO",429,82,"1200x900",600,1,600,400,"True",108,213,247,34,34,0
"C16RO",430,272,"1200x900",800,0,600,400,"True",200,181,163,-18,18,1
"C16RO",431,186,"1200x900",600,2,600,400,"True",997,197,181,-16,16,0
"C16RO",432,304,"1200x900",800,1,600,400,"False",667,605,401,-204,204,0
"C16RO",433,310,"1200x900",800,1,600,400,"True",559,592,642,50,50,0
"C16RO",434,19,"1200x900",600,0,600,400,"True",286,686,668,-18,18,0
"C16RO",435,449,"1200x900",1000,0,600,400,"True",105,683,626,-57,57,1
"C16RO",436,337,"1200x900",800,1,600,400,"False",299,622,465,-157,157,0
"C16RO",437,424,"1200x900",800,2,600,400,"False",903,545,418,-127,127,0
"C16RO",438,403,"1200x900",800,2,600,400,"False",625,704,540,-164,164,0
"C16RO",439,326,"1200x900",800,1,600,400,"True",103,482,527,45,45,0
"C16RO",440,266,"1200x900",800,0,600,400,"True",126,303,345,42,42,1
"C16RO",441,441,"1200x900",1000,0,600,400,"False",85,684,590,-94,94,1
"C16RO",442,446,"1200x900",1000,0,600,400,"True",72,298,361,63,63,1
"C16RO",443,378,"1200x900",800,2,600,400,"False",1018,708,565,-143,143,0
"C16RO",444,577,"1200x900",1000,2,600,400,"True",455,420,481,61,61,0
"C16RO",445,308,"1200x900",800,1,600,400,"True",437,425,420,-5,5,0
"C16RO",446,122,"1200x900",600,1,600,400,"True",817,709,686,-23,23,0
"C16RO",447,510,"1200x900",1000,1,600,400,"True",486,338,402,64,64,1
"C16RO",448,421,"1200x900",800,2,600,400,"False",898,394,268,-126,126,0
"C16RO",449,245,"1200x900",800,0,600,400,"True",296,235,200,-35,35,1
"C16RO",450,592,"1200x900",1000,2,600,400,"False",492,392,614,222,222,0
"C16RO",451,358,"1200x900",800,1,600,400,"False",263,635,439,-196,196,0
"C16RO",452,409,"1200x900",800,2,600,400,"True",501,659,595,-64,64,0
"C16RO",453,505,"1200x900",1000,1,600,400,"False",191,484,388,-96,96,1
"C16RO",454,352,"1200x900",800,1,600,400,"False",235,717,575,-142,142,0
"C16RO",455,84,"1200x900",600,1,600,400,"True",144,184,233,49,49,0
"C16RO",456,114,"1200x900",600,1,600,400,"True",183,697,622,-75,75,0
"C16RO",457,366,"1200x900",800,2,600,400,"True",931,464,410,-54,54,0
"C16RO",458,295,"1200x900",800,1,600,400,"True",471,334,357,23,23,0
"C16RO",459,161,"1200x900",600,2,600,400,"True",939,553,570,17,17,0
"C16RO",460,467,"1200x900",1000,0,600,400,"True",74,712,674,-38,38,1
"C16RO",461,401,"1200x900",800,2,600,400,"False",821,260,178,-82,82,0
"C16RO",462,7,"1200x900",600,0,600,400,"False",431,654,564,-90,90,1
"C16RO",463,313,"1200x900",800,1,600,400,"True",588,421,456,35,35,0
"C16RO",464,53,"1200x900",600,0,600,400,"True",177,189,222,33,33,0
"C16RO",465,624,"1200x900",1000,2,600,400,"False",693,501,408,-93,93,0
"C16RO",466,444,"1200x900",1000,0,600,400,"False",101,714,622,-92,92,1
"C16RO",467,426,"1200x900",800,2,600,400,"True",830,263,287,24,24,0
"C16RO",468,96,"1200x900",600,1,600,400,"True",433,458,476,18,18,0
"C16RO",469,81,"1200x900",600,1,600,400,"False",696,225,323,98,98,0
"C16RO",470,117,"1200x900",600,1,600,400,"False",711,456,355,-101,101,0
"C16RO",471,623,"1200x900",1000,2,600,400,"False",636,527,360,-167,167,0
"C16RO",472,9,"1200x900",600,0,600,400,"False",509,654,544,-110,110,1
"C16RO",473,494,"1200x900",1000,0,600,400,"False",127,692,581,-111,111,1
"C16RO",474,8,"1200x900",600,0,600,400,"True",156,679,625,-54,54,0
"C16RO",475,135,"1200x900",600,1,600,400,"True",759,569,611,42,42,0
"C16RO",476,10,"1200x900",600,0,600,400,"True",400,499,475,-24,24,1
"C16RO",477,282,"1200x900",800,0,600,400,"True",109,246,311,65,65,1
"C16RO",478,314,"1200x900",800,1,600,400,"False",277,616,529,-87,87,1
"C16RO",479,413,"1200x900",800,2,600,400,"False",849,506,595,89,89,0
"C16RO",480,419,"1200x900",800,2,600,400,"True",769,351,311,-40,40,0
"C16RO",481,422,"1200x900",800,2,600,400,"True",712,558,539,-19,19,0
"C16RO",482,184,"1200x900",600,2,600,400,"False",1067,441,592,151,151,0
"C16RO",483,284,"1200x900",800,0,600,400,"True",135,293,263,-30,30,1
"C16RO",484,240,"1200x900",800,0,600,400,"True",330,656,614,-42,42,1
"C16RO",485,37,"1200x900",600,0,600,400,"True",258,403,428,25,25,1
"C16RO",486,459,"1200x900",1000,0,600,400,"True",70,645,634,-11,11,1
"C16RO",487,6,"1200x900",600,0,600,400,"True",217,689,635,-54,54,1
"C16RO",488,632,"1200x900",1000,2,600,400,"False",984,227,525,298,298,0
"C16RO",489,16,"1200x900",600,0,600,400,"True",297,514,491,-23,23,1
"C16RO",490,595,"1200x900",1000,2,600,400,"False",687,640,403,-237,237,0
"C16RO",491,465,"1200x900",1000,0,600,400,"True",85,203,229,26,26,1
"C16RO",492,552,"1200x900",1000,1,600,400,"True",255,412,331,-81,81,0
"C16RO",493,202,"1200x900",600,2,600,400,"True",966,460,402,-58,58,0
"C16RO",494,20,"1200x900",600,0,600,400,"True",204,545,527,-18,18,1
"C16RO",495,206,"1200x900",600,2,600,400,"True",975,223,248,25,25,0
"C16RO",496,560,"1200x900",1000,1,600,400,"False",516,693,616,-77,77,0
"C16RO",497,176,"1200x900",600,2,600,400,"False",1033,281,206,-75,75,0
"C16RO",498,344,"1200x900",800,1,600,400,"True",589,408,474,66,66,0
"C16RO",499,613,"1200x900",1000,2,600,400,"False",690,374,449,75,75,0
"C16RO",500,530,"1200x900",1000,1,600,400,"False",584,405,315,-90,90,1
"C16RO",501,251,"1200x900",800,0,600,400,"False",88,352,262,-90,90,1
"C16RO",502,280,"1200x900",800,0,600,400,"True",104,302,308,6,6,1
"C16RO",503,128,"1200x900",600,1,600,400,"True",661,258,311,53,53,1
"C16RO",504,66,"1200x900",600,0,600,400,"True",155,673,602,-71,71,0
"C16RO",505,648,"1200x900",1000,2,600,400,"False",557,394,325,-69,69,0
"C16RO",506,85,"1200x900",600,1,600,400,"True",434,347,388,41,41,0
"C16RO",507,204,"1200x900",600,2,600,400,"False",1053,432,329,-103,103,0
"C16RO",508,586,"1200x900",1000,2,600,400,"False",802,262,380,118,118,0
"C16RO",509,607,"1200x900",1000,2,600,400,"True",900,573,571,-2,2,1
"C16RO",510,107,"1200x900",600,1,600,400,"True",878,678,675,-3,3,0
"C16RO",511,24,"1200x900",600,0,600,400,"True",430,538,566,28,28,1
"C16RO",512,241,"1200x900",800,0,600,400,"True",129,227,255,28,28,1
"C16RO",513,425,"1200x900",800,2,600,400,"True",621,438,455,17,17,0
"C16RO",514,525,"1200x900",1000,1,600,400,"False",123,690,604,-86,86,0
"C16RO",515,179,"1200x900",600,2,600,400,"True",908,602,598,-4,4,0
"C16RO",516,614,"1200x900",1000,2,600,400,"False",823,563,335,-228,228,0
"C16RO",517,572,"1200x900",1000,1,600,400,"True",302,260,301,41,41,0
"C16RO",518,309,"1200x900",800,1,600,400,"False",186,225,345,120,120,0
"C16RO",519,546,"1200x900",1000,1,600,400,"True",305,374,337,-37,37,0
"C16RO",520,211,"1200x900",600,2,600,400,"False",986,407,319,-88,88,0
"C16RO",521,345,"1200x900",800,1,600,400,"False",841,566,388,-178,178,1
"C16RO",522,93,"1200x900",600,1,600,400,"True",139,540,530,-10,10,0
"C16RO",523,508,"1200x900",1000,1,600,400,"True",596,485,538,53,53,0
"C16RO",524,164,"1200x900",600,2,600,400,"True",1051,268,239,-29,29,0
"C16RO",525,265,"1200x900",800,0,600,400,"True",229,353,330,-23,23,1
"C16RO",526,88,"1200x900",600,1,600,400,"True",186,554,533,-21,21,0
"C16RO",527,124,"1200x900",600,1,600,400,"False",345,467,383,-84,84,0
"C16RO",528,31,"1200x900",600,0,600,400,"True",365,338,350,12,12,1
"C16RO",529,481,"1200x900",1000,0,600,400,"True",80,185,182,-3,3,1
"C16RO",530,489,"1200x900",1000,0,600,400,"False",88,604,451,-153,153,1
"C16RO",531,620,"1200x900",1000,2,600,400,"False",832,649,415,-234,234,0
"C16RO",532,162,"1200x900",600,2,600,400,"False",849,279,378,99,99,0
"C16RO",533,556,"1200x900",1000,1,600,400,"False",415,420,581,161,161,0
"C16RO",534,353,"1200x900",800,1,600,400,"False",90,476,342,-134,134,0
"C16RO",535,501,"1200x900",1000,0,600,400,"True",96,323,351,28,28,1
"C16RO",536,643,"1200x900",1000,2,600,400,"True",740,325,269,-56,56,0
"C16RO",537,17,"1200x900",600,0,600,400,"True",402,496,467,-29,29,1
"C16RO",538,558,"1200x900",1000,1,600,400,"False",72,464,369,-95,95,1
"C16RO",539,359,"1200x900",800,1,600,400,"False",653,241,363,122,122,0
"C16RO",540,270,"1200x900",800,0,600,400,"True",192,418,413,-5,5,1
"C16RO",541,294,"1200x900",800,1,600,400,"True",262,287,321,34,34,0
"C16RO",542,619,"1200x900",1000,2,600,400,"False",803,247,398,151,151,0
"C16RO",543,111,"1200x900",600,1,600,400,"True",922,552,581,29,29,1
"C16RO",544,365,"1200x900",800,2,600,400,"False",1055,305,508,203,203,0
"C16RO",545,591,"1200x900",1000,2,600,400,"False",698,336,418,82,82,0
"C16RO",546,258,"1200x900",800,0,600,400,"False",126,664,559,-105,105,1
"C16RO",547,83,"1200x900",600,1,600,400,"True",763,568,609,41,41,1
"C16RO",548,502,"1200x900",1000,0,600,400,"True",111,639,648,9,9,1
"C16RO",549,479,"1200x900",1000,0,600,400,"False",74,705,638,-67,67,1
"C16RO",550,568,"1200x900",1000,1,600,400,"False",286,475,393,-82,82,1
"C16RO",551,598,"1200x900",1000,2,600,400,"False",706,559,470,-89,89,0
"C16RO",552,539,"1200x900",1000,1,600,400,"False",510,383,459,76,76,0
"C16RO",553,382,"1200x900",800,2,600,400,"False",870,523,414,-109,109,0
"C16RO",554,356,"1200x900",800,1,600,400,"False",123,484,382,-102,102,0
"C16RO",555,254,"1200x900",800,0,600,400,"True",136,583,564,-19,19,1
"C16RO",556,58,"1200x900",600,0,600,400,"True",353,655,619,-36,36,1
"C16RO",557,492,"1200x900",1000,0,600,400,"True",76,692,659,-33,33,1
"C16RO",558,554,"1200x900",1000,1,600,400,"True",79,309,338,29,29,1
"C16RO",559,237,"1200x900",800,0,600,400,"False",204,481,403,-78,78,1
"C16RO",560,641,"1200x900",1000,2,600,400,"False",897,272,520,248,248,0
"C16RO",561,11,"1200x900",600,0,600,400,"True",372,670,616,-54,54,1
"C16RO",562,350,"1200x900",800,1,600,400,"False",182,566,414,-152,152,0
"C16RO",563,34,"1200x900",600,0,600,400,"True",361,242,259,17,17,1
"C16RO",564,132,"1200x900",600,1,600,400,"True",333,185,139,-46,46,0
"C16RO",565,119,"1200x900",600,1,600,400,"False",168,563,472,-91,91,0
"C16RO",566,596,"1200x900",1000,2,600,400,"True",706,513,532,19,19,0
"C16RO",567,540,"1200x900",1000,1,600,400,"True",389,568,512,-56,56,1
"C16RO",568,603,"1200x900",1000,2,600,400,"True",693,280,295,15,15,0
"C16RO",569,61,"1200x900",600,0,600,400,"False",272,670,590,-80,80,1
"C16RO",570,213,"1200x900",600,2,600,400,"True",822,275,292,17,17,0
"C16RO",571,524,"1200x900",1000,1,600,400,"False",534,470,248,-222,222,0
"C16RO",572,188,"1200x900",600,2,600,400,"True",900,195,170,-25,25,0
"C16RO",573,305,"1200x900",800,1,600,400,"True",471,716,672,-44,44,0
"C16RO",574,2,"1200x900",600,0,600,400,"False",159,323,421,98,98,0
"C16RO",575,471,"1200x900",1000,0,600,400,"True",122,200,221,21,21,1
"C16RO",576,75,"1200x900",600,1,600,400,"True",635,558,571,13,13,0
"C16RO",577,59,"1200x900",600,0,600,400,"True",391,692,631,-61,61,1
"C16RO",578,32,"1200x900",600,0,600,400,"True",152,563,536,-27,27,1
"C16RO",579,531,"1200x900",1000,1,600,400,"True",233,362,422,60,60,0
"C16RO",580,576,"1200x900",1000,1,600,400,"True",376,713,693,-20,20,0
"C16RO",581,469,"1200x900",1000,0,600,400,"True",73,227,279,52,52,1
"C16RO",582,21,"1200x900",600,0,600,400,"True",314,383,352,-31,31,1
"C16RO",583,582,"1200x900",1000,2,600,400,"True",554,347,331,-16,16,0
"C16RO",584,191,"1200x900",600,2,600,400,"True",962,396,351,-45,45,0
"C16RO",585,368,"1200x900",800,2,600,400,"True",778,515,521,6,6,0
"C16RO",586,447,"1200x900",1000,0,600,400,"True",71,339,358,19,19,1
"C16RO",587,431,"1200x900",800,2,600,400,"True",694,382,418,36,36,0
"C16RO",588,262,"1200x900",800,0,600,400,"True",196,481,493,12,12,1
"C16RO",589,600,"1200x900",1000,2,600,400,"False",765,207,336,129,129,0
"C16RO",590,226,"1200x900",800,0,600,400,"True",187,229,240,11,11,1
"C16RO",591,333,"1200x900",800,1,600,400,"True",521,548,553,5,5,0
"C16RO",592,248,"1200x900",800,0,600,400,"True",94,240,289,49,49,1
"C16RO",593,334,"1200x900",800,1,600,400,"True",481,665,608,-57,57,0
"C16RO",594,278,"1200x900",800,0,600,400,"True",251,711,678,-33,33,1
"C16RO",595,234,"1200x900",800,0,600,400,"True",72,344,358,14,14,1
"C16RO",596,120,"1200x900",600,1,600,400,"True",690,655,595,-60,60,0
"C16RO",597,218,"1200x900",800,0,600,400,"True",106,397,393,-4,4,1
"C16RO",598,391,"1200x900",800,2,600,400,"True",895,521,467,-54,54,0
"C16RO",599,644,"1200x900",1000,2,600,400,"False",495,486,354,-132,132,0
"C16RO",600,488,"1200x900",1000,0,600,400,"True",129,687,630,-57,57,1
"C16RO",601,170,"1200x900",600,2,600,400,"False",996,468,382,-86,86,0
"C16RO",602,115,"1200x900",600,1,600,400,"True",545,307,353,46,46,0
"C16RO",603,230,"1200x900",800,0,600,400,"True",99,678,639,-39,39,1
"C16RO",604,364,"1200x900",800,2,600,400,"False",1018,204,444,240,240,0
"C16RO",605,324,"1200x900",800,1,600,400,"False",719,712,514,-198,198,1
"C16RO",606,559,"1200x900",1000,1,600,400,"True",641,244,294,50,50,0
"C16RO",607,534,"1200x900",1000,1,600,400,"False",328,504,290,-214,214,1
"C16RO",608,373,"1200x900",800,2,600,400,"False",694,326,463,137,137,0
"C16RO",609,256,"1200x900",800,0,600,400,"True",192,656,594,-62,62,1
"C16RO",610,475,"1200x900",1000,0,600,400,"False",101,715,643,-72,72,1
"C16RO",611,273,"1200x900",800,0,600,400,"True",180,309,289,-20,20,1
"C16RO",612,496,"1200x900",1000,0,600,400,"True",70,639,605,-34,34,1
"C16RO",613,315,"1200x900",800,1,600,400,"True",105,211,253,42,42,0
"C16RO",614,48,"1200x900",600,0,600,400,"False",323,645,566,-79,79,1
"C16RO",615,602,"1200x900",1000,2,600,400,"False",865,452,273,-179,179,0
"C16RO",616,410,"1200x900",800,2,600,400,"False",916,477,276,-201,201,0
"C16RO",617,417,"1200x900",800,2,600,400,"True",750,280,303,23,23,0
"C16RO",618,360,"1200x900",800,1,600,400,"False",203,608,499,-109,109,0
"C16RO",619,51,"1200x900",600,0,600,400,"True",272,181,201,20,20,1
"C16RO",620,536,"1200x900",1000,1,600,400,"True",580,213,218,5,5,0
"C16RO",621,233,"1200x900",800,0,600,400,"True",164,700,665,-35,35,1
"C16RO",622,150,"1200x900",600,2,600,400,"True",897,345,355,10,10,0
"C16RO",623,513,"1200x900",1000,1,600,400,"False",235,602,392,-210,210,0
"C16RO",624,99,"1200x900",600,1,600,400,"False",811,407,485,78,78,0
"C16RO",625,187,"1200x900",600,2,600,400,"True",857,639,619,-20,20,0
"C16RO",626,622,"1200x900",1000,2,600,400,"False",307,683,596,-87,87,0
"C16RO",627,260,"1200x900",800,0,600,400,"True",103,525,535,10,10,1
"C16RO",628,638,"1200x900",1000,2,600,400,"False",385,198,299,101,101,0
"C16RO",629,351,"1200x900",800,1,600,400,"True",122,581,558,-23,23,0
"C16RO",630,504,"1200x900",1000,0,600,400,"False",107,699,631,-68,68,1
"C16RO",631,610,"1200x900",1000,2,600,400,"False",702,293,177,-116,116,0
"C16RO",632,148,"1200x900",600,2,600,400,"True",907,330,278,-52,52,0
"C16RO",633,133,"1200x900",600,1,600,400,"False",345,551,413,-138,138,0
"C16RO",634,567,"1200x900",1000,1,600,400,"True",655,297,334,37,37,1
"C16RO",635,255,"1200x900",800,0,600,400,"False",93,709,624,-85,85,1
"C16RO",636,566,"1200x900",1000,1,600,400,"True",378,472,468,-4,4,1
"C16RO",637,104,"1200x900",600,1,600,400,"False",448,584,463,-121,121,0
"C16RO",638,355,"1200x900",800,1,600,400,"True",77,386,444,58,58,0
"C16RO",639,60,"1200x900",600,0,600,400,"False",365,213,280,67,67,1
"C16RO",640,454,"1200x900",1000,0,600,400,"False",78,687,571,-116,116,1
"C16RO",641,328,"1200x900",800,1,600,400,"False",104,649,538,-111,111,0
"C16RO",642,127,"1200x900",600,1,600,400,"False",309,691,572,-119,119,0
"C16RO",643,579,"1200x900",1000,2,600,400,"False",803,394,553,159,159,0
"C16RO",644,137,"1200x900",600,1,600,400,"True",789,577,608,31,31,0
"C16RO",645,125,"1200x900",600,1,600,400,"True",750,531,554,23,23,0
"C16RO",647,44,"1200x900",600,0,600,400,"True",305,554,575,21,21,1
"C16RO",648,463,"1200x900",1000,0,600,400,"False",115,693,617,-76,76,1
"C17GL",1,276,"1200x900",800,0,600,400,"False",281,217,415,198,198,1
"C17GL",2,197,"1200x900",600,2,600,400,"True",903,212,199,-13,13,0
"C17GL",3,503,"1200x900",1000,0,600,400,"False",86,279,439,160,160,1
"C17GL",4,15,"1200x900",600,0,600,400,"False",473,352,429,77,77,1
"C17GL",5,450,"1200x900",1000,0,600,400,"False",130,204,376,172,172,1
"C17GL",6,64,"1200x900",600,0,600,400,"True",102,339,347,8,8,0
"C17GL",7,130,"1200x900",600,1,600,400,"True",741,428,469,41,41,0
"C17GL",8,176,"1200x900",600,2,600,400,"False",1033,281,401,120,120,0
"C17GL",9,85,"1200x900",600,1,600,400,"True",434,347,360,13,13,0
"C17GL",10,407,"1200x900",800,2,600,400,"False",989,340,614,274,274,0
"C17GL",11,635,"1200x900",1000,2,600,400,"False",833,402,529,127,127,0
"C17GL",12,38,"1200x900",600,0,600,400,"False",120,628,559,-69,69,1
"C17GL",13,136,"1200x900",600,1,600,400,"False",264,205,423,218,218,0
"C17GL",14,391,"1200x900",800,2,600,400,"False",895,521,463,-58,58,0
"C17GL",15,116,"1200x900",600,1,600,400,"True",767,289,397,108,108,0
"C17GL",16,21,"1200x900",600,0,600,400,"True",314,383,444,61,61,1
"C17GL",17,144,"1200x900",600,1,600,400,"True",718,371,417,46,46,0
"C17GL",19,291,"1200x900",800,1,600,400,"False",522,694,572,-122,122,0
"C17GL",20,599,"1200x900",1000,2,600,400,"False",316,570,634,64,64,0
"C17GL",21,553,"1200x900",1000,1,600,400,"False",116,712,588,-124,124,0
"C17GL",23,97,"1200x900",600,1,600,400,"True",760,643,626,-17,17,1
"C17GL",24,199,"1200x900",600,2,600,400,"False",992,467,396,-71,71,0
"C17GL",25,157,"1200x900",600,2,600,400,"False",1016,323,488,165,165,0
"C17GL",26,226,"1200x900",800,0,600,400,"False",187,229,310,81,81,1
"C17GL",27,590,"1200x900",1000,2,600,400,"False",636,278,478,200,200,0
"C17GL",28,429,"1200x900",800,2,600,400,"False",682,692,411,-281,281,0
"C17GL",29,220,"1200x900",800,0,600,400,"False",108,699,604,-95,95,1
"C17GL",31,126,"1200x900",600,1,600,400,"False",849,354,503,149,149,0
"C17GL",32,185,"1200x900",600,2,600,400,"False",907,212,434,222,222,0
"C17GL",33,499,"1200x900",1000,0,600,400,"False",93,271,395,124,124,1
"C17GL",34,507,"1200x900",1000,1,600,400,"False",608,583,510,-73,73,1
"C17GL",35,322,"1200x900",800,1,600,400,"False",703,206,441,235,235,1
"C17GL",36,46,"1200x900",600,0,600,400,"True",193,355,373,18,18,1
"C17GL",37,353,"1200x900",800,1,600,400,"False",90,476,297,-179,179,0
"C17GL",38,72,"1200x900",600,0,600,400,"True",158,537,501,-36,36,0
"C17GL",39,194,"1200x900",600,2,600,400,"False",896,236,410,174,174,0
"C17GL",40,269,"1200x900",800,0,600,400,"False",160,295,365,70,70,1
"C17GL",41,384,"1200x900",800,2,600,400,"False",821,707,538,-169,169,0
"C17GL",42,29,"1200x900",600,0,600,400,"False",385,533,607,74,74,1
"C17GL",43,516,"1200x900",1000,1,600,400,"True",440,559,526,-33,33,0
"C17GL",44,222,"1200x900",800,0,600,400,"False",152,206,375,169,169,1
"C17GL",45,355,"1200x900",800,1,600,400,"True",77,386,306,-80,80,0
"C17GL",46,193,"1200x900",600,2,600,400,"True",874,588,568,-20,20,0
"C17GL",47,183,"1200x900",600,2,600,400,"False",927,289,529,240,240,0
"C17GL",48,198,"1200x900",600,2,600,400,"True",976,500,498,-2,2,0
"C17GL",49,37,"1200x900",600,0,600,400,"True",258,403,424,21,21,1
"C17GL",51,40,"1200x900",600,0,600,400,"True",143,513,558,45,45,0
"C17GL",52,8,"1200x900",600,0,600,400,"True",156,679,666,-13,13,0
"C17GL",53,28,"1200x900",600,0,600,400,"True",336,410,453,43,43,1
"C17GL",55,459,"1200x900",1000,0,600,400,"False",70,645,548,-97,97,1
"C17GL",56,213,"1200x900",600,2,600,400,"False",822,275,504,229,229,0
"C17GL",57,209,"1200x900",600,2,600,400,"True",937,637,566,-71,71,0
"C17GL",58,630,"1200x900",1000,2,600,400,"True",754,559,597,38,38,0
"C17GL",59,135,"1200x900",600,1,600,400,"True",759,569,622,53,53,0
"C17GL",60,175,"1200x900",600,2,600,400,"False",1028,432,253,-179,179,0
"C17GL",61,227,"1200x900",800,0,600,400,"True",196,551,608,57,57,1
"C17GL",62,505,"1200x900",1000,1,600,400,"True",191,484,447,-37,37,1
"C17GL",63,308,"1200x900",800,1,600,400,"False",437,425,503,78,78,0
"C17GL",64,449,"1200x900",1000,0,600,400,"False",105,683,548,-135,135,1
"C17GL",65,408,"1200x900",800,2,600,400,"True",758,567,514,-53,53,0
"C17GL",66,485,"1200x900",1000,0,600,400,"False",121,694,570,-124,124,1
"C17GL",67,300,"1200x900",800,1,600,400,"False",620,693,599,-94,94,0
"C17GL",68,361,"1200x900",800,2,600,400,"False",931,328,437,109,109,0
"C17GL",69,350,"1200x900",800,1,600,400,"False",182,566,410,-156,156,0
"C17GL",70,106,"1200x900",600,1,600,400,"False",803,659,409,-250,250,1
"C17GL",71,483,"1200x900",1000,0,600,400,"False",93,191,342,151,151,1
"C17GL",72,162,"1200x900",600,2,600,400,"True",849,279,293,14,14,0
"C17GL",73,356,"1200x900",800,1,600,400,"False",123,484,398,-86,86,0
"C17GL",74,235,"1200x900",800,0,600,400,"False",146,646,523,-123,123,1
"C17GL",75,559,"1200x900",1000,1,600,400,"True",641,244,220,-24,24,0
"C17GL",76,343,"1200x900",800,1,600,400,"False",407,557,362,-195,195,0
"C17GL",77,522,"1200x900",1000,1,600,400,"True",223,379,426,47,47,0
"C17GL",78,118,"1200x900",600,1,600,400,"False",190,588,377,-211,211,0
"C17GL",79,47,"1200x900",600,0,600,400,"True",303,499,464,-35,35,1
"C17GL",80,474,"1200x900",1000,0,600,400,"False",85,339,436,97,97,1
"C17GL",81,528,"1200x900",1000,1,600,400,"False",839,227,576,349,349,1
"C17GL",82,472,"1200x900",1000,0,600,400,"False",77,685,574,-111,111,1
"C17GL",83,354,"1200x900",800,1,600,400,"False",118,236,593,357,357,0
"C17GL",84,234,"1200x900",800,0,600,400,"True",72,344,399,55,55,1
"C17GL",85,58,"1200x900",600,0,600,400,"False",353,655,592,-63,63,1
"C17GL",86,167,"1200x900",600,2,600,400,"False",956,241,613,372,372,0
"C17GL",87,282,"1200x900",800,0,600,400,"False",109,246,384,138,138,1
"C17GL",88,207,"1200x900",600,2,600,400,"False",838,235,320,85,85,0
"C17GL",89,458,"1200x900",1000,0,600,400,"False",78,624,430,-194,194,1
"C17GL",90,146,"1200x900",600,2,600,400,"False",989,492,232,-260,260,0
"C17GL",91,206,"1200x900",600,2,600,400,"False",975,223,517,294,294,0
"C17GL",92,448,"1200x900",1000,0,600,400,"False",107,641,546,-95,95,1
"C17GL",93,137,"1200x900",600,1,600,400,"True",789,577,594,17,17,0
"C17GL",94,239,"1200x900",800,0,600,400,"False",114,231,416,185,185,1
"C17GL",95,432,"1200x900",800,2,600,400,"False",792,380,322,-58,58,0
"C17GL",96,518,"1200x900",1000,1,600,400,"False",583,717,519,-198,198,0
"C17GL",97,152,"1200x900",600,2,600,400,"True",971,399,385,-14,14,0
"C17GL",98,262,"1200x900",800,0,600,400,"True",196,481,440,-41,41,1
"C17GL",99,565,"1200x900",1000,1,600,400,"True",451,562,573,11,11,0
"C17GL",100,128,"1200x900",600,1,600,400,"False",661,258,394,136,136,1
"C17GL",101,628,"1200x900",1000,2,600,400,"False",768,410,522,112,112,0
"C17GL",102,54,"1200x900",600,0,600,400,"True",474,564,510,-54,54,1
"C17GL",103,267,"1200x900",800,0,600,400,"True",145,665,645,-20,20,1
"C17GL",104,484,"1200x900",1000,0,600,400,"False",100,223,509,286,286,1
"C17GL",105,502,"1200x900",1000,0,600,400,"False",111,639,563,-76,76,1
"C17GL",106,56,"1200x900",600,0,600,400,"True",148,491,531,40,40,0
"C17GL",107,296,"1200x900",800,1,600,400,"False",89,279,490,211,211,0
"C17GL",108,208,"1200x900",600,2,600,400,"True",946,399,408,9,9,0
"C17GL",109,115,"1200x900",600,1,600,400,"False",545,307,438,131,131,0
"C17GL",110,215,"1200x900",600,2,600,400,"False",939,596,423,-173,173,0
"C17GL",111,385,"1200x900",800,2,600,400,"False",740,456,642,186,186,0
"C17GL",112,31,"1200x900",600,0,600,400,"True",365,338,315,-23,23,1
"C17GL",113,147,"1200x900",600,2,600,400,"False",942,418,356,-62,62,0
"C17GL",114,288,"1200x900",800,0,600,400,"False",180,547,645,98,98,1
"C17GL",115,178,"1200x900",600,2,600,400,"False",1041,510,634,124,124,0
"C17GL",116,515,"1200x900",1000,1,600,400,"False",307,217,399,182,182,0
"C17GL",117,486,"1200x900",1000,0,600,400,"False",102,676,324,-352,352,1
"C17GL",118,129,"1200x900",600,1,600,400,"False",859,482,362,-120,120,1
"C17GL",119,544,"1200x900",1000,1,600,400,"False",602,620,472,-148,148,0
"C17GL",120,218,"1200x900",800,0,600,400,"True",106,397,461,64,64,1
"C17GL",121,170,"1200x900",600,2,600,400,"False",996,468,394,-74,74,0
"C17GL",122,133,"1200x900",600,1,600,400,"False",345,551,326,-225,225,0
"C17GL",123,372,"1200x900",800,2,600,400,"True",833,620,624,4,4,0
"C17GL",124,141,"1200x900",600,1,600,400,"True",671,582,575,-7,7,0
"C17GL",125,124,"1200x900",600,1,600,400,"False",345,467,358,-109,109,0
"C17GL",126,409,"1200x900",800,2,600,400,"True",501,659,644,-15,15,0
"C17GL",127,177,"1200x900",600,2,600,400,"False",912,236,426,190,190,0
"C17GL",128,71,"1200x900",600,0,600,400,"False",219,248,334,86,86,0
"C17GL",129,618,"1200x900",1000,2,600,400,"False",276,671,326,-345,345,0
"C17GL",130,557,"1200x900",1000,1,600,400,"True",677,505,533,28,28,1
"C17GL",131,278,"1200x900",800,0,600,400,"False",251,711,579,-132,132,1
"C17GL",132,359,"1200x900",800,1,600,400,"False",653,241,585,344,344,0
"C17GL",133,580,"1200x900",1000,2,600,400,"True",651,267,312,45,45,0
"C17GL",134,434,"1200x900",1000,0,600,400,"False",89,657,502,-155,155,1
"C17GL",135,66,"1200x900",600,0,600,400,"True",155,673,686,13,13,0
"C17GL",136,60,"1200x900",600,0,600,400,"False",365,213,348,135,135,1
"C17GL",137,217,"1200x900",800,0,600,400,"False",85,573,489,-84,84,1
"C17GL",138,490,"1200x900",1000,0,600,400,"False",114,183,443,260,260,1
"C17GL",139,395,"1200x900",800,2,600,400,"True",743,334,397,63,63,0
"C17GL",140,19,"1200x900",600,0,600,400,"False",286,686,601,-85,85,0
"C17GL",141,561,"1200x900",1000,1,600,400,"False",231,406,633,227,227,0
"C17GL",142,211,"1200x900",600,2,600,400,"False",986,407,291,-116,116,0
"C17GL",143,513,"1200x900",1000,1,600,400,"False",235,602,306,-296,296,0
"C17GL",144,195,"1200x900",600,2,600,400,"True",942,249,276,27,27,0
"C17GL",145,514,"1200x900",1000,1,600,400,"False",539,690,527,-163,163,0
"C17GL",146,270,"1200x900",800,0,600,400,"False",192,418,549,131,131,1
"C17GL",147,275,"1200x900",800,0,600,400,"True",120,594,552,-42,42,0
"C17GL",148,114,"1200x900",600,1,600,400,"False",183,697,562,-135,135,0
"C17GL",149,96,"1200x900",600,1,600,400,"False",433,458,620,162,162,0
"C17GL",150,488,"1200x900",1000,0,600,400,"True",129,687,640,-47,47,1
"C17GL",151,188,"1200x900",600,2,600,400,"False",900,195,525,330,330,0
"C17GL",152,479,"1200x900",1000,0,600,400,"True",74,705,642,-63,63,1
"C17GL",154,44,"1200x900",600,0,600,400,"True",305,554,492,-62,62,1
"C17GL",155,52,"1200x900",600,0,600,400,"True",171,188,242,54,54,0
"C17GL",156,422,"1200x900",800,2,600,400,"True",712,558,616,58,58,0
"C17GL",157,61,"1200x900",600,0,600,400,"False",272,670,591,-79,79,1
"C17GL",158,25,"1200x900",600,0,600,400,"True",263,403,445,42,42,1
"C17GL",159,105,"1200x900",600,1,600,400,"False",527,440,587,147,147,0
"C17GL",160,1,"1200x900",600,0,600,400,"True",136,502,521,19,19,0
"C17GL",162,294,"1200x900",800,1,600,400,"False",262,287,479,192,192,0
"C17GL",163,70,"1200x900",600,0,600,400,"True",309,703,710,7,7,1
"C17GL",165,648,"1200x900",1000,2,600,400,"False",557,394,486,92,92,0
"C17GL",166,281,"1200x900",800,0,600,400,"True",112,611,562,-49,49,1
"C17GL",167,125,"1200x900",600,1,600,400,"True",750,531,483,-48,48,0
"C17GL",168,179,"1200x900",600,2,600,400,"True",908,602,609,7,7,0
"C17GL",169,620,"1200x900",1000,2,600,400,"False",832,649,276,-373,373,0
"C17GL",170,646,"1200x900",1000,2,600,400,"False",829,227,451,224,224,1
"C17GL",171,23,"1200x900",600,0,600,400,"True",308,463,512,49,49,1
"C17GL",172,478,"1200x900",1000,0,600,400,"False",79,672,593,-79,79,1
"C17GL",174,95,"1200x900",600,1,600,400,"False",749,425,556,131,131,1
"C17GL",175,609,"1200x900",1000,2,600,400,"False",697,627,510,-117,117,0
"C17GL",176,22,"1200x900",600,0,600,400,"True",398,591,571,-20,20,1
"C17GL",178,57,"1200x900",600,0,600,400,"True",354,508,549,41,41,1
"C17GL",179,494,"1200x900",1000,0,600,400,"False",127,692,576,-116,116,1
"C17GL",180,138,"1200x900",600,1,600,400,"False",844,580,686,106,106,1
"C17GL",181,573,"1200x900",1000,1,600,400,"False",486,615,511,-104,104,0
"C17GL",182,538,"1200x900",1000,1,600,400,"False",308,457,688,231,231,1
"C17GL",183,258,"1200x900",800,0,600,400,"False",126,664,549,-115,115,1
"C17GL",184,498,"1200x900",1000,0,600,400,"False",100,260,540,280,280,1
"C17GL",185,168,"1200x900",600,2,600,400,"False",1001,439,331,-108,108,0
"C17GL",186,236,"1200x900",800,0,600,400,"False",162,350,263,-87,87,1
"C17GL",187,142,"1200x900",600,1,600,400,"True",286,474,486,12,12,0
"C17GL",188,643,"1200x900",1000,2,600,400,"True",740,325,381,56,56,0
"C17GL",189,304,"1200x900",800,1,600,400,"True",667,605,562,-43,43,0
"C17GL",190,579,"1200x900",1000,2,600,400,"True",803,394,330,-64,64,0
"C17GL",191,107,"1200x900",600,1,600,400,"False",878,678,291,-387,387,0
"C17GL",192,78,"1200x900",600,1,600,400,"False",885,684,252,-432,432,0
"C17GL",193,165,"1200x900",600,2,600,400,"True",912,554,596,42,42,0
"C17GL",194,156,"1200x900",600,2,600,400,"False",913,197,312,115,115,0
"C17GL",195,346,"1200x900",800,1,600,400,"False",269,635,412,-223,223,0
"C17GL",196,317,"1200x900",800,1,600,400,"True",185,564,581,17,17,0
"C17GL",197,277,"1200x900",800,0,600,400,"False",140,310,420,110,110,1
"C17GL",198,551,"1200x900",1000,1,600,400,"True",146,445,515,70,70,1
"C17GL",199,626,"1200x900",1000,2,600,400,"True",329,449,434,-15,15,0
"C17GL",201,5,"1200x900",600,0,600,400,"True",228,587,533,-54,54,0
"C17GL",202,49,"1200x900",600,0,600,400,"True",109,380,386,6,6,0
"C17GL",204,7,"1200x900",600,0,600,400,"True",431,654,610,-44,44,1
"C17GL",205,264,"1200x900",800,0,600,400,"True",198,660,638,-22,22,1
"C17GL",206,460,"1200x900",1000,0,600,400,"False",155,189,311,122,122,1
"C17GL",207,632,"1200x900",1000,2,600,400,"False",984,227,439,212,212,0
"C17GL",208,370,"1200x900",800,2,600,400,"False",874,336,438,102,102,0
"C17GL",209,159,"1200x900",600,2,600,400,"True",992,309,294,-15,15,0
"C17GL",210,466,"1200x900",1000,0,600,400,"False",82,205,425,220,220,1
"C17GL",211,347,"1200x900",800,1,600,400,"False",757,295,598,303,303,1
"C17GL",212,201,"1200x900",600,2,600,400,"False",1005,462,663,201,201,0
"C17GL",213,311,"1200x900",800,1,600,400,"False",710,261,431,170,170,0
"C17GL",214,358,"1200x900",800,1,600,400,"True",263,635,584,-51,51,0
"C17GL",215,245,"1200x900",800,0,600,400,"False",296,235,391,156,156,1
"C17GL",216,36,"1200x900",600,0,600,400,"False",128,346,442,96,96,1
"C17GL",217,265,"1200x900",800,0,600,400,"False",229,353,452,99,99,1
"C17GL",218,191,"1200x900",600,2,600,400,"True",962,396,374,-22,22,0
"C17GL",219,90,"1200x900",600,1,600,400,"False",560,474,313,-161,161,0
"C17GL",220,647,"1200x900",1000,2,600,400,"False",560,637,413,-224,224,0
"C17GL",221,139,"1200x900",600,1,600,400,"False",192,695,601,-94,94,0
"C17GL",222,303,"1200x900",800,1,600,400,"False",241,431,298,-133,133,0
"C17GL",223,121,"1200x900",600,1,600,400,"True",884,364,404,40,40,0
"C17GL",224,212,"1200x900",600,2,600,400,"False",841,206,367,161,161,0
"C17GL",225,412,"1200x900",800,2,600,400,"False",842,280,449,169,169,0
"C17GL",226,103,"1200x900",600,1,600,400,"False",528,320,405,85,85,1
"C17GL",227,140,"1200x900",600,1,600,400,"True",700,523,510,-13,13,0
"C17GL",228,306,"1200x900",800,1,600,400,"True",164,524,568,44,44,0
"C17GL",229,629,"1200x900",1000,2,600,400,"False",681,257,447,190,190,0
"C17GL",230,616,"1200x900",1000,2,600,400,"True",854,357,441,84,84,1
"C17GL",231,67,"1200x900",600,0,600,400,"False",289,308,400,92,92,1
"C17GL",232,237,"1200x900",800,0,600,400,"False",204,481,575,94,94,1
"C17GL",233,150,"1200x900",600,2,600,400,"True",897,345,375,30,30,0
"C17GL",234,424,"1200x900",800,2,600,400,"False",903,545,347,-198,198,0
"C17GL",235,109,"1200x900",600,1,600,400,"False",691,589,672,83,83,0
"C17GL",236,112,"1200x900",600,1,600,400,"False",681,490,364,-126,126,0
"C17GL",237,92,"1200x900",600,1,600,400,"True",624,605,514,-91,91,0
"C17GL",238,349,"1200x900",800,1,600,400,"False",402,665,567,-98,98,0
"C17GL",239,73,"1200x900",600,1,600,400,"True",94,665,681,16,16,0
"C17GL",240,421,"1200x900",800,2,600,400,"False",898,394,248,-146,146,0
"C17GL",241,583,"1200x900",1000,2,600,400,"False",949,284,549,265,265,1
"C17GL",242,77,"1200x900",600,1,600,400,"False",780,525,429,-96,96,0
"C17GL",243,79,"1200x900",600,1,600,400,"False",731,289,670,381,381,0
"C17GL",244,153,"1200x900",600,2,600,400,"True",1037,601,622,21,21,0
"C17GL",245,274,"1200x900",800,0,600,400,"True",146,497,547,50,50,1
"C17GL",246,637,"1200x900",1000,2,600,400,"False",750,460,522,62,62,0
"C17GL",247,313,"1200x900",800,1,600,400,"False",588,421,533,112,112,0
"C17GL",248,530,"1200x900",1000,1,600,400,"True",584,405,390,-15,15,1
"C17GL",249,62,"1200x900",600,0,600,400,"True",345,346,383,37,37,1
"C17GL",250,512,"1200x900",1000,1,600,400,"False",139,261,466,205,205,0
"C17GL",252,315,"1200x900",800,1,600,400,"True",105,211,246,35,35,0
"C17GL",253,244,"1200x900",800,0,600,400,"True",194,203,247,44,44,1
"C17GL",254,261,"1200x900",800,0,600,400,"True",86,713,700,-13,13,1
"C17GL",255,248,"1200x900",800,0,600,400,"False",94,240,392,152,152,1
"C17GL",256,123,"1200x900",600,1,600,400,"True",761,365,362,-3,3,1
"C17GL",257,164,"1200x900",600,2,600,400,"True",1051,268,300,32,32,0
"C17GL",258,470,"1200x900",1000,0,600,400,"False",91,666,520,-146,146,1
"C17GL",259,295,"1200x900",800,1,600,400,"False",471,334,508,174,174,0
"C17GL",260,510,"1200x900",1000,1,600,400,"True",486,338,413,75,75,1
"C17GL",261,251,"1200x900",800,0,600,400,"False",88,352,497,145,145,1
"C17GL",263,332,"1200x900",800,1,600,400,"False",260,699,502,-197,197,0
"C17GL",264,418,"1200x900",800,2,600,400,"False",754,507,258,-249,249,0
"C17GL",265,615,"1200x900",1000,2,600,400,"True",736,634,615,-19,19,0
"C17GL",266,160,"1200x900",600,2,600,400,"False",863,606,677,71,71,0
"C17GL",267,302,"1200x900",800,1,600,400,"False",479,467,595,128,128,1
"C17GL",268,224,"1200x900",800,0,600,400,"False",161,474,545,71,71,1
"C17GL",269,582,"1200x900",1000,2,600,400,"True",554,347,407,60,60,0
"C17GL",270,371,"1200x900",800,2,600,400,"True",730,560,544,-16,16,0
"C17GL",271,163,"1200x900",600,2,600,400,"True",1046,665,599,-66,66,0
"C17GL",272,368,"1200x900",800,2,600,400,"False",778,515,315,-200,200,0
"C17GL",273,443,"1200x900",1000,0,600,400,"False",99,651,547,-104,104,1
"C17GL",275,285,"1200x900",800,0,600,400,"False",237,396,559,163,163,1
"C17GL",276,26,"1200x900",600,0,600,400,"True",70,712,687,-25,25,0
"C17GL",277,403,"1200x900",800,2,600,400,"True",625,704,642,-62,62,0
"C17GL",278,242,"1200x900",800,0,600,400,"True",117,448,417,-31,31,1
"C17GL",279,453,"1200x900",1000,0,600,400,"False",71,393,477,84,84,1
"C17GL",280,455,"1200x900",1000,0,600,400,"False",107,718,615,-103,103,1
"C17GL",281,456,"1200x900",1000,0,600,400,"False",91,257,488,231,231,1
"C17GL",282,543,"1200x900",1000,1,600,400,"False",88,202,499,297,297,0
"C17GL",283,186,"1200x900",600,2,600,400,"False",997,197,386,189,189,0
"C17GL",284,374,"1200x900",800,2,600,400,"False",755,450,628,178,178,0
"C17GL",285,200,"1200x900",600,2,600,400,"True",897,302,254,-48,48,0
"C17GL",286,436,"1200x900",1000,0,600,400,"False",82,617,478,-139,139,1
"C17GL",287,639,"1200x900",1000,2,600,400,"True",504,456,430,-26,26,0
"C17GL",288,75,"1200x900",600,1,600,400,"True",635,558,540,-18,18,0
"C17GL",289,546,"1200x900",1000,1,600,400,"True",305,374,337,-37,37,0
"C17GL",290,246,"1200x900",800,0,600,400,"True",196,418,458,40,40,1
"C17GL",291,279,"1200x900",800,0,600,400,"False",252,202,364,162,162,1
"C17GL",292,161,"1200x900",600,2,600,400,"False",939,553,422,-131,131,0
"C17GL",293,542,"1200x900",1000,1,600,400,"True",304,401,392,-9,9,0
"C17GL",294,426,"1200x900",800,2,600,400,"False",830,263,374,111,111,0
"C17GL",295,578,"1200x900",1000,2,600,400,"False",966,276,511,235,235,0
"C17GL",296,283,"1200x900",800,0,600,400,"True",90,264,214,-50,50,1
"C17GL",297,552,"1200x900",1000,1,600,400,"False",255,412,528,116,116,0
"C17GL",298,363,"1200x900",800,2,600,400,"False",800,218,417,199,199,0
"C17GL",299,122,"1200x900",600,1,600,400,"False",817,709,319,-390,390,0
"C17GL",300,420,"1200x900",800,2,600,400,"True",519,223,290,67,67,0
"C17GL",301,627,"1200x900",1000,2,600,400,"True",760,510,430,-80,80,0
"C17GL",302,392,"1200x900",800,2,600,400,"True",1031,618,538,-80,80,0
"C17GL",303,340,"1200x900",800,1,600,400,"False",226,240,488,248,248,0
"C17GL",304,314,"1200x900",800,1,600,400,"True",277,616,663,47,47,1
"C17GL",305,83,"1200x900",600,1,600,400,"False",763,568,501,-67,67,1
"C17GL",306,81,"1200x900",600,1,600,400,"False",696,225,341,116,116,0
"C17GL",307,465,"1200x900",1000,0,600,400,"False",85,203,463,260,260,1
"C17GL",308,441,"1200x900",1000,0,600,400,"False",85,684,586,-98,98,1
"C17GL",309,525,"1200x900",1000,1,600,400,"True",123,690,725,35,35,0
"C17GL",310,110,"1200x900",600,1,600,400,"True",776,550,596,46,46,1
"C17GL",311,238,"1200x900",800,0,600,400,"False",162,283,407,124,124,1
"C17GL",312,566,"1200x900",1000,1,600,400,"True",378,472,418,-54,54,1
"C17GL",315,228,"1200x900",800,0,600,400,"True",174,687,652,-35,35,1
"C17GL",316,250,"1200x900",800,0,600,400,"False",290,248,411,163,163,1
"C17GL",317,468,"1200x900",1000,0,600,400,"False",121,219,334,115,115,1
"C17GL",318,511,"1200x900",1000,1,600,400,"False",408,390,539,149,149,1
"C17GL",319,597,"1200x900",1000,2,600,400,"False",352,239,360,121,121,0
"C17GL",321,520,"1200x900",1000,1,600,400,"False",564,260,349,89,89,0
"C17GL",322,591,"1200x900",1000,2,600,400,"False",698,336,622,286,286,0
"C17GL",323,318,"1200x900",800,1,600,400,"True",788,534,465,-69,69,0
"C17GL",324,540,"1200x900",1000,1,600,400,"False",389,568,638,70,70,1
"C17GL",325,231,"1200x900",800,0,600,400,"False",251,718,613,-105,105,1
"C17GL",326,373,"1200x900",800,2,600,400,"False",694,326,742,416,416,0
"C17GL",327,221,"1200x900",800,0,600,400,"True",132,520,590,70,70,1
"C17GL",328,504,"1200x900",1000,0,600,400,"False",107,699,630,-69,69,1
"C17GL",330,6,"1200x900",600,0,600,400,"True",217,689,721,32,32,1
"C17GL",331,287,"1200x900",800,0,600,400,"False",120,567,445,-122,122,1
"C17GL",332,387,"1200x900",800,2,600,400,"True",990,444,401,-43,43,0
"C17GL",333,319,"1200x900",800,1,600,400,"True",494,587,589,2,2,1
"C17GL",335,32,"1200x900",600,0,600,400,"True",152,563,605,42,42,1
"C17GL",336,416,"1200x900",800,2,600,400,"False",748,617,430,-187,187,0
"C17GL",337,617,"1200x900",1000,2,600,400,"True",294,180,248,68,68,0
"C17GL",338,297,"1200x900",800,1,600,400,"False",625,244,324,80,80,0
"C17GL",339,132,"1200x900",600,1,600,400,"True",333,185,326,141,141,0
"C17GL",340,53,"1200x900",600,0,600,400,"False",177,189,254,65,65,0
"C17GL",341,531,"1200x900",1000,1,600,400,"True",233,362,334,-28,28,0
"C17GL",342,63,"1200x900",600,0,600,400,"True",311,188,224,36,36,1
"C17GL",343,410,"1200x900",800,2,600,400,"False",916,477,261,-216,216,0
"C17GL",344,341,"1200x900",800,1,600,400,"False",735,632,485,-147,147,1
"C17GL",345,535,"1200x900",1000,1,600,400,"False",372,410,608,198,198,0
"C17GL",346,644,"1200x900",1000,2,600,400,"True",495,486,443,-43,43,0
"C17GL",347,192,"1200x900",600,2,600,400,"False",1064,320,547,227,227,0
"C17GL",348,101,"1200x900",600,1,600,400,"False",541,656,322,-334,334,0
"C17GL",349,589,"1200x900",1000,2,600,400,"False",856,418,522,104,104,0
"C17GL",350,496,"1200x900",1000,0,600,400,"True",70,639,613,-26,26,1
"C17GL",351,489,"1200x900",1000,0,600,400,"True",88,604,591,-13,13,1
"C17GL",352,154,"1200x900",600,2,600,400,"False",941,454,305,-149,149,0
"C17GL",353,638,"1200x900",1000,2,600,400,"False",385,198,360,162,162,0
"C17GL",355,20,"1200x900",600,0,600,400,"True",204,545,568,23,23,1
"C17GL",357,86,"1200x900",600,1,600,400,"False",692,388,524,136,136,1
"C17GL",358,39,"1200x900",600,0,600,400,"True",210,609,593,-16,16,0
"C17GL",359,230,"1200x900",800,0,600,400,"False",99,678,588,-90,90,1
"C17GL",360,534,"1200x900",1000,1,600,400,"False",328,504,365,-139,139,1
"C17GL",361,131,"1200x900",600,1,600,400,"False",531,367,520,153,153,0
"C17GL",362,527,"1200x900",1000,1,600,400,"True",565,601,592,-9,9,0
"C17GL",363,423,"1200x900",800,2,600,400,"False",1051,710,573,-137,137,1
"C17GL",364,27,"1200x900",600,0,600,400,"False",373,309,425,116,116,1
"C17GL",365,259,"1200x900",800,0,600,400,"False",156,180,263,83,83,1
"C17GL",366,625,"1200x900",1000,2,600,400,"True",279,228,240,12,12,0
"C17GL",367,365,"1200x900",800,2,600,400,"False",1055,305,500,195,195,0
"C17GL",368,501,"1200x900",1000,0,600,400,"False",96,323,440,117,117,1
"C17GL",369,3,"1200x900",600,0,600,400,"False",298,443,533,90,90,1
"C17GL",370,292,"1200x900",800,1,600,400,"False",88,565,471,-94,94,0
"C17GL",371,290,"1200x900",800,1,600,400,"True",789,603,565,-38,38,0
"C17GL",372,550,"1200x900",1000,1,600,400,"True",301,459,495,36,36,0
"C17GL",374,444,"1200x900",1000,0,600,400,"False",101,714,544,-170,170,1
"C17GL",376,482,"1200x900",1000,0,600,400,"False",79,686,561,-125,125,1
"C17GL",377,312,"1200x900",800,1,600,400,"True",238,683,641,-42,42,0
"C17GL",378,17,"1200x900",600,0,600,400,"True",402,496,449,-47,47,1
"C17GL",379,323,"1200x900",800,1,600,400,"False",388,348,495,147,147,0
"C17GL",380,329,"1200x900",800,1,600,400,"False",517,239,394,155,155,0
"C17GL",381,204,"1200x900",600,2,600,400,"False",1053,432,244,-188,188,0
"C17GL",382,379,"1200x900",800,2,600,400,"False",994,325,453,128,128,0
"C17GL",383,333,"1200x900",800,1,600,400,"True",521,548,549,1,1,0
"C17GL",384,435,"1200x900",1000,0,600,400,"False",119,200,427,227,227,1
"C17GL",385,562,"1200x900",1000,1,600,400,"True",347,540,567,27,27,0
"C17GL",386,492,"1200x900",1000,0,600,400,"False",76,692,510,-182,182,1
"C17GL",387,411,"1200x900",800,2,600,400,"False",805,361,578,217,217,0
"C17GL",388,606,"1200x900",1000,2,600,400,"False",653,627,491,-136,136,0
"C17GL",389,398,"1200x900",800,2,600,400,"False",944,698,473,-225,225,0
"C17GL",390,481,"1200x900",1000,0,600,400,"False",80,185,441,256,256,1
"C17GL",391,575,"1200x900",1000,1,600,400,"False",272,693,555,-138,138,0
"C17GL",392,113,"1200x900",600,1,600,400,"True",897,657,651,-6,6,0
"C17GL",393,34,"1200x900",600,0,600,400,"True",361,242,260,18,18,1
"C17GL",394,570,"1200x900",1000,1,600,400,"True",315,352,316,-36,36,0
"C17GL",395,438,"1200x900",1000,0,600,400,"False",77,713,540,-173,173,1
"C17GL",396,255,"1200x900",800,0,600,400,"False",93,709,601,-108,108,1
"C17GL",397,598,"1200x900",1000,2,600,400,"True",706,559,558,-1,1,0
"C17GL",398,240,"1200x900",800,0,600,400,"True",330,656,631,-25,25,1
"C17GL",400,397,"1200x900",800,2,600,400,"False",817,692,533,-159,159,0
"C17GL",401,461,"1200x900",1000,0,600,400,"False",95,711,591,-120,120,1
"C17GL",402,59,"1200x900",600,0,600,400,"True",391,692,697,5,5,1
"C17GL",403,521,"1200x900",1000,1,600,400,"False",111,303,445,142,142,1
"C17GL",405,607,"1200x900",1000,2,600,400,"False",900,573,352,-221,221,1
"C17GL",406,641,"1200x900",1000,2,600,400,"False",897,272,570,298,298,0
"C17GL",407,89,"1200x900",600,1,600,400,"True",917,366,337,-29,29,1
"C17GL",408,330,"1200x900",800,1,600,400,"True",759,301,294,-7,7,1
"C17GL",409,569,"1200x900",1000,1,600,400,"False",494,720,509,-211,211,0
"C17GL",410,76,"1200x900",600,1,600,400,"True",647,614,603,-11,11,0
"C17GL",411,517,"1200x900",1000,1,600,400,"False",548,182,248,66,66,0
"C17GL",412,604,"1200x900",1000,2,600,400,"False",459,593,423,-170,170,0
"C17GL",413,464,"1200x900",1000,0,600,400,"False",82,222,396,174,174,1
"C17GL",414,605,"1200x900",1000,2,600,400,"False",493,665,413,-252,252,0
"C17GL",416,223,"1200x900",800,0,600,400,"True",179,191,127,-64,64,1
"C17GL",418,337,"1200x900",800,1,600,400,"True",299,622,534,-88,88,0
"C17GL",419,173,"1200x900",600,2,600,400,"True",948,693,616,-77,77,0
"C17GL",420,529,"1200x900",1000,1,600,400,"True",267,412,364,-48,48,1
"C17GL",421,286,"1200x900",800,0,600,400,"False",105,378,450,72,72,1
"C17GL",422,241,"1200x900",800,0,600,400,"False",129,227,382,155,155,1
"C17GL",423,225,"1200x900",800,0,600,400,"True",178,423,408,-15,15,1
"C17GL",424,30,"1200x900",600,0,600,400,"True",107,353,382,29,29,0
"C17GL",425,555,"1200x900",1000,1,600,400,"False",444,556,676,120,120,0
"C17GL",426,619,"1200x900",1000,2,600,400,"False",803,247,620,373,373,0
"C17GL",427,249,"1200x900",800,0,600,400,"False",126,306,402,96,96,1
"C17GL",428,414,"1200x900",800,2,600,400,"True",831,592,616,24,24,0
"C17GL",429,585,"1200x900",1000,2,600,400,"False",698,688,588,-100,100,1
"C17GL",430,541,"1200x900",1000,1,600,400,"True",339,478,436,-42,42,0
"C17GL",431,612,"1200x900",1000,2,600,400,"False",706,198,410,212,212,0
"C17GL",432,588,"1200x900",1000,2,600,400,"True",585,350,365,15,15,0
"C17GL",433,339,"1200x900",800,1,600,400,"False",273,545,660,115,115,1
"C17GL",434,50,"1200x900",600,0,600,400,"True",75,582,586,4,4,0
"C17GL",435,433,"1200x900",1000,0,600,400,"False",76,222,443,221,221,1
"C17GL",436,601,"1200x900",1000,2,600,400,"False",735,697,482,-215,215,0
"C17GL",437,473,"1200x900",1000,0,600,400,"False",75,323,538,215,215,1
"C17GL",438,640,"1200x900",1000,2,600,400,"False",361,334,482,148,148,0
"C17GL",439,451,"1200x900",1000,0,600,400,"False",110,702,543,-159,159,1
"C17GL",440,155,"1200x900",600,2,600,400,"False",940,269,430,161,161,0
"C17GL",441,352,"1200x900",800,1,600,400,"False",235,717,525,-192,192,0
"C17GL",442,519,"1200x900",1000,1,600,400,"True",319,565,619,54,54,1
"C17GL",443,446,"1200x900",1000,0,600,400,"False",72,298,577,279,279,1
"C17GL",445,388,"1200x900",800,2,600,400,"False",930,320,584,264,264,0
"C17GL",446,190,"1200x900",600,2,600,400,"False",977,238,350,112,112,0
"C17GL",447,377,"1200x900",800,2,600,400,"True",683,388,432,44,44,0
"C17GL",448,74,"1200x900",600,1,600,400,"False",115,358,570,212,212,0
"C17GL",449,94,"1200x900",600,1,600,400,"True",729,482,521,39,39,0
"C17GL",450,378,"1200x900",800,2,600,400,"False",1018,708,520,-188,188,0
"C17GL",451,120,"1200x900",600,1,600,400,"False",690,655,735,80,80,0
"C17GL",452,16,"1200x900",600,0,600,400,"False",297,514,642,128,128,1
"C17GL",453,334,"1200x900",800,1,600,400,"True",481,665,727,62,62,0
"C17GL",454,539,"1200x900",1000,1,600,400,"True",510,383,324,-59,59,0
"C17GL",456,338,"1200x900",800,1,600,400,"False",813,253,552,299,299,1
"C17GL",457,558,"1200x900",1000,1,600,400,"False",72,464,558,94,94,1
"C17GL",458,471,"1200x900",1000,0,600,400,"False",122,200,449,249,249,1
"C17GL",459,68,"1200x900",600,0,600,400,"False",165,367,568,201,201,0
"C17GL",460,293,"1200x900",800,1,600,400,"True",561,396,455,59,59,0
"C17GL",461,602,"1200x900",1000,2,600,400,"False",865,452,361,-91,91,0
"C17GL",462,48,"1200x900",600,0,600,400,"False",323,645,554,-91,91,1
"C17GL",463,586,"1200x900",1000,2,600,400,"False",802,262,572,310,310,0
"C17GL",464,425,"1200x900",800,2,600,400,"False",621,438,324,-114,114,0
"C17GL",465,256,"1200x900",800,0,600,400,"True",192,656,721,65,65,1
"C17GL",466,362,"1200x900",800,2,600,400,"False",819,338,597,259,259,0
"C17GL",467,328,"1200x900",800,1,600,400,"False",104,649,514,-135,135,0
"C17GL",468,166,"1200x900",600,2,600,400,"False",896,274,560,286,286,0
"C17GL",469,390,"1200x900",800,2,600,400,"False",982,674,536,-138,138,1
"C17GL",471,11,"1200x900",600,0,600,400,"True",372,670,638,-32,32,1
"C17GL",472,476,"1200x900",1000,0,600,400,"False",76,359,601,242,242,1
"C17GL",473,18,"1200x900",600,0,600,400,"False",400,318,395,77,77,1
"C17GL",474,307,"1200x900",800,1,600,400,"True",716,247,297,50,50,0
"C17GL",475,497,"1200x900",1000,0,600,400,"False",106,696,417,-279,279,1
"C17GL",476,151,"1200x900",600,2,600,400,"False",828,680,447,-233,233,0
"C17GL",477,447,"1200x900",1000,0,600,400,"False",71,339,566,227,227,1
"C17GL",478,342,"1200x900",800,1,600,400,"False",677,204,518,314,314,0
"C17GL",479,98,"1200x900",600,1,600,400,"True",625,530,526,-4,4,0
"C17GL",480,232,"1200x900",800,0,600,400,"True",84,511,525,14,14,1
"C17GL",481,229,"1200x900",800,0,600,400,"True",117,697,652,-45,45,1
"C17GL",482,324,"1200x900",800,1,600,400,"False",719,712,444,-268,268,1
"C17GL",483,243,"1200x900",800,0,600,400,"False",114,332,424,92,92,1
"C17GL",484,169,"1200x900",600,2,600,400,"False",924,290,451,161,161,0
"C17GL",485,357,"1200x900",800,1,600,400,"True",109,594,512,-82,82,0
"C17GL",486,331,"1200x900",800,1,600,400,"True",240,620,534,-86,86,0
"C17GL",487,509,"1200x900",1000,1,600,400,"False",509,434,526,92,92,0
"C17GL",489,576,"1200x900",1000,1,600,400,"True",376,713,666,-47,47,0
"C17GL",490,369,"1200x900",800,2,600,400,"False",903,594,668,74,74,0
"C17GL",491,326,"1200x900",800,1,600,400,"False",103,482,614,132,132,0
"C17GL",492,376,"1200x900",800,2,600,400,"False",788,275,384,109,109,0
"C17GL",493,143,"1200x900",600,1,600,400,"False",479,284,370,86,86,1
"C17GL",494,214,"1200x900",600,2,600,400,"True",1046,305,252,-53,53,0
"C17GL",495,396,"1200x900",800,2,600,400,"False",678,663,521,-142,142,0
"C17GL",496,182,"1200x900",600,2,600,400,"False",933,389,301,-88,88,0
"C17GL",497,394,"1200x900",800,2,600,400,"False",847,292,615,323,323,0
"C17GL",498,316,"1200x900",800,1,600,400,"False",362,319,535,216,216,0
"C17GL",499,587,"1200x900",1000,2,600,400,"False",741,686,306,-380,380,0
"C17GL",500,631,"1200x900",1000,2,600,400,"True",699,479,527,48,48,0
"C17GL",501,621,"1200x900",1000,2,600,400,"True",540,478,535,57,57,0
"C17GL",502,442,"1200x900",1000,0,600,400,"False",87,183,405,222,222,1
"C17GL",505,111,"1200x900",600,1,600,400,"True",922,552,580,28,28,1
"C17GL",506,574,"1200x900",1000,1,600,400,"False",614,194,323,129,129,0
"C17GL",507,254,"1200x900",800,0,600,400,"True",136,583,568,-15,15,1
"C17GL",508,636,"1200x900",1000,2,600,400,"False",575,583,436,-147,147,0
"C17GL",509,289,"1200x900",800,1,600,400,"True",421,703,758,55,55,1
"C17GL",510,309,"1200x900",800,1,600,400,"False",186,225,566,341,341,0
"C17GL",512,386,"1200x900",800,2,600,400,"True",774,301,364,63,63,0
"C17GL",513,233,"1200x900",800,0,600,400,"True",164,700,691,-9,9,1
"C17GL",514,9,"1200x900",600,0,600,400,"False",509,654,534,-120,120,1
"C17GL",515,560,"1200x900",1000,1,600,400,"False",516,693,418,-275,275,0
"C17GL",516,41,"1200x900",600,0,600,400,"True",370,452,465,13,13,1
"C17GL",517,500,"1200x900",1000,0,600,400,"True",105,700,684,-16,16,1
"C17GL",518,88,"1200x900",600,1,600,400,"True",186,554,582,28,28,0
"C17GL",519,642,"1200x900",1000,2,600,400,"False",776,316,552,236,236,0
"C17GL",520,252,"1200x900",800,0,600,400,"True",224,673,746,73,73,1
"C17GL",521,622,"1200x900",1000,2,600,400,"False",307,683,236,-447,447,0
"C17GL",522,571,"1200x900",1000,1,600,400,"True",239,522,489,-33,33,1
"C17GL",523,581,"1200x900",1000,2,600,400,"False",310,357,473,116,116,0
"C17GL",524,419,"1200x900",800,2,600,400,"True",769,351,392,41,41,0
"C17GL",525,475,"1200x900",1000,0,600,400,"True",101,715,724,9,9,1
"C17GL",526,280,"1200x900",800,0,600,400,"True",104,302,313,11,11,1
"C17GL",528,271,"1200x900",800,0,600,400,"False",74,360,232,-128,128,1
"C17GL",529,393,"1200x900",800,2,600,400,"False",657,620,452,-168,168,0
"C17GL",530,298,"1200x900",800,1,600,400,"True",311,457,532,75,75,0
"C17GL",531,440,"1200x900",1000,0,600,400,"False",71,237,357,120,120,1
"C17GL",532,134,"1200x900",600,1,600,400,"False",300,188,366,178,178,0
"C17GL",533,596,"1200x900",1000,2,600,400,"False",706,513,291,-222,222,0
"C17GL",534,180,"1200x900",600,2,600,400,"False",929,270,446,176,176,0
"C17GL",535,33,"1200x900",600,0,600,400,"True",198,533,506,-27,27,1
"C17GL",536,462,"1200x900",1000,0,600,400,"True",102,672,612,-60,60,1
"C17GL",538,487,"1200x900",1000,0,600,400,"True",78,670,628,-42,42,1
"C17GL",539,117,"1200x900",600,1,600,400,"False",711,456,308,-148,148,0
"C17GL",540,614,"1200x900",1000,2,600,400,"True",823,563,511,-52,52,0
"C17GL",541,202,"1200x900",600,2,600,400,"False",966,460,593,133,133,0
"C17GL",542,184,"1200x900",600,2,600,400,"False",1067,441,559,118,118,0
"C17GL",543,43,"1200x900",600,0,600,400,"False",277,446,612,166,166,1
"C17GL",544,360,"1200x900",800,1,600,400,"False",203,608,445,-163,163,0
"C17GL",545,247,"1200x900",800,0,600,400,"False",160,424,504,80,80,1
"C17GL",546,263,"1200x900",800,0,600,400,"False",82,396,483,87,87,1
"C17GL",547,545,"1200x900",1000,1,600,400,"True",358,562,514,-48,48,0
"C17GL",549,335,"1200x900",800,1,600,400,"False",124,360,521,161,161,0
"C17GL",550,327,"1200x900",800,1,600,400,"False",152,339,462,123,123,0
"C17GL",551,477,"1200x900",1000,0,600,400,"True",88,640,594,-46,46,1
"C17GL",553,273,"1200x900",800,0,600,400,"False",180,309,449,140,140,1
"C17GL",555,102,"1200x900",600,1,600,400,"False",861,603,538,-65,65,0
"C17GL",556,310,"1200x900",800,1,600,400,"True",559,592,584,-8,8,0
"C17GL",557,127,"1200x900",600,1,600,400,"False",309,691,563,-128,128,0
"C17GL",558,572,"1200x900",1000,1,600,400,"False",302,260,479,219,219,0
"C17GL",559,268,"1200x900",800,0,600,400,"True",148,400,337,-63,63,1
"C17GL",560,556,"1200x900",1000,1,600,400,"False",415,420,326,-94,94,0
"C17GL",561,42,"1200x900",600,0,600,400,"True",233,479,424,-55,55,0
"C17GL",562,427,"1200x900",800,2,600,400,"True",812,380,371,-9,9,0
"C17GL",563,532,"1200x900",1000,1,600,400,"True",215,207,240,33,33,0
"C17GL",564,593,"1200x900",1000,2,600,400,"False",246,719,625,-94,94,0
"C17GL",565,493,"1200x900",1000,0,600,400,"False",80,582,508,-74,74,1
"C17GL",566,404,"1200x900",800,2,600,400,"False",842,396,649,253,253,0
"C17GL",567,345,"1200x900",800,1,600,400,"True",841,566,569,3,3,1
"C17GL",568,80,"1200x900",600,1,600,400,"False",616,423,535,112,112,1
"C17GL",569,402,"1200x900",800,2,600,400,"False",878,234,385,151,151,0
"C17GL",570,91,"1200x900",600,1,600,400,"True",417,630,626,-4,4,1
"C17GL",571,536,"1200x900",1000,1,600,400,"True",580,213,278,65,65,0
"C17GL",572,4,"1200x900",600,0,600,400,"False",602,200,273,73,73,1
"C17GL",573,563,"1200x900",1000,1,600,400,"True",201,696,724,28,28,0
"C17GL",574,577,"1200x900",1000,2,600,400,"True",455,420,402,-18,18,0
"C17GL",575,13,"1200x900",600,0,600,400,"False",296,211,340,129,129,1
"C17GL",577,351,"1200x900",800,1,600,400,"False",122,581,474,-107,107,0
"C17GL",578,375,"1200x900",800,2,600,400,"True",716,384,469,85,85,0
"C17GL",579,257,"1200x900",800,0,600,400,"False",97,219,423,204,204,1
"C17GL",580,430,"1200x900",800,2,600,400,"True",922,254,325,71,71,0
"C17GL",581,526,"1200x900",1000,1,600,400,"True",497,710,746,36,36,0
"C17GL",582,454,"1200x900",1000,0,600,400,"False",78,687,575,-112,112,1
"C17GL",583,417,"1200x900",800,2,600,400,"False",750,280,514,234,234,0
"C17GL",584,100,"1200x900",600,1,600,400,"True",453,511,471,-40,40,0
"C17GL",585,457,"1200x900",1000,0,600,400,"False",97,630,558,-72,72,1
"C17GL",586,174,"1200x900",600,2,600,400,"False",998,457,387,-70,70,0
"C17GL",587,463,"1200x900",1000,0,600,400,"False",115,693,509,-184,184,1
"C17GL",588,10,"1200x900",600,0,600,400,"True",400,499,498,-1,1,1
"C17GL",589,405,"1200x900",800,2,600,400,"True",790,307,333,26,26,0
"C17GL",590,65,"1200x900",600,0,600,400,"False",442,645,480,-165,165,1
"C17GL",591,548,"1200x900",1000,1,600,400,"False",103,278,603,325,325,0
"C17GL",592,380,"1200x900",800,2,600,400,"False",942,228,389,161,161,0
"C17GL",593,469,"1200x900",1000,0,600,400,"False",73,227,410,183,183,1
"C17GL",594,172,"1200x900",600,2,600,400,"False",912,444,314,-130,130,0
"C17GL",595,549,"1200x900",1000,1,600,400,"False",657,366,531,165,165,0
"C17GL",596,399,"1200x900",800,2,600,400,"False",603,602,462,-140,140,0
"C17GL",597,610,"1200x900",1000,2,600,400,"False",702,293,547,254,254,0
"C17GL",598,428,"1200x900",800,2,600,400,"False",732,665,492,-173,173,0
"C17GL",599,272,"1200x900",800,0,600,400,"False",200,181,394,213,213,1
"C17GL",600,55,"1200x900",600,0,600,400,"True",211,305,275,-30,30,1
"C17GL",601,495,"1200x900",1000,0,600,400,"False",93,692,439,-253,253,1
"C17GL",602,401,"1200x900",800,2,600,400,"False",821,260,411,151,151,0
"C17GL",603,452,"1200x900",1000,0,600,400,"False",97,273,503,230,230,1
"C17GL",604,554,"1200x900",1000,1,600,400,"True",79,309,329,20,20,1
"C17GL",605,171,"1200x900",600,2,600,400,"False",909,200,310,110,110,0
"C17GL",606,508,"1200x900",1000,1,600,400,"True",596,485,444,-41,41,0
"C17GL",607,14,"1200x900",600,0,600,400,"False",399,224,357,133,133,1
"C17GL",608,325,"1200x900",800,1,600,400,"True",105,394,492,98,98,0
"C17GL",609,400,"1200x900",800,2,600,400,"True",733,297,309,12,12,0
"C17GL",610,299,"1200x900",800,1,600,400,"False",779,274,470,196,196,0
"C17GL",611,437,"1200x900",1000,0,600,400,"True",74,667,632,-35,35,1
"C17GL",612,84,"1200x900",600,1,600,400,"True",144,184,230,46,46,0
"C17GL",613,439,"1200x900",1000,0,600,400,"False",110,229,310,81,81,1
"C17GL",614,284,"1200x900",800,0,600,400,"True",135,293,335,42,42,1
"C17GL",615,24,"1200x900",600,0,600,400,"False",430,538,466,-72,72,1
"C17GL",617,594,"1200x900",1000,2,600,400,"False",537,637,497,-140,140,0
"C17GL",618,301,"1200x900",800,1,600,400,"True",162,574,588,14,14,0
"C17GL",619,523,"1200x900",1000,1,600,400,"False",339,318,537,219,219,0
"C17GL",620,51,"1200x900",600,0,600,400,"True",272,181,161,-20,20,1
"C17GL",621,266,"1200x900",800,0,600,400,"True",126,303,365,62,62,1
"C17GL",622,12,"1200x900",600,0,600,400,"True",365,336,327,-9,9,1
"C17GL",623,415,"1200x900",800,2,600,400,"False",823,684,383,-301,301,0
"C17GL",624,321,"1200x900",800,1,600,400,"False",601,190,425,235,235,0
"C17GL",625,645,"1200x900",1000,2,600,400,"False",619,396,336,-60,60,0
"C17GL",627,119,"1200x900",600,1,600,400,"False",168,563,323,-240,240,0
"C17GL",628,158,"1200x900",600,2,600,400,"True",939,300,366,66,66,0
"C17GL",629,491,"1200x900",1000,0,600,400,"False",108,198,382,184,184,1
"C17GL",630,45,"1200x900",600,0,600,400,"True",487,678,669,-9,9,1
"C17GL",631,108,"1200x900",600,1,600,400,"True",830,239,306,67,67,0
"C17GL",632,467,"1200x900",1000,0,600,400,"False",74,712,577,-135,135,1
"C17GL",633,93,"1200x900",600,1,600,400,"True",139,540,476,-64,64,0
"C17GL",634,480,"1200x900",1000,0,600,400,"False",100,231,441,210,210,1
"C17GL",635,524,"1200x900",1000,1,600,400,"True",534,470,520,50,50,0
"C17GL",636,366,"1200x900",800,2,600,400,"False",931,464,363,-101,101,0
"C17GL",637,99,"1200x900",600,1,600,400,"False",811,407,494,87,87,0
"C17GL",638,104,"1200x900",600,1,600,400,"True",448,584,521,-63,63,0
"C17GL",639,506,"1200x900",1000,1,600,400,"False",559,567,383,-184,184,1
"C17GL",641,336,"1200x900",800,1,600,400,"True",251,587,514,-73,73,0
"C17GL",643,148,"1200x900",600,2,600,400,"False",907,330,266,-64,64,0
"C17GL",644,145,"1200x900",600,2,600,400,"False",1004,630,428,-202,202,0
"C17GL",645,219,"1200x900",800,0,600,400,"True",202,502,561,59,59,1
"C17GL",646,564,"1200x900",1000,1,600,400,"True",215,264,306,42,42,0
"C17GL",647,537,"1200x900",1000,1,600,400,"False",621,412,492,80,80,1
"C17GL",648,595,"1200x900",1000,2,600,400,"False",687,640,357,-283,283,0
"C18EO",1,277,"1200x900",800,0,600,400,"True",140,310,317,7,7,1
"C18EO",2,206,"1200x900",600,2,600,400,"False",975,223,80,-143,143,0
"C18EO",3,514,"1200x900",1000,1,600,400,"False",539,690,603,-87,87,0
"C18EO",4,506,"1200x900",1000,1,600,400,"False",559,567,354,-213,213,1
"C18EO",5,97,"1200x900",600,1,600,400,"True",760,643,669,26,26,1
"C18EO",6,565,"1200x900",1000,1,600,400,"False",451,562,368,-194,194,0
"C18EO",7,644,"1200x900",1000,2,600,400,"False",495,486,295,-191,191,0
"C18EO",8,625,"1200x900",1000,2,600,400,"False",279,228,621,393,393,0
"C18EO",9,77,"1200x900",600,1,600,400,"True",780,525,465,-60,60,0
"C18EO",10,535,"1200x900",1000,1,600,400,"False",372,410,324,-86,86,0
"C18EO",11,214,"1200x900",600,2,600,400,"False",1046,305,144,-161,161,0
"C18EO",12,509,"1200x900",1000,1,600,400,"False",509,434,315,-119,119,0
"C18EO",13,108,"1200x900",600,1,600,400,"False",830,239,340,101,101,0
"C18EO",14,317,"1200x900",800,1,600,400,"False",185,564,420,-144,144,0
"C18EO",15,414,"1200x900",800,2,600,400,"False",831,592,719,127,127,0
"C18EO",16,289,"1200x900",800,1,600,400,"True",421,703,746,43,43,1
"C18EO",17,460,"1200x900",1000,0,600,400,"False",155,189,329,140,140,1
"C18EO",18,311,"1200x900",800,1,600,400,"False",710,261,684,423,423,0
"C18EO",19,359,"1200x900",800,1,600,400,"False",653,241,447,206,206,0
"C18EO",20,605,"1200x900",1000,2,600,400,"False",493,665,471,-194,194,0
"C18EO",21,37,"1200x900",600,0,600,400,"True",258,403,451,48,48,1
"C18EO",22,282,"1200x900",800,0,600,400,"True",109,246,283,37,37,1
"C18EO",23,525,"1200x900",1000,1,600,400,"False",123,690,463,-227,227,0
"C18EO",24,394,"1200x900",800,2,600,400,"True",847,292,326,34,34,0
"C18EO",25,254,"1200x900",800,0,600,400,"False",136,583,705,122,122,1
"C18EO",26,434,"1200x900",1000,0,600,400,"True",89,657,628,-29,29,1
"C18EO",27,45,"1200x900",600,0,600,400,"False",487,678,588,-90,90,1
"C18EO",28,74,"1200x900",600,1,600,400,"False",115,358,50,-308,308,0
"C18EO",29,113,"1200x900",600,1,600,400,"True",897,657,598,-59,59,0
"C18EO",30,81,"1200x900",600,1,600,400,"False",696,225,143,-82,82,0
"C18EO",31,130,"1200x900",600,1,600,400,"True",741,428,382,-46,46,0
"C18EO",32,335,"1200x900",800,1,600,400,"False",124,360,594,234,234,0
"C18EO",33,562,"1200x900",1000,1,600,400,"False",347,540,297,-243,243,0
"C18EO",34,112,"1200x900",600,1,600,400,"False",681,490,415,-75,75,0
"C18EO",35,376,"1200x900",800,2,600,400,"False",788,275,158,-117,117,0
"C18EO",36,551,"1200x900",1000,1,600,400,"False",146,445,746,301,301,1
"C18EO",37,431,"1200x900",800,2,600,400,"False",694,382,268,-114,114,0
"C18EO",38,479,"1200x900",1000,0,600,400,"False",74,705,613,-92,92,1
"C18EO",39,220,"1200x900",800,0,600,400,"True",108,699,665,-34,34,1
"C18EO",40,542,"1200x900",1000,1,600,400,"False",304,401,228,-173,173,0
"C18EO",41,301,"1200x900",800,1,600,400,"True",162,574,603,29,29,0
"C18EO",42,610,"1200x900",1000,2,600,400,"False",702,293,213,-80,80,0
"C18EO",43,181,"1200x900",600,2,600,400,"True",1018,223,184,-39,39,0
"C18EO",44,261,"1200x900",800,0,600,400,"True",86,713,726,13,13,1
"C18EO",45,528,"1200x900",1000,1,600,400,"False",839,227,583,356,356,1
"C18EO",46,85,"1200x900",600,1,600,400,"False",434,347,577,230,230,0
"C18EO",47,560,"1200x900",1000,1,600,400,"False",516,693,536,-157,157,0
"C18EO",48,612,"1200x900",1000,2,600,400,"True",706,198,178,-20,20,0
"C18EO",49,201,"1200x900",600,2,600,400,"True",1005,462,433,-29,29,0
"C18EO",50,504,"1200x900",1000,0,600,400,"True",107,699,661,-38,38,1
"C18EO",51,33,"1200x900",600,0,600,400,"True",198,533,511,-22,22,1
"C18EO",52,58,"1200x900",600,0,600,400,"True",353,655,616,-39,39,1
"C18EO",53,204,"1200x900",600,2,600,400,"False",1053,432,185,-247,247,0
"C18EO",54,505,"1200x900",1000,1,600,400,"True",191,484,462,-22,22,1
"C18EO",55,105,"1200x900",600,1,600,400,"False",527,440,594,154,154,0
"C18EO",56,487,"1200x900",1000,0,600,400,"False",78,670,747,77,77,1
"C18EO",57,42,"1200x900",600,0,600,400,"False",233,479,403,-76,76,0
"C18EO",58,30,"1200x900",600,0,600,400,"False",107,353,433,80,80,0
"C18EO",59,51,"1200x900",600,0,600,400,"True",272,181,153,-28,28,1
"C18EO",60,444,"1200x900",1000,0,600,400,"True",101,714,753,39,39,1
"C18EO",61,333,"1200x900",800,1,600,400,"True",521,548,548,0,0,0
"C18EO",62,386,"1200x900",800,2,600,400,"False",774,301,225,-76,76,0
"C18EO",63,20,"1200x900",600,0,600,400,"False",204,545,396,-149,149,1
"C18EO",64,532,"1200x900",1000,1,600,400,"False",215,207,287,80,80,0
"C18EO",65,591,"1200x900",1000,2,600,400,"False",698,336,421,85,85,0
"C18EO",66,164,"1200x900",600,2,600,400,"True",1051,268,299,31,31,0
"C18EO",67,513,"1200x900",1000,1,600,400,"False",235,602,231,-371,371,0
"C18EO",68,606,"1200x900",1000,2,600,400,"False",653,627,425,-202,202,0
"C18EO",69,390,"1200x900",800,2,600,400,"False",982,674,452,-222,222,1
"C18EO",70,383,"1200x900",800,2,600,400,"False",855,407,470,63,63,0
"C18EO",71,304,"1200x900",800,1,600,400,"False",667,605,339,-266,266,0
"C18EO",72,131,"1200x900",600,1,600,400,"False",531,367,653,286,286,0
"C18EO",73,638,"1200x900",1000,2,600,400,"True",385,198,252,54,54,0
"C18EO",74,478,"1200x900",1000,0,600,400,"False",79,672,769,97,97,1
"C18EO",75,243,"1200x900",800,0,600,400,"True",114,332,355,23,23,1
"C18EO",76,364,"1200x900",800,2,600,400,"True",1018,204,209,5,5,0
"C18EO",77,32,"1200x900",600,0,600,400,"False",152,563,683,120,120,1
"C18EO",78,264,"1200x900",800,0,600,400,"False",198,660,532,-128,128,1
"C18EO",79,245,"1200x900",800,0,600,400,"True",296,235,284,49,49,1
"C18EO",80,177,"1200x900",600,2,600,400,"True",912,236,316,80,80,0
"C18EO",81,137,"1200x900",600,1,600,400,"True",789,577,544,-33,33,0
"C18EO",82,554,"1200x900",1000,1,600,400,"False",79,309,168,-141,141,1
"C18EO",83,481,"1200x900",1000,0,600,400,"True",80,185,143,-42,42,1
"C18EO",84,449,"1200x900",1000,0,600,400,"False",105,683,783,100,100,1
"C18EO",85,418,"1200x900",800,2,600,400,"False",754,507,599,92,92,0
"C18EO",86,531,"1200x900",1000,1,600,400,"False",233,362,525,163,163,0
"C18EO",87,622,"1200x900",1000,2,600,400,"False",307,683,470,-213,213,0
"C18EO",88,448,"1200x900",1000,0,600,400,"False",107,641,471,-170,170,1
"C18EO",89,188,"1200x900",600,2,600,400,"True",900,195,270,75,75,0
"C18EO",90,203,"1200x900",600,2,600,400,"False",938,603,488,-115,115,0
"C18EO",91,132,"1200x900",600,1,600,400,"True",333,185,236,51,51,0
"C18EO",92,421,"1200x900",800,2,600,400,"False",898,394,238,-156,156,0
"C18EO",93,229,"1200x900",800,0,600,400,"False",117,697,599,-98,98,1
"C18EO",94,633,"1200x900",1000,2,600,400,"False",564,253,474,221,221,0
"C18EO",95,296,"1200x900",800,1,600,400,"True",89,279,344,65,65,0
"C18EO",96,628,"1200x900",1000,2,600,400,"False",768,410,524,114,114,0
"C18EO",97,144,"1200x900",600,1,600,400,"False",718,371,453,82,82,0
"C18EO",98,391,"1200x900",800,2,600,400,"True",895,521,473,-48,48,0
"C18EO",99,192,"1200x900",600,2,600,400,"False",1064,320,645,325,325,0
"C18EO",100,47,"1200x900",600,0,600,400,"False",303,499,434,-65,65,1
"C18EO",101,145,"1200x900",600,2,600,400,"False",1004,630,711,81,81,0
"C18EO",102,299,"1200x900",800,1,600,400,"False",779,274,675,401,401,0
"C18EO",103,558,"1200x900",1000,1,600,400,"False",72,464,770,306,306,1
"C18EO",104,68,"1200x900",600,0,600,400,"True",165,367,386,19,19,0
"C18EO",105,218,"1200x900",800,0,600,400,"True",106,397,412,15,15,1
"C18EO",106,39,"1200x900",600,0,600,400,"True",210,609,583,-26,26,0
"C18EO",107,248,"1200x900",800,0,600,400,"False",94,240,391,151,151,1
"C18EO",108,627,"1200x900",1000,2,600,400,"True",760,510,543,33,33,0
"C18EO",109,303,"1200x900",800,1,600,400,"True",241,431,410,-21,21,0
"C18EO",110,484,"1200x900",1000,0,600,400,"True",100,223,262,39,39,1
"C18EO",111,515,"1200x900",1000,1,600,400,"True",307,217,192,-25,25,0
"C18EO",112,526,"1200x900",1000,1,600,400,"False",497,710,625,-85,85,0
"C18EO",113,235,"1200x900",800,0,600,400,"True",146,646,645,-1,1,1
"C18EO",114,416,"1200x900",800,2,600,400,"False",748,617,480,-137,137,0
"C18EO",115,297,"1200x900",800,1,600,400,"False",625,244,461,217,217,0
"C18EO",116,566,"1200x900",1000,1,600,400,"True",378,472,475,3,3,1
"C18EO",117,552,"1200x900",1000,1,600,400,"False",255,412,616,204,204,0
"C18EO",118,491,"1200x900",1000,0,600,400,"False",108,198,325,127,127,1
"C18EO",119,262,"1200x900",800,0,600,400,"True",196,481,533,52,52,1
"C18EO",120,647,"1200x900",1000,2,600,400,"False",560,637,487,-150,150,0
"C18EO",121,348,"1200x900",800,1,600,400,"True",764,294,307,13,13,0
"C18EO",122,290,"1200x900",800,1,600,400,"False",789,603,456,-147,147,0
"C18EO",123,150,"1200x900",600,2,600,400,"True",897,345,297,-48,48,0
"C18EO",124,240,"1200x900",800,0,600,400,"True",330,656,712,56,56,1
"C18EO",125,101,"1200x900",600,1,600,400,"False",541,656,714,58,58,0
"C18EO",126,596,"1200x900",1000,2,600,400,"False",706,513,708,195,195,0
"C18EO",127,10,"1200x900",600,0,600,400,"True",400,499,473,-26,26,1
"C18EO",128,332,"1200x900",800,1,600,400,"True",260,699,716,17,17,0
"C18EO",129,340,"1200x900",800,1,600,400,"False",226,240,663,423,423,0
"C18EO",130,453,"1200x900",1000,0,600,400,"False",71,393,251,-142,142,1
"C18EO",131,471,"1200x900",1000,0,600,400,"False",122,200,395,195,195,1
"C18EO",132,459,"1200x900",1000,0,600,400,"False",70,645,549,-96,96,1
"C18EO",133,403,"1200x900",800,2,600,400,"False",625,704,560,-144,144,0
"C18EO",134,48,"1200x900",600,0,600,400,"False",323,645,559,-86,86,1
"C18EO",135,221,"1200x900",800,0,600,400,"True",132,520,497,-23,23,1
"C18EO",136,274,"1200x900",800,0,600,400,"True",146,497,545,48,48,1
"C18EO",137,576,"1200x900",1000,1,600,400,"True",376,713,744,31,31,0
"C18EO",138,49,"1200x900",600,0,600,400,"True",109,380,435,55,55,0
"C18EO",139,110,"1200x900",600,1,600,400,"False",776,550,769,219,219,1
"C18EO",140,288,"1200x900",800,0,600,400,"True",180,547,554,7,7,1
"C18EO",141,73,"1200x900",600,1,600,400,"False",94,665,761,96,96,0
"C18EO",142,29,"1200x900",600,0,600,400,"True",385,533,552,19,19,1
"C18EO",143,117,"1200x900",600,1,600,400,"False",711,456,396,-60,60,0
"C18EO",144,549,"1200x900",1000,1,600,400,"False",657,366,457,91,91,0
"C18EO",145,86,"1200x900",600,1,600,400,"True",692,388,367,-21,21,1
"C18EO",146,312,"1200x900",800,1,600,400,"True",238,683,728,45,45,0
"C18EO",147,595,"1200x900",1000,2,600,400,"False",687,640,540,-100,100,0
"C18EO",148,196,"1200x900",600,2,600,400,"False",1030,397,193,-204,204,0
"C18EO",149,432,"1200x900",800,2,600,400,"True",792,380,338,-42,42,0
"C18EO",150,17,"1200x900",600,0,600,400,"True",402,496,457,-39,39,1
"C18EO",151,401,"1200x900",800,2,600,400,"False",821,260,190,-70,70,0
"C18EO",152,329,"1200x900",800,1,600,400,"False",517,239,328,89,89,0
"C18EO",153,315,"1200x900",800,1,600,400,"True",105,211,237,26,26,0
"C18EO",154,336,"1200x900",800,1,600,400,"False",251,587,730,143,143,0
"C18EO",155,381,"1200x900",800,2,600,400,"True",705,408,442,34,34,0
"C18EO",156,60,"1200x900",600,0,600,400,"True",365,213,192,-21,21,1
"C18EO",157,355,"1200x900",800,1,600,400,"False",77,386,500,114,114,0
"C18EO",158,510,"1200x900",1000,1,600,400,"True",486,338,369,31,31,1
"C18EO",159,489,"1200x900",1000,0,600,400,"True",88,604,544,-60,60,1
"C18EO",160,475,"1200x900",1000,0,600,400,"False",101,715,638,-77,77,1
"C18EO",161,38,"1200x900",600,0,600,400,"False",120,628,554,-74,74,1
"C18EO",162,600,"1200x900",1000,2,600,400,"False",765,207,609,402,402,0
"C18EO",163,616,"1200x900",1000,2,600,400,"False",854,357,191,-166,166,1
"C18EO",164,257,"1200x900",800,0,600,400,"False",97,219,317,98,98,1
"C18EO",165,223,"1200x900",800,0,600,400,"True",179,191,182,-9,9,1
"C18EO",166,361,"1200x900",800,2,600,400,"False",931,328,195,-133,133,0
"C18EO",167,480,"1200x900",1000,0,600,400,"True",100,231,255,24,24,1
"C18EO",168,440,"1200x900",1000,0,600,400,"False",71,237,342,105,105,1
"C18EO",169,584,"1200x900",1000,2,600,400,"False",731,413,335,-78,78,0
"C18EO",170,385,"1200x900",800,2,600,400,"False",740,456,557,101,101,0
"C18EO",171,134,"1200x900",600,1,600,400,"True",300,188,146,-42,42,0
"C18EO",172,1,"1200x900",600,0,600,400,"True",136,502,470,-32,32,0
"C18EO",173,607,"1200x900",1000,2,600,400,"True",900,573,602,29,29,1
"C18EO",174,275,"1200x900",800,0,600,400,"True",120,594,543,-51,51,0
"C18EO",175,371,"1200x900",800,2,600,400,"False",730,560,333,-227,227,0
"C18EO",176,326,"1200x900",800,1,600,400,"True",103,482,485,3,3,0
"C18EO",177,53,"1200x900",600,0,600,400,"False",177,189,334,145,145,0
"C18EO",178,330,"1200x900",800,1,600,400,"False",759,301,228,-73,73,1
"C18EO",179,266,"1200x900",800,0,600,400,"True",126,303,343,40,40,1
"C18EO",182,61,"1200x900",600,0,600,400,"False",272,670,574,-96,96,1
"C18EO",183,195,"1200x900",600,2,600,400,"False",942,249,190,-59,59,0
"C18EO",184,360,"1200x900",800,1,600,400,"False",203,608,687,79,79,0
"C18EO",185,468,"1200x900",1000,0,600,400,"True",121,219,229,10,10,1
"C18EO",186,328,"1200x900",800,1,600,400,"True",104,649,649,0,0,0
"C18EO",187,241,"1200x900",800,0,600,400,"False",129,227,305,78,78,1
"C18EO",188,561,"1200x900",1000,1,600,400,"False",231,406,735,329,329,0
"C18EO",189,594,"1200x900",1000,2,600,400,"False",537,637,546,-91,91,0
"C18EO",190,76,"1200x900",600,1,600,400,"True",647,614,600,-14,14,0
"C18EO",191,527,"1200x900",1000,1,600,400,"False",565,601,515,-86,86,0
"C18EO",192,139,"1200x900",600,1,600,400,"False",192,695,791,96,96,0
"C18EO",193,540,"1200x900",1000,1,600,400,"False",389,568,647,79,79,1
"C18EO",194,172,"1200x900",600,2,600,400,"False",912,444,170,-274,274,0
"C18EO",195,167,"1200x900",600,2,600,400,"True",956,241,224,-17,17,0
"C18EO",196,611,"1200x900",1000,2,600,400,"True",414,511,550,39,39,0
"C18EO",197,363,"1200x900",800,2,600,400,"True",800,218,238,20,20,0
"C18EO",198,294,"1200x900",800,1,600,400,"False",262,287,562,275,275,0
"C18EO",199,104,"1200x900",600,1,600,400,"False",448,584,686,102,102,0
"C18EO",200,25,"1200x900",600,0,600,400,"True",263,403,459,56,56,1
"C18EO",201,477,"1200x900",1000,0,600,400,"False",88,640,575,-65,65,1
"C18EO",202,614,"1200x900",1000,2,600,400,"False",823,563,421,-142,142,0
"C18EO",203,617,"1200x900",1000,2,600,400,"False",294,180,665,485,485,0
"C18EO",204,102,"1200x900",600,1,600,400,"True",861,603,598,-5,5,0
"C18EO",205,533,"1200x900",1000,1,600,400,"False",355,483,393,-90,90,0
"C18EO",206,309,"1200x900",800,1,600,400,"False",186,225,537,312,312,0
"C18EO",207,90,"1200x900",600,1,600,400,"False",560,474,636,162,162,0
"C18EO",208,322,"1200x900",800,1,600,400,"False",703,206,303,97,97,1
"C18EO",209,406,"1200x900",800,2,600,400,"False",971,233,355,122,122,0
"C18EO",210,408,"1200x900",800,2,600,400,"False",758,567,353,-214,214,0
"C18EO",211,353,"1200x900",800,1,600,400,"False",90,476,707,231,231,0
"C18EO",212,151,"1200x900",600,2,600,400,"True",828,680,666,-14,14,0
"C18EO",213,292,"1200x900",800,1,600,400,"False",88,565,669,104,104,0
"C18EO",214,609,"1200x900",1000,2,600,400,"True",697,627,619,-8,8,0
"C18EO",215,466,"1200x900",1000,0,600,400,"False",82,205,293,88,88,1
"C18EO",216,369,"1200x900",800,2,600,400,"True",903,594,518,-76,76,0
"C18EO",217,154,"1200x900",600,2,600,400,"True",941,454,487,33,33,0
"C18EO",218,592,"1200x900",1000,2,600,400,"False",492,392,625,233,233,0
"C18EO",219,534,"1200x900",1000,1,600,400,"False",328,504,631,127,127,1
"C18EO",220,168,"1200x900",600,2,600,400,"False",1001,439,237,-202,202,0
"C18EO",221,95,"1200x900",600,1,600,400,"True",749,425,362,-63,63,1
"C18EO",222,21,"1200x900",600,0,600,400,"False",314,383,455,72,72,1
"C18EO",223,246,"1200x900",800,0,600,400,"True",196,418,476,58,58,1
"C18EO",224,388,"1200x900",800,2,600,400,"False",930,320,660,340,340,0
"C18EO",225,543,"1200x900",1000,1,600,400,"False",88,202,617,415,415,0
"C18EO",226,302,"1200x900",800,1,600,400,"False",479,467,528,61,61,1
"C18EO",227,207,"1200x900",600,2,600,400,"False",838,235,435,200,200,0
"C18EO",228,9,"1200x900",600,0,600,400,"False",509,654,544,-110,110,1
"C18EO",229,209,"1200x900",600,2,600,400,"True",937,637,635,-2,2,0
"C18EO",230,88,"1200x900",600,1,600,400,"True",186,554,574,20,20,0
"C18EO",231,173,"1200x900",600,2,600,400,"True",948,693,696,3,3,0
"C18EO",232,300,"1200x900",800,1,600,400,"True",620,693,678,-15,15,0
"C18EO",233,115,"1200x900",600,1,600,400,"True",545,307,287,-20,20,0
"C18EO",234,516,"1200x900",1000,1,600,400,"False",440,559,483,-76,76,0
"C18EO",235,152,"1200x900",600,2,600,400,"True",971,399,365,-34,34,0
"C18EO",236,242,"1200x900",800,0,600,400,"True",117,448,511,63,63,1
"C18EO",237,12,"1200x900",600,0,600,400,"True",365,336,316,-20,20,1
"C18EO",238,184,"1200x900",600,2,600,400,"False",1067,441,739,298,298,0
"C18EO",239,142,"1200x900",600,1,600,400,"False",286,474,660,186,186,0
"C18EO",240,318,"1200x900",800,1,600,400,"False",788,534,679,145,145,0
"C18EO",241,308,"1200x900",800,1,600,400,"False",437,425,586,161,161,0
"C18EO",242,67,"1200x900",600,0,600,400,"True",289,308,325,17,17,1
"C18EO",245,365,"1200x900",800,2,600,400,"False",1055,305,582,277,277,0
"C18EO",246,169,"1200x900",600,2,600,400,"False",924,290,500,210,210,0
"C18EO",247,435,"1200x900",1000,0,600,400,"True",119,200,150,-50,50,1
"C18EO",248,316,"1200x900",800,1,600,400,"False",362,319,735,416,416,0
"C18EO",249,464,"1200x900",1000,0,600,400,"False",82,222,318,96,96,1
"C18EO",251,258,"1200x900",800,0,600,400,"False",126,664,430,-234,234,1
"C18EO",252,428,"1200x900",800,2,600,400,"True",732,665,681,16,16,0
"C18EO",253,392,"1200x900",800,2,600,400,"False",1031,618,766,148,148,0
"C18EO",254,404,"1200x900",800,2,600,400,"False",842,396,331,-65,65,0
"C18EO",255,100,"1200x900",600,1,600,400,"False",453,511,343,-168,168,0
"C18EO",256,69,"1200x900",600,0,600,400,"False",322,268,401,133,133,0
"C18EO",257,615,"1200x900",1000,2,600,400,"False",736,634,704,70,70,0
"C18EO",258,541,"1200x900",1000,1,600,400,"True",339,478,503,25,25,0
"C18EO",259,143,"1200x900",600,1,600,400,"True",479,284,320,36,36,1
"C18EO",260,367,"1200x900",800,2,600,400,"True",613,464,490,26,26,0
"C18EO",261,179,"1200x900",600,2,600,400,"True",908,602,566,-36,36,0
"C18EO",262,602,"1200x900",1000,2,600,400,"False",865,452,248,-204,204,0
"C18EO",263,250,"1200x900",800,0,600,400,"False",290,248,321,73,73,1
"C18EO",264,501,"1200x900",1000,0,600,400,"True",96,323,374,51,51,1
"C18EO",265,165,"1200x900",600,2,600,400,"False",912,554,699,145,145,0
"C18EO",266,347,"1200x900",800,1,600,400,"False",757,295,604,309,309,1
"C18EO",267,52,"1200x900",600,0,600,400,"False",171,188,263,75,75,0
"C18EO",268,219,"1200x900",800,0,600,400,"True",202,502,528,26,26,1
"C18EO",269,624,"1200x900",1000,2,600,400,"False",693,501,404,-97,97,0
"C18EO",270,496,"1200x900",1000,0,600,400,"True",70,639,640,1,1,1
"C18EO",271,494,"1200x900",1000,0,600,400,"True",127,692,635,-57,57,1
"C18EO",273,225,"1200x900",800,0,600,400,"True",178,423,490,67,67,1
"C18EO",274,78,"1200x900",600,1,600,400,"True",885,684,736,52,52,0
"C18EO",275,121,"1200x900",600,1,600,400,"False",884,364,456,92,92,0
"C18EO",276,205,"1200x900",600,2,600,400,"True",1021,504,538,34,34,0
"C18EO",277,577,"1200x900",1000,2,600,400,"True",455,420,440,20,20,0
"C18EO",278,351,"1200x900",800,1,600,400,"False",122,581,652,71,71,0
"C18EO",279,99,"1200x900",600,1,600,400,"False",811,407,526,119,119,0
"C18EO",280,476,"1200x900",1000,0,600,400,"False",76,359,84,-275,275,1
"C18EO",281,8,"1200x900",600,0,600,400,"True",156,679,642,-37,37,0
"C18EO",282,529,"1200x900",1000,1,600,400,"False",267,412,229,-183,183,1
"C18EO",283,211,"1200x900",600,2,600,400,"False",986,407,216,-191,191,0
"C18EO",284,170,"1200x900",600,2,600,400,"False",996,468,284,-184,184,0
"C18EO",285,140,"1200x900",600,1,600,400,"True",700,523,523,0,0,0
"C18EO",286,366,"1200x900",800,2,600,400,"False",931,464,177,-287,287,0
"C18EO",287,387,"1200x900",800,2,600,400,"False",990,444,386,-58,58,0
"C18EO",288,255,"1200x900",800,0,600,400,"False",93,709,632,-77,77,1
"C18EO",289,199,"1200x900",600,2,600,400,"False",992,467,166,-301,301,0
"C18EO",290,70,"1200x900",600,0,600,400,"True",309,703,724,21,21,1
"C18EO",291,375,"1200x900",800,2,600,400,"False",716,384,302,-82,82,0
"C18EO",292,75,"1200x900",600,1,600,400,"True",635,558,555,-3,3,0
"C18EO",293,579,"1200x900",1000,2,600,400,"False",803,394,577,183,183,0
"C18EO",294,249,"1200x900",800,0,600,400,"True",126,306,359,53,53,1
"C18EO",295,342,"1200x900",800,1,600,400,"True",677,204,144,-60,60,0
"C18EO",296,187,"1200x900",600,2,600,400,"False",857,639,430,-209,209,0
"C18EO",297,234,"1200x900",800,0,600,400,"True",72,344,319,-25,25,1
"C18EO",298,161,"1200x900",600,2,600,400,"True",939,553,563,10,10,0
"C18EO",299,334,"1200x900",800,1,600,400,"False",481,665,341,-324,324,0
"C18EO",300,217,"1200x900",800,0,600,400,"True",85,573,581,8,8,1
"C18EO",301,588,"1200x900",1000,2,600,400,"True",585,350,431,81,81,0
"C18EO",302,273,"1200x900",800,0,600,400,"False",180,309,400,91,91,1
"C18EO",303,349,"1200x900",800,1,600,400,"False",402,665,454,-211,211,0
"C18EO",304,631,"1200x900",1000,2,600,400,"True",699,479,496,17,17,0
"C18EO",305,463,"1200x900",1000,0,600,400,"True",115,693,705,12,12,1
"C18EO",306,346,"1200x900",800,1,600,400,"True",269,635,614,-21,21,0
"C18EO",307,352,"1200x900",800,1,600,400,"True",235,717,678,-39,39,0
"C18EO",308,186,"1200x900",600,2,600,400,"True",997,197,277,80,80,0
"C18EO",309,382,"1200x900",800,2,600,400,"True",870,523,474,-49,49,0
"C18EO",310,251,"1200x900",800,0,600,400,"True",88,352,349,-3,3,1
"C18EO",311,603,"1200x900",1000,2,600,400,"True",693,280,262,-18,18,0
"C18EO",312,604,"1200x900",1000,2,600,400,"False",459,593,430,-163,163,0
"C18EO",313,191,"1200x900",600,2,600,400,"False",962,396,200,-196,196,0
"C18EO",314,314,"1200x900",800,1,600,400,"True",277,616,603,-13,13,1
"C18EO",315,356,"1200x900",800,1,600,400,"False",123,484,657,173,173,0
"C18EO",316,461,"1200x900",1000,0,600,400,"False",95,711,587,-124,124,1
"C18EO",317,587,"1200x900",1000,2,600,400,"False",741,686,172,-514,514,0
"C18EO",318,63,"1200x900",600,0,600,400,"True",311,188,215,27,27,1
"C18EO",319,119,"1200x900",600,1,600,400,"True",168,563,519,-44,44,0
"C18EO",320,483,"1200x900",1000,0,600,400,"False",93,191,271,80,80,1
"C18EO",321,626,"1200x900",1000,2,600,400,"True",329,449,480,31,31,0
"C18EO",322,216,"1200x900",600,2,600,400,"False",1029,286,393,107,107,0
"C18EO",323,380,"1200x900",800,2,600,400,"False",942,228,321,93,93,0
"C18EO",324,499,"1200x900",1000,0,600,400,"True",93,271,220,-51,51,1
"C18EO",325,236,"1200x900",800,0,600,400,"True",162,350,309,-41,41,1
"C18EO",326,589,"1200x900",1000,2,600,400,"False",856,418,598,180,180,0
"C18EO",327,519,"1200x900",1000,1,600,400,"False",319,565,641,76,76,1
"C18EO",328,620,"1200x900",1000,2,600,400,"False",832,649,259,-390,390,0
"C18EO",329,92,"1200x900",600,1,600,400,"False",624,605,753,148,148,0
"C18EO",330,305,"1200x900",800,1,600,400,"False",471,716,636,-80,80,0
"C18EO",331,71,"1200x900",600,0,600,400,"True",219,248,280,32,32,0
"C18EO",332,378,"1200x900",800,2,600,400,"False",1018,708,366,-342,342,0
"C18EO",333,84,"1200x900",600,1,600,400,"False",144,184,306,122,122,0
"C18EO",334,563,"1200x900",1000,1,600,400,"True",201,696,735,39,39,0
"C18EO",335,286,"1200x900",800,0,600,400,"False",105,378,450,72,72,1
"C18EO",336,521,"1200x900",1000,1,600,400,"False",111,303,451,148,148,1
"C18EO",337,239,"1200x900",800,0,600,400,"True",114,231,277,46,46,1
"C18EO",338,427,"1200x900",800,2,600,400,"True",812,380,354,-26,26,0
"C18EO",339,291,"1200x900",800,1,600,400,"True",522,694,661,-33,33,0
"C18EO",340,438,"1200x900",1000,0,600,400,"False",77,713,646,-67,67,1
"C18EO",341,27,"1200x900",600,0,600,400,"False",373,309,376,67,67,1
"C18EO",342,44,"1200x900",600,0,600,400,"True",305,554,521,-33,33,1
"C18EO",343,621,"1200x900",1000,2,600,400,"False",540,478,571,93,93,0
"C18EO",344,455,"1200x900",1000,0,600,400,"False",107,718,603,-115,115,1
"C18EO",345,270,"1200x900",800,0,600,400,"False",192,418,509,91,91,1
"C18EO",346,107,"1200x900",600,1,600,400,"True",878,678,683,5,5,0
"C18EO",347,98,"1200x900",600,1,600,400,"True",625,530,565,35,35,0
"C18EO",348,556,"1200x900",1000,1,600,400,"False",415,420,566,146,146,0
"C18EO",349,36,"1200x900",600,0,600,400,"True",128,346,307,-39,39,1
"C18EO",350,22,"1200x900",600,0,600,400,"True",398,591,609,18,18,1
"C18EO",351,57,"1200x900",600,0,600,400,"False",354,508,587,79,79,1
"C18EO",352,6,"1200x900",600,0,600,400,"False",217,689,569,-120,120,1
"C18EO",353,82,"1200x900",600,1,600,400,"False",108,213,441,228,228,0
"C18EO",354,568,"1200x900",1000,1,600,400,"False",286,475,599,124,124,1
"C18EO",355,536,"1200x900",1000,1,600,400,"False",580,213,294,81,81,0
"C18EO",356,15,"1200x900",600,0,600,400,"False",473,352,275,-77,77,1
"C18EO",357,96,"1200x900",600,1,600,400,"False",433,458,680,222,222,0
"C18EO",358,642,"1200x900",1000,2,600,400,"False",776,316,455,139,139,0
"C18EO",359,64,"1200x900",600,0,600,400,"True",102,339,304,-35,35,0
"C18EO",360,34,"1200x900",600,0,600,400,"True",361,242,295,53,53,1
"C18EO",361,163,"1200x900",600,2,600,400,"False",1046,665,721,56,56,0
"C18EO",362,553,"1200x900",1000,1,600,400,"False",116,712,284,-428,428,0
"C18EO",363,415,"1200x900",800,2,600,400,"True",823,684,720,36,36,0
"C18EO",364,400,"1200x900",800,2,600,400,"False",733,297,235,-62,62,0
"C18EO",365,639,"1200x900",1000,2,600,400,"False",504,456,278,-178,178,0
"C18EO",366,586,"1200x900",1000,2,600,400,"False",802,262,532,270,270,0
"C18EO",367,456,"1200x900",1000,0,600,400,"True",91,257,187,-70,70,1
"C18EO",368,109,"1200x900",600,1,600,400,"False",691,589,475,-114,114,0
"C18EO",369,324,"1200x900",800,1,600,400,"False",719,712,546,-166,166,1
"C18EO",370,24,"1200x900",600,0,600,400,"True",430,538,532,-6,6,1
"C18EO",371,488,"1200x900",1000,0,600,400,"False",129,687,584,-103,103,1
"C18EO",372,389,"1200x900",800,2,600,400,"False",843,530,446,-84,84,0
"C18EO",373,393,"1200x900",800,2,600,400,"False",657,620,481,-139,139,0
"C18EO",374,545,"1200x900",1000,1,600,400,"True",358,562,552,-10,10,0
"C18EO",375,193,"1200x900",600,2,600,400,"True",874,588,521,-67,67,0
"C18EO",376,503,"1200x900",1000,0,600,400,"False",86,279,363,84,84,1
"C18EO",377,520,"1200x900",1000,1,600,400,"False",564,260,185,-75,75,0
"C18EO",378,575,"1200x900",1000,1,600,400,"True",272,693,666,-27,27,0
"C18EO",379,26,"1200x900",600,0,600,400,"True",70,712,706,-6,6,0
"C18EO",380,93,"1200x900",600,1,600,400,"False",139,540,680,140,140,0
"C18EO",381,91,"1200x900",600,1,600,400,"True",417,630,564,-66,66,1
"C18EO",382,598,"1200x900",1000,2,600,400,"True",706,559,534,-25,25,0
"C18EO",383,443,"1200x900",1000,0,600,400,"True",99,651,675,24,24,1
"C18EO",384,120,"1200x900",600,1,600,400,"True",690,655,611,-44,44,0
"C18EO",385,232,"1200x900",800,0,600,400,"True",84,511,535,24,24,1
"C18EO",386,283,"1200x900",800,0,600,400,"True",90,264,218,-46,46,1
"C18EO",387,555,"1200x900",1000,1,600,400,"True",444,556,534,-22,22,0
"C18EO",388,410,"1200x900",800,2,600,400,"False",916,477,156,-321,321,0
"C18EO",389,358,"1200x900",800,1,600,400,"False",263,635,433,-202,202,0
"C18EO",390,174,"1200x900",600,2,600,400,"True",998,457,497,40,40,0
"C18EO",391,362,"1200x900",800,2,600,400,"True",819,338,302,-36,36,0
"C18EO",392,31,"1200x900",600,0,600,400,"True",365,338,375,37,37,1
"C18EO",393,495,"1200x900",1000,0,600,400,"True",93,692,709,17,17,1
"C18EO",394,571,"1200x900",1000,1,600,400,"False",239,522,367,-155,155,1
"C18EO",395,122,"1200x900",600,1,600,400,"True",817,709,769,60,60,0
"C18EO",396,619,"1200x900",1000,2,600,400,"False",803,247,553,306,306,0
"C18EO",397,645,"1200x900",1000,2,600,400,"True",619,396,406,10,10,0
"C18EO",398,138,"1200x900",600,1,600,400,"True",844,580,536,-44,44,1
"C18EO",399,194,"1200x900",600,2,600,400,"True",896,236,271,35,35,0
"C18EO",400,422,"1200x900",800,2,600,400,"False",712,558,443,-115,115,0
"C18EO",401,379,"1200x900",800,2,600,400,"False",994,325,610,285,285,0
"C18EO",402,313,"1200x900",800,1,600,400,"True",588,421,406,-15,15,0
"C18EO",403,278,"1200x900",800,0,600,400,"True",251,711,717,6,6,1
"C18EO",404,293,"1200x900",800,1,600,400,"True",561,396,370,-26,26,0
"C18EO",405,306,"1200x900",800,1,600,400,"False",164,524,705,181,181,0
"C18EO",406,276,"1200x900",800,0,600,400,"True",281,217,218,1,1,1
"C18EO",407,166,"1200x900",600,2,600,400,"False",896,274,173,-101,101,0
"C18EO",408,472,"1200x900",1000,0,600,400,"False",77,685,605,-80,80,1
"C18EO",409,5,"1200x900",600,0,600,400,"True",228,587,534,-53,53,0
"C18EO",410,135,"1200x900",600,1,600,400,"True",759,569,506,-63,63,0
"C18EO",411,180,"1200x900",600,2,600,400,"True",929,270,273,3,3,0
"C18EO",412,157,"1200x900",600,2,600,400,"False",1016,323,199,-124,124,0
"C18EO",413,341,"1200x900",800,1,600,400,"True",735,632,576,-56,56,1
"C18EO",414,485,"1200x900",1000,0,600,400,"False",121,694,544,-150,150,1
"C18EO",415,500,"1200x900",1000,0,600,400,"False",105,700,571,-129,129,1
"C18EO",416,395,"1200x900",800,2,600,400,"True",743,334,375,41,41,0
"C18EO",418,149,"1200x900",600,2,600,400,"True",890,289,300,11,11,0
"C18EO",419,354,"1200x900",800,1,600,400,"False",118,236,359,123,123,0
"C18EO",420,185,"1200x900",600,2,600,400,"True",907,212,170,-42,42,0
"C18EO",421,321,"1200x900",800,1,600,400,"True",601,190,134,-56,56,0
"C18EO",422,162,"1200x900",600,2,600,400,"True",849,279,275,-4,4,0
"C18EO",423,41,"1200x900",600,0,600,400,"True",370,452,471,19,19,1
"C18EO",424,482,"1200x900",1000,0,600,400,"True",79,686,739,53,53,1
"C18EO",425,298,"1200x900",800,1,600,400,"False",311,457,357,-100,100,0
"C18EO",426,580,"1200x900",1000,2,600,400,"True",651,267,335,68,68,0
"C18EO",427,511,"1200x900",1000,1,600,400,"True",408,390,464,74,74,1
"C18EO",428,447,"1200x900",1000,0,600,400,"True",71,339,359,20,20,1
"C18EO",429,420,"1200x900",800,2,600,400,"False",519,223,424,201,201,0
"C18EO",430,272,"1200x900",800,0,600,400,"True",200,181,182,1,1,1
"C18EO",431,103,"1200x900",600,1,600,400,"True",528,320,346,26,26,1
"C18EO",432,55,"1200x900",600,0,600,400,"True",211,305,335,30,30,1
"C18EO",433,451,"1200x900",1000,0,600,400,"False",110,702,495,-207,207,1
"C18EO",435,227,"1200x900",800,0,600,400,"True",196,551,552,1,1,1
"C18EO",436,550,"1200x900",1000,1,600,400,"True",301,459,481,22,22,0
"C18EO",437,507,"1200x900",1000,1,600,400,"True",608,583,625,42,42,1
"C18EO",438,377,"1200x900",800,2,600,400,"True",683,388,426,38,38,0
"C18EO",439,123,"1200x900",600,1,600,400,"True",761,365,374,9,9,1
"C18EO",440,539,"1200x900",1000,1,600,400,"True",510,383,400,17,17,0
"C18EO",442,618,"1200x900",1000,2,600,400,"False",276,671,527,-144,144,0
"C18EO",443,111,"1200x900",600,1,600,400,"True",922,552,580,28,28,1
"C18EO",444,641,"1200x900",1000,2,600,400,"False",897,272,674,402,402,0
"C18EO",445,409,"1200x900",800,2,600,400,"False",501,659,504,-155,155,0
"C18EO",446,635,"1200x900",1000,2,600,400,"False",833,402,229,-173,173,0
"C18EO",447,175,"1200x900",600,2,600,400,"False",1028,432,299,-133,133,0
"C18EO",448,14,"1200x900",600,0,600,400,"True",399,224,189,-35,35,1
"C18EO",449,226,"1200x900",800,0,600,400,"True",187,229,229,0,0,1
"C18EO",450,268,"1200x900",800,0,600,400,"True",148,400,353,-47,47,1
"C18EO",451,56,"1200x900",600,0,600,400,"True",148,491,426,-65,65,0
"C18EO",452,632,"1200x900",1000,2,600,400,"False",984,227,409,182,182,0
"C18EO",453,630,"1200x900",1000,2,600,400,"False",754,559,387,-172,172,0
"C18EO",454,465,"1200x900",1000,0,600,400,"False",85,203,358,155,155,1
"C18EO",455,569,"1200x900",1000,1,600,400,"False",494,720,432,-288,288,0
"C18EO",456,153,"1200x900",600,2,600,400,"False",1037,601,393,-208,208,0
"C18EO",457,310,"1200x900",800,1,600,400,"True",559,592,567,-25,25,0
"C18EO",458,327,"1200x900",800,1,600,400,"False",152,339,271,-68,68,0
"C18EO",459,583,"1200x900",1000,2,600,400,"False",949,284,215,-69,69,1
"C18EO",460,253,"1200x900",800,0,600,400,"False",177,424,562,138,138,1
"C18EO",461,256,"1200x900",800,0,600,400,"True",192,656,649,-7,7,1
"C18EO",462,338,"1200x900",800,1,600,400,"False",813,253,131,-122,122,1
"C18EO",463,65,"1200x900",600,0,600,400,"True",442,645,594,-51,51,1
"C18EO",464,399,"1200x900",800,2,600,400,"True",603,602,627,25,25,0
"C18EO",465,279,"1200x900",800,0,600,400,"False",252,202,370,168,168,1
"C18EO",466,559,"1200x900",1000,1,600,400,"False",641,244,336,92,92,0
"C18EO",467,210,"1200x900",600,2,600,400,"False",835,506,289,-217,217,0
"C18EO",468,419,"1200x900",800,2,600,400,"True",769,351,416,65,65,0
"C18EO",469,212,"1200x900",600,2,600,400,"False",841,206,368,162,162,0
"C18EO",470,224,"1200x900",800,0,600,400,"True",161,474,476,2,2,1
"C18EO",471,320,"1200x900",800,1,600,400,"True",644,376,402,26,26,0
"C18EO",472,280,"1200x900",800,0,600,400,"True",104,302,297,-5,5,1
"C18EO",473,593,"1200x900",1000,2,600,400,"False",246,719,427,-292,292,0
"C18EO",474,372,"1200x900",800,2,600,400,"False",833,620,466,-154,154,0
"C18EO",475,442,"1200x900",1000,0,600,400,"False",87,183,393,210,210,1
"C18EO",476,147,"1200x900",600,2,600,400,"True",942,418,496,78,78,0
"C18EO",477,439,"1200x900",1000,0,600,400,"False",110,229,311,82,82,1
"C18EO",479,648,"1200x900",1000,2,600,400,"False",557,394,192,-202,202,0
"C18EO",480,233,"1200x900",800,0,600,400,"True",164,700,759,59,59,1
"C18EO",481,486,"1200x900",1000,0,600,400,"True",102,676,675,-1,1,1
"C18EO",482,599,"1200x900",1000,2,600,400,"True",316,570,579,9,9,0
"C18EO",483,564,"1200x900",1000,1,600,400,"False",215,264,362,98,98,0
"C18EO",484,4,"1200x900",600,0,600,400,"True",602,200,235,35,35,1
"C18EO",485,287,"1200x900",800,0,600,400,"True",120,567,536,-31,31,1
"C18EO",486,412,"1200x900",800,2,600,400,"False",842,280,214,-66,66,0
"C18EO",487,636,"1200x900",1000,2,600,400,"False",575,583,374,-209,209,0
"C18EO",488,263,"1200x900",800,0,600,400,"True",82,396,434,38,38,1
"C18EO",489,72,"1200x900",600,0,600,400,"True",158,537,508,-29,29,0
"C18EO",490,469,"1200x900",1000,0,600,400,"False",73,227,361,134,134,1
"C18EO",491,368,"1200x900",800,2,600,400,"False",778,515,454,-61,61,0
"C18EO",492,228,"1200x900",800,0,600,400,"True",174,687,675,-12,12,1
"C18EO",493,133,"1200x900",600,1,600,400,"False",345,551,672,121,121,0
"C18EO",495,215,"1200x900",600,2,600,400,"False",939,596,502,-94,94,0
"C18EO",496,437,"1200x900",1000,0,600,400,"True",74,667,646,-21,21,1
"C18EO",497,284,"1200x900",800,0,600,400,"True",135,293,344,51,51,1
"C18EO",498,523,"1200x900",1000,1,600,400,"True",339,318,290,-28,28,0
"C18EO",499,244,"1200x900",800,0,600,400,"True",194,203,172,-31,31,1
"C18EO",500,271,"1200x900",800,0,600,400,"True",74,360,372,12,12,1
"C18EO",501,126,"1200x900",600,1,600,400,"False",849,354,450,96,96,0
"C18EO",502,370,"1200x900",800,2,600,400,"False",874,336,181,-155,155,0
"C18EO",503,40,"1200x900",600,0,600,400,"True",143,513,515,2,2,0
"C18EO",504,492,"1200x900",1000,0,600,400,"True",76,692,659,-33,33,1
"C18EO",506,171,"1200x900",600,2,600,400,"True",909,200,206,6,6,0
"C18EO",507,54,"1200x900",600,0,600,400,"True",474,564,541,-23,23,1
"C18EO",508,452,"1200x900",1000,0,600,400,"True",97,273,297,24,24,1
"C18EO",509,159,"1200x900",600,2,600,400,"True",992,309,391,82,82,0
"C18EO",510,423,"1200x900",800,2,600,400,"False",1051,710,558,-152,152,1
"C18EO",511,323,"1200x900",800,1,600,400,"False",388,348,587,239,239,0
"C18EO",512,319,"1200x900",800,1,600,400,"True",494,587,586,-1,1,1
"C18EO",513,127,"1200x900",600,1,600,400,"True",309,691,704,13,13,0
"C18EO",514,597,"1200x900",1000,2,600,400,"True",352,239,227,-12,12,0
"C18EO",515,89,"1200x900",600,1,600,400,"True",917,366,386,20,20,1
"C18EO",516,425,"1200x900",800,2,600,400,"False",621,438,354,-84,84,0
"C18EO",517,623,"1200x900",1000,2,600,400,"False",636,527,381,-146,146,0
"C18EO",518,417,"1200x900",800,2,600,400,"False",750,280,521,241,241,0
"C18EO",520,454,"1200x900",1000,0,600,400,"False",78,687,547,-140,140,1
"C18EO",521,430,"1200x900",800,2,600,400,"True",922,254,224,-30,30,0
"C18EO",522,158,"1200x900",600,2,600,400,"True",939,300,314,14,14,0
"C18EO",523,252,"1200x900",800,0,600,400,"True",224,673,703,30,30,1
"C18EO",524,202,"1200x900",600,2,600,400,"True",966,460,499,39,39,0
"C18EO",525,197,"1200x900",600,2,600,400,"True",903,212,215,3,3,0
"C18EO",526,208,"1200x900",600,2,600,400,"False",946,399,261,-138,138,0
"C18EO",527,7,"1200x900",600,0,600,400,"True",431,654,691,37,37,1
"C18EO",528,497,"1200x900",1000,0,600,400,"False",106,696,594,-102,102,1
"C18EO",529,411,"1200x900",800,2,600,400,"False",805,361,483,122,122,0
"C18EO",530,125,"1200x900",600,1,600,400,"True",750,531,557,26,26,0
"C18EO",531,43,"1200x900",600,0,600,400,"True",277,446,404,-42,42,1
"C18EO",532,524,"1200x900",1000,1,600,400,"False",534,470,538,68,68,0
"C18EO",533,128,"1200x900",600,1,600,400,"True",661,258,236,-22,22,1
"C18EO",534,373,"1200x900",800,2,600,400,"False",694,326,432,106,106,0
"C18EO",535,343,"1200x900",800,1,600,400,"False",407,557,290,-267,267,0
"C18EO",536,398,"1200x900",800,2,600,400,"False",944,698,566,-132,132,0
"C18EO",537,470,"1200x900",1000,0,600,400,"True",91,666,726,60,60,1
"C18EO",538,458,"1200x900",1000,0,600,400,"True",78,624,604,-20,20,1
"C18EO",539,498,"1200x900",1000,0,600,400,"False",100,260,395,135,135,1
"C18EO",540,178,"1200x900",600,2,600,400,"True",1041,510,552,42,42,0
"C18EO",541,50,"1200x900",600,0,600,400,"False",75,582,506,-76,76,0
"C18EO",542,200,"1200x900",600,2,600,400,"True",897,302,380,78,78,0
"C18EO",543,585,"1200x900",1000,2,600,400,"False",698,688,525,-163,163,1
"C18EO",544,429,"1200x900",800,2,600,400,"False",682,692,464,-228,228,0
"C18EO",545,530,"1200x900",1000,1,600,400,"False",584,405,328,-77,77,1
"C18EO",546,269,"1200x900",800,0,600,400,"True",160,295,321,26,26,1
"C18EO",547,260,"1200x900",800,0,600,400,"False",103,525,382,-143,143,1
"C18EO",548,129,"1200x900",600,1,600,400,"False",859,482,256,-226,226,1
"C18EO",549,325,"1200x900",800,1,600,400,"True",105,394,363,-31,31,0
"C18EO",550,87,"1200x900",600,1,600,400,"True",231,604,605,1,1,0
"C18EO",551,80,"1200x900",600,1,600,400,"True",616,423,475,52,52,1
"C18EO",552,118,"1200x900",600,1,600,400,"False",190,588,694,106,106,0
"C18EO",553,450,"1200x900",1000,0,600,400,"True",130,204,220,16,16,1
"C18EO",554,148,"1200x900",600,2,600,400,"True",907,330,368,38,38,0
"C18EO",555,285,"1200x900",800,0,600,400,"True",237,396,354,-42,42,1
"C18EO",556,182,"1200x900",600,2,600,400,"True",933,389,388,-1,1,0
"C18EO",557,567,"1200x900",1000,1,600,400,"True",655,297,304,7,7,1
"C18EO",558,462,"1200x900",1000,0,600,400,"True",102,672,695,23,23,1
"C18EO",559,634,"1200x900",1000,2,600,400,"False",735,313,418,105,105,0
"C18EO",560,213,"1200x900",600,2,600,400,"False",822,275,392,117,117,0
"C18EO",561,640,"1200x900",1000,2,600,400,"False",361,334,544,210,210,0
"C18EO",562,445,"1200x900",1000,0,600,400,"False",78,302,390,88,88,1
"C18EO",563,350,"1200x900",800,1,600,400,"False",182,566,439,-127,127,0
"C18EO",564,19,"1200x900",600,0,600,400,"False",286,686,587,-99,99,0
"C18EO",565,608,"1200x900",1000,2,600,400,"False",742,250,348,98,98,0
"C18EO",566,637,"1200x900",1000,2,600,400,"False",750,460,611,151,151,0
"C18EO",567,307,"1200x900",800,1,600,400,"True",716,247,242,-5,5,0
"C18EO",568,546,"1200x900",1000,1,600,400,"True",305,374,405,31,31,0
"C18EO",569,46,"1200x900",600,0,600,400,"True",193,355,386,31,31,1
"C18EO",570,230,"1200x900",800,0,600,400,"True",99,678,641,-37,37,1
"C18EO",571,35,"1200x900",600,0,600,400,"True",366,555,609,54,54,1
"C18EO",572,337,"1200x900",800,1,600,400,"False",299,622,698,76,76,0
"C18EO",573,176,"1200x900",600,2,600,400,"True",1033,281,344,63,63,0
"C18EO",574,295,"1200x900",800,1,600,400,"False",471,334,237,-97,97,0
"C18EO",575,474,"1200x900",1000,0,600,400,"False",85,339,451,112,112,1
"C18EO",576,183,"1200x900",600,2,600,400,"True",927,289,289,0,0,0
"C18EO",577,402,"1200x900",800,2,600,400,"True",878,234,190,-44,44,0
"C18EO",578,189,"1200x900",600,2,600,400,"True",881,397,367,-30,30,0
"C18EO",579,247,"1200x900",800,0,600,400,"True",160,424,477,53,53,1
"C18EO",580,538,"1200x900",1000,1,600,400,"False",308,457,237,-220,220,1
"C18EO",581,433,"1200x900",1000,0,600,400,"False",76,222,306,84,84,1
"C18EO",582,2,"1200x900",600,0,600,400,"True",159,323,373,50,50,0
"C18EO",583,643,"1200x900",1000,2,600,400,"True",740,325,338,13,13,0
"C18EO",584,141,"1200x900",600,1,600,400,"False",671,582,701,119,119,0
"C18EO",585,3,"1200x900",600,0,600,400,"False",298,443,333,-110,110,1
"C18EO",586,155,"1200x900",600,2,600,400,"False",940,269,376,107,107,0
"C18EO",587,116,"1200x900",600,1,600,400,"False",767,289,147,-142,142,0
"C18EO",588,502,"1200x900",1000,0,600,400,"True",111,639,581,-58,58,1
"C18EO",589,518,"1200x900",1000,1,600,400,"True",583,717,675,-42,42,0
"C18EO",590,397,"1200x900",800,2,600,400,"True",817,692,622,-70,70,0
"C18EO",591,16,"1200x900",600,0,600,400,"False",297,514,630,116,116,1
"C18EO",592,59,"1200x900",600,0,600,400,"True",391,692,657,-35,35,1
"C18EO",593,473,"1200x900",1000,0,600,400,"False",75,323,531,208,208,1
"C18EO",594,573,"1200x900",1000,1,600,400,"True",486,615,588,-27,27,0
"C18EO",596,11,"1200x900",600,0,600,400,"True",372,670,669,-1,1,1
"C18EO",597,357,"1200x900",800,1,600,400,"False",109,594,675,81,81,0
"C18EO",598,493,"1200x900",1000,0,600,400,"True",80,582,601,19,19,1
"C18EO",599,548,"1200x900",1000,1,600,400,"False",103,278,494,216,216,0
"C18EO",600,512,"1200x900",1000,1,600,400,"False",139,261,560,299,299,0
"C18EO",601,441,"1200x900",1000,0,600,400,"False",85,684,550,-134,134,1
"C18EO",602,156,"1200x900",600,2,600,400,"False",913,197,384,187,187,0
"C18EO",603,570,"1200x900",1000,1,600,400,"True",315,352,419,67,67,0
"C18EO",604,544,"1200x900",1000,1,600,400,"False",602,620,521,-99,99,0
"C18EO",605,537,"1200x900",1000,1,600,400,"False",621,412,612,200,200,1
"C18EO",606,331,"1200x900",800,1,600,400,"True",240,620,552,-68,68,0
"C18EO",607,231,"1200x900",800,0,600,400,"True",251,718,671,-47,47,1
"C18EO",608,237,"1200x900",800,0,600,400,"False",204,481,551,70,70,1
"C18EO",609,384,"1200x900",800,2,600,400,"False",821,707,606,-101,101,0
"C18EO",610,23,"1200x900",600,0,600,400,"True",308,463,507,44,44,1
"C18EO",611,629,"1200x900",1000,2,600,400,"False",681,257,533,276,276,0
"C18EO",612,613,"1200x900",1000,2,600,400,"False",690,374,500,126,126,0
"C18EO",613,374,"1200x900",800,2,600,400,"True",755,450,439,-11,11,0
"C18EO",614,339,"1200x900",800,1,600,400,"True",273,545,602,57,57,1
"C18EO",615,83,"1200x900",600,1,600,400,"False",763,568,727,159,159,1
"C18EO",616,574,"1200x900",1000,1,600,400,"False",614,194,270,76,76,0
"C18EO",617,265,"1200x900",800,0,600,400,"True",229,353,304,-49,49,1
"C18EO",618,114,"1200x900",600,1,600,400,"True",183,697,579,-118,118,0
"C18EO",619,79,"1200x900",600,1,600,400,"True",731,289,300,11,11,0
"C18EO",620,426,"1200x900",800,2,600,400,"False",830,263,372,109,109,0
"C18EO",621,578,"1200x900",1000,2,600,400,"False",966,276,613,337,337,0
"C18EO",622,413,"1200x900",800,2,600,400,"False",849,506,316,-190,190,0
"C18EO",623,436,"1200x900",1000,0,600,400,"False",82,617,747,130,130,1
"C18EO",624,517,"1200x900",1000,1,600,400,"True",548,182,144,-38,38,0
"C18EO",625,222,"1200x900",800,0,600,400,"False",152,206,94,-112,112,1
"C18EO",626,582,"1200x900",1000,2,600,400,"True",554,347,342,-5,5,0
"C18EO",627,557,"1200x900",1000,1,600,400,"False",677,505,603,98,98,1
"C18EO",628,259,"1200x900",800,0,600,400,"True",156,180,189,9,9,1
"C18EO",629,344,"1200x900",800,1,600,400,"False",589,408,281,-127,127,0
"C18EO",630,160,"1200x900",600,2,600,400,"False",863,606,500,-106,106,0
"C18EO",631,94,"1200x900",600,1,600,400,"False",729,482,395,-87,87,0
"C18EO",632,590,"1200x900",1000,2,600,400,"False",636,278,406,128,128,0
"C18EO",633,13,"1200x900",600,0,600,400,"True",296,211,134,-77,77,1
"C18EO",634,457,"1200x900",1000,0,600,400,"False",97,630,540,-90,90,1
"C18EO",635,446,"1200x900",1000,0,600,400,"False",72,298,468,170,170,1
"C18EO",636,646,"1200x900",1000,2,600,400,"True",829,227,280,53,53,1
"C18EO",637,345,"1200x900",800,1,600,400,"False",841,566,672,106,106,1
"C18EO",638,467,"1200x900",1000,0,600,400,"True",74,712,694,-18,18,1
"C18EO",639,508,"1200x900",1000,1,600,400,"True",596,485,465,-20,20,0
"C18EO",640,547,"1200x900",1000,1,600,400,"False",369,384,621,237,237,1
"C18EO",641,407,"1200x900",800,2,600,400,"False",989,340,128,-212,212,0
"C18EO",642,601,"1200x900",1000,2,600,400,"False",735,697,267,-430,430,0
"C18EO",643,281,"1200x900",800,0,600,400,"False",112,611,541,-70,70,1
"C18EO",644,146,"1200x900",600,2,600,400,"False",989,492,253,-239,239,0
"C18EO",645,28,"1200x900",600,0,600,400,"True",336,410,387,-23,23,1
"C18EO",646,572,"1200x900",1000,1,600,400,"False",302,260,357,97,97,0
"C18EO",647,490,"1200x900",1000,0,600,400,"True",114,183,182,-1,1,1
"C18EO",648,522,"1200x900",1000,1,600,400,"False",223,379,616,237,237,0
"C19AS",1,610,"1200x900",1000,2,600,400,"True",702,293,347,54,54,0
"C19AS",2,625,"1200x900",1000,2,600,400,"False",279,228,566,338,338,0
"C19AS",3,207,"1200x900",600,2,600,400,"True",838,235,306,71,71,0
"C19AS",4,500,"1200x900",1000,0,600,400,"False",105,700,520,-180,180,1
"C19AS",5,635,"1200x900",1000,2,600,400,"True",833,402,479,77,77,0
"C19AS",6,527,"1200x900",1000,1,600,400,"True",565,601,585,-16,16,0
"C19AS",7,287,"1200x900",800,0,600,400,"False",120,567,497,-70,70,1
"C19AS",8,393,"1200x900",800,2,600,400,"False",657,620,288,-332,332,0
"C19AS",9,353,"1200x900",800,1,600,400,"True",90,476,531,55,55,0
"C19AS",10,585,"1200x900",1000,2,600,400,"True",698,688,630,-58,58,1
"C19AS",11,82,"1200x900",600,1,600,400,"False",108,213,358,145,145,0
"C19AS",12,2,"1200x900",600,0,600,400,"True",159,323,275,-48,48,0
"C19AS",13,73,"1200x900",600,1,600,400,"True",94,665,559,-106,106,0
"C19AS",14,155,"1200x900",600,2,600,400,"False",940,269,375,106,106,0
"C19AS",15,104,"1200x900",600,1,600,400,"False",448,584,686,102,102,0
"C19AS",16,83,"1200x900",600,1,600,400,"True",763,568,557,-11,11,1
"C19AS",17,361,"1200x900",800,2,600,400,"False",931,328,50,-278,278,0
"C19AS",18,378,"1200x900",800,2,600,400,"False",1018,708,484,-224,224,0
"C19AS",19,488,"1200x900",1000,0,600,400,"False",129,687,542,-145,145,1
"C19AS",20,629,"1200x900",1000,2,600,400,"False",681,257,415,158,158,0
"C19AS",21,156,"1200x900",600,2,600,400,"True",913,197,250,53,53,0
"C19AS",22,38,"1200x900",600,0,600,400,"True",120,628,586,-42,42,1
"C19AS",23,245,"1200x900",800,0,600,400,"True",296,235,179,-56,56,1
"C19AS",24,32,"1200x900",600,0,600,400,"False",152,563,465,-98,98,1
"C19AS",25,9,"1200x900",600,0,600,400,"False",509,654,543,-111,111,1
"C19AS",26,74,"1200x900",600,1,600,400,"False",115,358,274,-84,84,0
"C19AS",27,229,"1200x900",800,0,600,400,"False",117,697,624,-73,73,1
"C19AS",28,342,"1200x900",800,1,600,400,"True",677,204,211,7,7,0
"C19AS",29,448,"1200x900",1000,0,600,400,"False",107,641,459,-182,182,1
"C19AS",30,480,"1200x900",1000,0,600,400,"False",100,231,322,91,91,1
"C19AS",31,540,"1200x900",1000,1,600,400,"False",389,568,263,-305,305,1
"C19AS",32,645,"1200x900",1000,2,600,400,"True",619,396,406,10,10,0
"C19AS",33,42,"1200x900",600,0,600,400,"True",233,479,484,5,5,0
"C19AS",34,418,"1200x900",800,2,600,400,"True",754,507,473,-34,34,0
"C19AS",35,613,"1200x900",1000,2,600,400,"True",690,374,380,6,6,0
"C19AS",36,262,"1200x900",800,0,600,400,"True",196,481,440,-41,41,1
"C19AS",37,365,"1200x900",800,2,600,400,"True",1055,305,334,29,29,0
"C19AS",38,559,"1200x900",1000,1,600,400,"False",641,244,544,300,300,0
"C19AS",39,138,"1200x900",600,1,600,400,"False",844,580,662,82,82,1
"C19AS",40,614,"1200x900",1000,2,600,400,"False",823,563,378,-185,185,0
"C19AS",41,329,"1200x900",800,1,600,400,"False",517,239,113,-126,126,0
"C19AS",42,240,"1200x900",800,0,600,400,"False",330,656,511,-145,145,1
"C19AS",43,147,"1200x900",600,2,600,400,"True",942,418,432,14,14,0
"C19AS",44,231,"1200x900",800,0,600,400,"False",251,718,582,-136,136,1
"C19AS",45,325,"1200x900",800,1,600,400,"False",105,394,615,221,221,0
"C19AS",46,553,"1200x900",1000,1,600,400,"False",116,712,637,-75,75,0
"C19AS",47,640,"1200x900",1000,2,600,400,"False",361,334,557,223,223,0
"C19AS",48,299,"1200x900",800,1,600,400,"False",779,274,529,255,255,0
"C19AS",49,434,"1200x900",1000,0,600,400,"False",89,657,590,-67,67,1
"C19AS",50,140,"1200x900",600,1,600,400,"True",700,523,556,33,33,0
"C19AS",51,1,"1200x900",600,0,600,400,"True",136,502,513,11,11,0
"C19AS",53,238,"1200x900",800,0,600,400,"True",162,283,229,-54,54,1
"C19AS",54,148,"1200x900",600,2,600,400,"True",907,330,271,-59,59,0
"C19AS",55,521,"1200x900",1000,1,600,400,"False",111,303,586,283,283,1
"C19AS",56,501,"1200x900",1000,0,600,400,"True",96,323,347,24,24,1
"C19AS",59,258,"1200x900",800,0,600,400,"True",126,664,711,47,47,1
"C19AS",60,599,"1200x900",1000,2,600,400,"False",316,570,312,-258,258,0
"C19AS",61,154,"1200x900",600,2,600,400,"False",941,454,577,123,123,0
"C19AS",62,413,"1200x900",800,2,600,400,"False",849,506,311,-195,195,0
"C19AS",63,21,"1200x900",600,0,600,400,"True",314,383,358,-25,25,1
"C19AS",64,270,"1200x900",800,0,600,400,"True",192,418,353,-65,65,1
"C19AS",65,551,"1200x900",1000,1,600,400,"False",146,445,624,179,179,1
"C19AS",66,94,"1200x900",600,1,600,400,"False",729,482,357,-125,125,0
"C19AS",68,103,"1200x900",600,1,600,400,"True",528,320,337,17,17,1
"C19AS",69,98,"1200x900",600,1,600,400,"False",625,530,393,-137,137,0
"C19AS",70,27,"1200x900",600,0,600,400,"True",373,309,242,-67,67,1
"C19AS",71,145,"1200x900",600,2,600,400,"False",1004,630,451,-179,179,0
"C19AS",72,406,"1200x900",800,2,600,400,"False",971,233,465,232,232,0
"C19AS",73,5,"1200x900",600,0,600,400,"True",228,587,590,3,3,0
"C19AS",74,368,"1200x900",800,2,600,400,"True",778,515,480,-35,35,0
"C19AS",76,206,"1200x900",600,2,600,400,"False",975,223,315,92,92,0
"C19AS",77,493,"1200x900",1000,0,600,400,"False",80,582,721,139,139,1
"C19AS",78,311,"1200x900",800,1,600,400,"False",710,261,425,164,164,0
"C19AS",79,170,"1200x900",600,2,600,400,"False",996,468,391,-77,77,0
"C19AS",80,93,"1200x900",600,1,600,400,"True",139,540,563,23,23,0
"C19AS",81,547,"1200x900",1000,1,600,400,"True",369,384,410,26,26,1
"C19AS",82,55,"1200x900",600,0,600,400,"True",211,305,329,24,24,1
"C19AS",84,134,"1200x900",600,1,600,400,"False",300,188,588,400,400,0
"C19AS",85,323,"1200x900",800,1,600,400,"False",388,348,416,68,68,0
"C19AS",87,451,"1200x900",1000,0,600,400,"False",110,702,570,-132,132,1
"C19AS",88,473,"1200x900",1000,0,600,400,"True",75,323,299,-24,24,1
"C19AS",89,455,"1200x900",1000,0,600,400,"False",107,718,567,-151,151,1
"C19AS",90,628,"1200x900",1000,2,600,400,"True",768,410,436,26,26,0
"C19AS",91,203,"1200x900",600,2,600,400,"True",938,603,588,-15,15,0
"C19AS",92,517,"1200x900",1000,1,600,400,"False",548,182,434,252,252,0
"C19AS",93,359,"1200x900",800,1,600,400,"False",653,241,447,206,206,0
"C19AS",94,220,"1200x900",800,0,600,400,"False",108,699,791,92,92,1
"C19AS",95,431,"1200x900",800,2,600,400,"False",694,382,293,-89,89,0
"C19AS",96,516,"1200x900",1000,1,600,400,"True",440,559,627,68,68,0
"C19AS",97,190,"1200x900",600,2,600,400,"False",977,238,354,116,116,0
"C19AS",98,72,"1200x900",600,0,600,400,"True",158,537,524,-13,13,0
"C19AS",99,369,"1200x900",800,2,600,400,"False",903,594,697,103,103,0
"C19AS",100,420,"1200x900",800,2,600,400,"False",519,223,478,255,255,0
"C19AS",101,459,"1200x900",1000,0,600,400,"False",70,645,530,-115,115,1
"C19AS",102,340,"1200x900",800,1,600,400,"False",226,240,396,156,156,0
"C19AS",103,590,"1200x900",1000,2,600,400,"False",636,278,521,243,243,0
"C19AS",104,402,"1200x900",800,2,600,400,"False",878,234,403,169,169,0
"C19AS",105,193,"1200x900",600,2,600,400,"True",874,588,587,-1,1,0
"C19AS",106,421,"1200x900",800,2,600,400,"True",898,394,387,-7,7,0
"C19AS",107,307,"1200x900",800,1,600,400,"False",716,247,449,202,202,0
"C19AS",108,593,"1200x900",1000,2,600,400,"False",246,719,293,-426,426,0
"C19AS",109,532,"1200x900",1000,1,600,400,"False",215,207,526,319,319,0
"C19AS",110,482,"1200x900",1000,0,600,400,"True",79,686,665,-21,21,1
"C19AS",111,244,"1200x900",800,0,600,400,"False",194,203,114,-89,89,1
"C19AS",112,246,"1200x900",800,0,600,400,"False",196,418,262,-156,156,1
"C19AS",113,28,"1200x900",600,0,600,400,"True",336,410,424,14,14,1
"C19AS",114,515,"1200x900",1000,1,600,400,"False",307,217,302,85,85,0
"C19AS",115,489,"1200x900",1000,0,600,400,"True",88,604,548,-56,56,1
"C19AS",117,300,"1200x900",800,1,600,400,"False",620,693,767,74,74,0
"C19AS",118,549,"1200x900",1000,1,600,400,"False",657,366,539,173,173,0
"C19AS",119,279,"1200x900",800,0,600,400,"True",252,202,257,55,55,1
"C19AS",120,62,"1200x900",600,0,600,400,"True",345,346,372,26,26,1
"C19AS",121,463,"1200x900",1000,0,600,400,"False",115,693,544,-149,149,1
"C19AS",122,616,"1200x900",1000,2,600,400,"False",854,357,654,297,297,1
"C19AS",123,116,"1200x900",600,1,600,400,"False",767,289,622,333,333,0
"C19AS",124,583,"1200x900",1000,2,600,400,"True",949,284,303,19,19,1
"C19AS",125,533,"1200x900",1000,1,600,400,"True",355,483,474,-9,9,0
"C19AS",126,387,"1200x900",800,2,600,400,"False",990,444,277,-167,167,0
"C19AS",127,525,"1200x900",1000,1,600,400,"True",123,690,646,-44,44,0
"C19AS",128,588,"1200x900",1000,2,600,400,"False",585,350,715,365,365,0
"C19AS",129,576,"1200x900",1000,1,600,400,"False",376,713,574,-139,139,0
"C19AS",130,436,"1200x900",1000,0,600,400,"True",82,617,622,5,5,1
"C19AS",131,266,"1200x900",800,0,600,400,"True",126,303,279,-24,24,1
"C19AS",132,385,"1200x900",800,2,600,400,"True",740,456,426,-30,30,0
"C19AS",134,182,"1200x900",600,2,600,400,"True",933,389,352,-37,37,0
"C19AS",135,167,"1200x900",600,2,600,400,"False",956,241,331,90,90,0
"C19AS",136,46,"1200x900",600,0,600,400,"True",193,355,423,68,68,1
"C19AS",137,276,"1200x900",800,0,600,400,"False",281,217,283,66,66,1
"C19AS",138,397,"1200x900",800,2,600,400,"False",817,692,434,-258,258,0
"C19AS",139,497,"1200x900",1000,0,600,400,"True",106,696,635,-61,61,1
"C19AS",140,115,"1200x900",600,1,600,400,"False",545,307,242,-65,65,0
"C19AS",141,25,"1200x900",600,0,600,400,"True",263,403,413,10,10,1
"C19AS",142,226,"1200x900",800,0,600,400,"True",187,229,215,-14,14,1
"C19AS",143,66,"1200x900",600,0,600,400,"True",155,673,657,-16,16,0
"C19AS",144,70,"1200x900",600,0,600,400,"True",309,703,736,33,33,1
"C19AS",145,304,"1200x900",800,1,600,400,"True",667,605,566,-39,39,0
"C19AS",146,257,"1200x900",800,0,600,400,"True",97,219,210,-9,9,1
"C19AS",147,249,"1200x900",800,0,600,400,"True",126,306,283,-23,23,1
"C19AS",148,470,"1200x900",1000,0,600,400,"False",91,666,587,-79,79,1
"C19AS",149,647,"1200x900",1000,2,600,400,"False",560,637,397,-240,240,0
"C19AS",150,619,"1200x900",1000,2,600,400,"False",803,247,481,234,234,0
"C19AS",151,522,"1200x900",1000,1,600,400,"True",223,379,300,-79,79,0
"C19AS",152,354,"1200x900",800,1,600,400,"False",118,236,574,338,338,0
"C19AS",153,322,"1200x900",800,1,600,400,"False",703,206,280,74,74,1
"C19AS",154,344,"1200x900",800,1,600,400,"False",589,408,281,-127,127,0
"C19AS",155,324,"1200x900",800,1,600,400,"False",719,712,596,-116,116,1
"C19AS",156,582,"1200x900",1000,2,600,400,"False",554,347,702,355,355,0
"C19AS",157,534,"1200x900",1000,1,600,400,"False",328,504,330,-174,174,1
"C19AS",158,430,"1200x900",800,2,600,400,"False",922,254,475,221,221,0
"C19AS",159,643,"1200x900",1000,2,600,400,"True",740,325,319,-6,6,0
"C19AS",160,641,"1200x900",1000,2,600,400,"False",897,272,477,205,205,0
"C19AS",161,509,"1200x900",1000,1,600,400,"True",509,434,409,-25,25,0
"C19AS",162,254,"1200x900",800,0,600,400,"True",136,583,593,10,10,1
"C19AS",163,560,"1200x900",1000,1,600,400,"False",516,693,627,-66,66,0
"C19AS",164,452,"1200x900",1000,0,600,400,"False",97,273,473,200,200,1
"C19AS",165,10,"1200x900",600,0,600,400,"True",400,499,474,-25,25,1
"C19AS",166,350,"1200x900",800,1,600,400,"False",182,566,493,-73,73,0
"C19AS",167,284,"1200x900",800,0,600,400,"True",135,293,303,10,10,1
"C19AS",168,132,"1200x900",600,1,600,400,"False",333,185,307,122,122,0
"C19AS",169,579,"1200x900",1000,2,600,400,"False",803,394,641,247,247,0
"C19AS",170,283,"1200x900",800,0,600,400,"True",90,264,303,39,39,1
"C19AS",172,506,"1200x900",1000,1,600,400,"False",559,567,745,178,178,1
"C19AS",173,77,"1200x900",600,1,600,400,"False",780,525,382,-143,143,0
"C19AS",174,443,"1200x900",1000,0,600,400,"True",99,651,649,-2,2,1
"C19AS",175,363,"1200x900",800,2,600,400,"False",800,218,371,153,153,0
"C19AS",176,648,"1200x900",1000,2,600,400,"True",557,394,440,46,46,0
"C19AS",177,602,"1200x900",1000,2,600,400,"False",865,452,257,-195,195,0
"C19AS",178,20,"1200x900",600,0,600,400,"True",204,545,560,15,15,1
"C19AS",179,345,"1200x900",800,1,600,400,"True",841,566,597,31,31,1
"C19AS",180,253,"1200x900",800,0,600,400,"True",177,424,356,-68,68,1
"C19AS",181,13,"1200x900",600,0,600,400,"False",296,211,270,59,59,1
"C19AS",182,126,"1200x900",600,1,600,400,"True",849,354,424,70,70,0
"C19AS",183,543,"1200x900",1000,1,600,400,"True",88,202,234,32,32,0
"C19AS",184,209,"1200x900",600,2,600,400,"True",937,637,660,23,23,0
"C19AS",185,63,"1200x900",600,0,600,400,"True",311,188,157,-31,31,1
"C19AS",186,435,"1200x900",1000,0,600,400,"True",119,200,137,-63,63,1
"C19AS",187,412,"1200x900",800,2,600,400,"True",842,280,328,48,48,0
"C19AS",188,235,"1200x900",800,0,600,400,"True",146,646,595,-51,51,1
"C19AS",189,464,"1200x900",1000,0,600,400,"False",82,222,288,66,66,1
"C19AS",191,281,"1200x900",800,0,600,400,"True",112,611,670,59,59,1
"C19AS",192,510,"1200x900",1000,1,600,400,"False",486,338,654,316,316,1
"C19AS",193,422,"1200x900",800,2,600,400,"True",712,558,482,-76,76,0
"C19AS",194,376,"1200x900",800,2,600,400,"True",788,275,307,32,32,0
"C19AS",195,112,"1200x900",600,1,600,400,"False",681,490,382,-108,108,0
"C19AS",196,164,"1200x900",600,2,600,400,"False",1051,268,96,-172,172,0
"C19AS",197,236,"1200x900",800,0,600,400,"True",162,350,409,59,59,1
"C19AS",198,600,"1200x900",1000,2,600,400,"False",765,207,352,145,145,0
"C19AS",200,496,"1200x900",1000,0,600,400,"True",70,639,675,36,36,1
"C19AS",201,601,"1200x900",1000,2,600,400,"False",735,697,428,-269,269,0
"C19AS",202,45,"1200x900",600,0,600,400,"True",487,678,619,-59,59,1
"C19AS",203,136,"1200x900",600,1,600,400,"False",264,205,445,240,240,0
"C19AS",204,314,"1200x900",800,1,600,400,"False",277,616,339,-277,277,1
"C19AS",205,574,"1200x900",1000,1,600,400,"True",614,194,234,40,40,0
"C19AS",206,59,"1200x900",600,0,600,400,"True",391,692,693,1,1,1
"C19AS",207,109,"1200x900",600,1,600,400,"True",691,589,527,-62,62,0
"C19AS",208,230,"1200x900",800,0,600,400,"True",99,678,657,-21,21,1
"C19AS",209,303,"1200x900",800,1,600,400,"True",241,431,416,-15,15,0
"C19AS",210,44,"1200x900",600,0,600,400,"True",305,554,586,32,32,1
"C19AS",211,165,"1200x900",600,2,600,400,"False",912,554,323,-231,231,0
"C19AS",212,492,"1200x900",1000,0,600,400,"False",76,692,549,-143,143,1
"C19AS",213,278,"1200x900",800,0,600,400,"True",251,711,688,-23,23,1
"C19AS",214,213,"1200x900",600,2,600,400,"True",822,275,281,6,6,0
"C19AS",215,309,"1200x900",800,1,600,400,"True",186,225,130,-95,95,0
"C19AS",216,67,"1200x900",600,0,600,400,"False",289,308,232,-76,76,1
"C19AS",217,29,"1200x900",600,0,600,400,"True",385,533,509,-24,24,1
"C19AS",218,35,"1200x900",600,0,600,400,"True",366,555,495,-60,60,1
"C19AS",219,453,"1200x900",1000,0,600,400,"True",71,393,424,31,31,1
"C19AS",220,355,"1200x900",800,1,600,400,"True",77,386,358,-28,28,0
"C19AS",221,441,"1200x900",1000,0,600,400,"False",85,684,591,-93,93,1
"C19AS",223,612,"1200x900",1000,2,600,400,"False",706,198,406,208,208,0
"C19AS",224,630,"1200x900",1000,2,600,400,"False",754,559,249,-310,310,0
"C19AS",225,631,"1200x900",1000,2,600,400,"False",699,479,606,127,127,0
"C19AS",226,382,"1200x900",800,2,600,400,"False",870,523,712,189,189,0
"C19AS",227,110,"1200x900",600,1,600,400,"False",776,550,374,-176,176,1
"C19AS",230,580,"1200x900",1000,2,600,400,"True",651,267,320,53,53,0
"C19AS",231,511,"1200x900",1000,1,600,400,"False",408,390,494,104,104,1
"C19AS",232,474,"1200x900",1000,0,600,400,"True",85,339,339,0,0,1
"C19AS",233,513,"1200x900",1000,1,600,400,"False",235,602,481,-121,121,0
"C19AS",234,106,"1200x900",600,1,600,400,"True",803,659,664,5,5,1
"C19AS",235,468,"1200x900",1000,0,600,400,"True",121,219,261,42,42,1
"C19AS",236,256,"1200x900",800,0,600,400,"False",192,656,525,-131,131,1
"C19AS",237,90,"1200x900",600,1,600,400,"False",560,474,282,-192,192,0
"C19AS",238,310,"1200x900",800,1,600,400,"True",559,592,626,34,34,0
"C19AS",239,334,"1200x900",800,1,600,400,"True",481,665,595,-70,70,0
"C19AS",240,531,"1200x900",1000,1,600,400,"False",233,362,493,131,131,0
"C19AS",241,502,"1200x900",1000,0,600,400,"True",111,639,600,-39,39,1
"C19AS",242,111,"1200x900",600,1,600,400,"True",922,552,623,71,71,1
"C19AS",243,172,"1200x900",600,2,600,400,"False",912,444,224,-220,220,0
"C19AS",244,52,"1200x900",600,0,600,400,"True",171,188,182,-6,6,0
"C19AS",246,122,"1200x900",600,1,600,400,"False",817,709,573,-136,136,0
"C19AS",247,34,"1200x900",600,0,600,400,"True",361,242,294,52,52,1
"C19AS",248,432,"1200x900",800,2,600,400,"False",792,380,277,-103,103,0
"C19AS",249,99,"1200x900",600,1,600,400,"True",811,407,435,28,28,0
"C19AS",250,581,"1200x900",1000,2,600,400,"True",310,357,425,68,68,0
"C19AS",251,337,"1200x900",800,1,600,400,"False",299,622,371,-251,251,0
"C19AS",252,626,"1200x900",1000,2,600,400,"False",329,449,533,84,84,0
"C19AS",253,396,"1200x900",800,2,600,400,"False",678,663,436,-227,227,0
"C19AS",255,472,"1200x900",1000,0,600,400,"True",77,685,681,-4,4,1
"C19AS",256,346,"1200x900",800,1,600,400,"False",269,635,463,-172,172,0
"C19AS",257,530,"1200x900",1000,1,600,400,"True",584,405,475,70,70,1
"C19AS",258,87,"1200x900",600,1,600,400,"False",231,604,381,-223,223,0
"C19AS",259,162,"1200x900",600,2,600,400,"True",849,279,333,54,54,0
"C19AS",260,458,"1200x900",1000,0,600,400,"True",78,624,622,-2,2,1
"C19AS",261,131,"1200x900",600,1,600,400,"True",531,367,267,-100,100,0
"C19AS",262,285,"1200x900",800,0,600,400,"True",237,396,363,-33,33,1
"C19AS",263,47,"1200x900",600,0,600,400,"True",303,499,520,21,21,1
"C19AS",264,505,"1200x900",1000,1,600,400,"True",191,484,456,-28,28,1
"C19AS",265,454,"1200x900",1000,0,600,400,"True",78,687,662,-25,25,1
"C19AS",266,634,"1200x900",1000,2,600,400,"False",735,313,435,122,122,0
"C19AS",267,247,"1200x900",800,0,600,400,"True",160,424,422,-2,2,1
"C19AS",268,78,"1200x900",600,1,600,400,"True",885,684,685,1,1,0
"C19AS",269,374,"1200x900",800,2,600,400,"False",755,450,549,99,99,0
"C19AS",270,388,"1200x900",800,2,600,400,"False",930,320,544,224,224,0
"C19AS",271,86,"1200x900",600,1,600,400,"False",692,388,492,104,104,1
"C19AS",272,556,"1200x900",1000,1,600,400,"False",415,420,605,185,185,0
"C19AS",273,250,"1200x900",800,0,600,400,"True",290,248,265,17,17,1
"C19AS",274,146,"1200x900",600,2,600,400,"False",989,492,397,-95,95,0
"C19AS",275,186,"1200x900",600,2,600,400,"False",997,197,346,149,149,0
"C19AS",276,189,"1200x900",600,2,600,400,"False",881,397,522,125,125,0
"C19AS",277,424,"1200x900",800,2,600,400,"False",903,545,417,-128,128,0
"C19AS",278,550,"1200x900",1000,1,600,400,"False",301,459,652,193,193,0
"C19AS",279,339,"1200x900",800,1,600,400,"False",273,545,437,-108,108,1
"C19AS",280,30,"1200x900",600,0,600,400,"True",107,353,352,-1,1,0
"C19AS",281,624,"1200x900",1000,2,600,400,"False",693,501,219,-282,282,0
"C19AS",282,623,"1200x900",1000,2,600,400,"False",636,527,329,-198,198,0
"C19AS",283,124,"1200x900",600,1,600,400,"True",345,467,441,-26,26,0
"C19AS",284,191,"1200x900",600,2,600,400,"True",962,396,400,4,4,0
"C19AS",285,379,"1200x900",800,2,600,400,"False",994,325,469,144,144,0
"C19AS",286,603,"1200x900",1000,2,600,400,"False",693,280,366,86,86,0
"C19AS",289,572,"1200x900",1000,1,600,400,"True",302,260,206,-54,54,0
"C19AS",290,153,"1200x900",600,2,600,400,"True",1037,601,615,14,14,0
"C19AS",291,526,"1200x900",1000,1,600,400,"False",497,710,307,-403,403,0
"C19AS",292,461,"1200x900",1000,0,600,400,"True",95,711,658,-53,53,1
"C19AS",294,214,"1200x900",600,2,600,400,"False",1046,305,102,-203,203,0
"C19AS",295,466,"1200x900",1000,0,600,400,"False",82,205,120,-85,85,1
"C19AS",296,76,"1200x900",600,1,600,400,"False",647,614,191,-423,423,0
"C19AS",297,49,"1200x900",600,0,600,400,"True",109,380,330,-50,50,0
"C19AS",298,123,"1200x900",600,1,600,400,"True",761,365,418,53,53,1
"C19AS",299,69,"1200x900",600,0,600,400,"False",322,268,166,-102,102,0
"C19AS",300,181,"1200x900",600,2,600,400,"True",1018,223,206,-17,17,0
"C19AS",301,315,"1200x900",800,1,600,400,"False",105,211,361,150,150,0
"C19AS",302,586,"1200x900",1000,2,600,400,"False",802,262,384,122,122,0
"C19AS",303,105,"1200x900",600,1,600,400,"False",527,440,610,170,170,0
"C19AS",304,158,"1200x900",600,2,600,400,"False",939,300,411,111,111,0
"C19AS",306,177,"1200x900",600,2,600,400,"True",912,236,255,19,19,0
"C19AS",307,269,"1200x900",800,0,600,400,"True",160,295,280,-15,15,1
"C19AS",308,275,"1200x900",800,0,600,400,"True",120,594,603,9,9,0
"C19AS",309,552,"1200x900",1000,1,600,400,"True",255,412,431,19,19,0
"C19AS",311,411,"1200x900",800,2,600,400,"False",805,361,545,184,184,0
"C19AS",312,218,"1200x900",800,0,600,400,"True",106,397,378,-19,19,1
"C19AS",313,439,"1200x900",1000,0,600,400,"True",110,229,163,-66,66,1
"C19AS",314,362,"1200x900",800,2,600,400,"False",819,338,481,143,143,0
"C19AS",315,225,"1200x900",800,0,600,400,"True",178,423,382,-41,41,1
"C19AS",316,427,"1200x900",800,2,600,400,"True",812,380,377,-3,3,0
"C19AS",317,36,"1200x900",600,0,600,400,"True",128,346,345,-1,1,1
"C19AS",318,518,"1200x900",1000,1,600,400,"False",583,717,609,-108,108,0
"C19AS",319,503,"1200x900",1000,0,600,400,"False",86,279,449,170,170,1
"C19AS",320,460,"1200x900",1000,0,600,400,"False",155,189,381,192,192,1
"C19AS",322,130,"1200x900",600,1,600,400,"True",741,428,461,33,33,0
"C19AS",323,519,"1200x900",1000,1,600,400,"True",319,565,512,-53,53,1
"C19AS",324,248,"1200x900",800,0,600,400,"False",94,240,349,109,109,1
"C19AS",326,384,"1200x900",800,2,600,400,"False",821,707,451,-256,256,0
"C19AS",327,401,"1200x900",800,2,600,400,"True",821,260,287,27,27,0
"C19AS",328,611,"1200x900",1000,2,600,400,"True",414,511,455,-56,56,0
"C19AS",329,544,"1200x900",1000,1,600,400,"True",602,620,665,45,45,0
"C19AS",330,462,"1200x900",1000,0,600,400,"True",102,672,676,4,4,1
"C19AS",331,479,"1200x900",1000,0,600,400,"True",74,705,696,-9,9,1
"C19AS",332,40,"1200x900",600,0,600,400,"True",143,513,556,43,43,0
"C19AS",333,438,"1200x900",1000,0,600,400,"True",77,713,671,-42,42,1
"C19AS",334,200,"1200x900",600,2,600,400,"True",897,302,319,17,17,0
"C19AS",335,255,"1200x900",800,0,600,400,"False",93,709,624,-85,85,1
"C19AS",336,188,"1200x900",600,2,600,400,"True",900,195,240,45,45,0
"C19AS",337,360,"1200x900",800,1,600,400,"False",203,608,393,-215,215,0
"C19AS",338,71,"1200x900",600,0,600,400,"False",219,248,321,73,73,0
"C19AS",339,298,"1200x900",800,1,600,400,"True",311,457,454,-3,3,0
"C19AS",340,296,"1200x900",800,1,600,400,"False",89,279,505,226,226,0
"C19AS",341,264,"1200x900",800,0,600,400,"True",198,660,631,-29,29,1
"C19AS",342,80,"1200x900",600,1,600,400,"False",616,423,546,123,123,1
"C19AS",343,61,"1200x900",600,0,600,400,"True",272,670,743,73,73,1
"C19AS",344,587,"1200x900",1000,2,600,400,"False",741,686,449,-237,237,0
"C19AS",345,31,"1200x900",600,0,600,400,"True",365,338,363,25,25,1
"C19AS",347,567,"1200x900",1000,1,600,400,"False",655,297,773,476,476,1
"C19AS",348,58,"1200x900",600,0,600,400,"True",353,655,618,-37,37,1
"C19AS",349,477,"1200x900",1000,0,600,400,"True",88,640,677,37,37,1
"C19AS",350,569,"1200x900",1000,1,600,400,"False",494,720,657,-63,63,0
"C19AS",351,14,"1200x900",600,0,600,400,"True",399,224,237,13,13,1
"C19AS",352,187,"1200x900",600,2,600,400,"False",857,639,479,-160,160,0
"C19AS",353,114,"1200x900",600,1,600,400,"True",183,697,698,1,1,0
"C19AS",354,498,"1200x900",1000,0,600,400,"False",100,260,497,237,237,1
"C19AS",355,316,"1200x900",800,1,600,400,"False",362,319,471,152,152,0
"C19AS",356,542,"1200x900",1000,1,600,400,"False",304,401,607,206,206,0
"C19AS",357,8,"1200x900",600,0,600,400,"True",156,679,623,-56,56,0
"C19AS",359,95,"1200x900",600,1,600,400,"True",749,425,484,59,59,1
"C19AS",361,442,"1200x900",1000,0,600,400,"False",87,183,291,108,108,1
"C19AS",362,428,"1200x900",800,2,600,400,"False",732,665,498,-167,167,0
"C19AS",363,273,"1200x900",800,0,600,400,"False",180,309,454,145,145,1
"C19AS",364,37,"1200x900",600,0,600,400,"True",258,403,441,38,38,1
"C19AS",365,166,"1200x900",600,2,600,400,"True",896,274,270,-4,4,0
"C19AS",366,68,"1200x900",600,0,600,400,"True",165,367,350,-17,17,0
"C19AS",367,584,"1200x900",1000,2,600,400,"True",731,413,408,-5,5,0
"C19AS",369,211,"1200x900",600,2,600,400,"False",986,407,319,-88,88,0
"C19AS",370,481,"1200x900",1000,0,600,400,"True",80,185,241,56,56,1
"C19AS",371,139,"1200x900",600,1,600,400,"False",192,695,430,-265,265,0
"C19AS",372,198,"1200x900",600,2,600,400,"True",976,500,525,25,25,0
"C19AS",373,367,"1200x900",800,2,600,400,"True",613,464,427,-37,37,0
"C19AS",374,605,"1200x900",1000,2,600,400,"False",493,665,471,-194,194,0
"C19AS",375,313,"1200x900",800,1,600,400,"True",588,421,448,27,27,0
"C19AS",376,491,"1200x900",1000,0,600,400,"False",108,198,305,107,107,1
"C19AS",377,562,"1200x900",1000,1,600,400,"False",347,540,412,-128,128,0
"C19AS",378,555,"1200x900",1000,1,600,400,"False",444,556,477,-79,79,0
"C19AS",379,341,"1200x900",800,1,600,400,"True",735,632,587,-45,45,1
"C19AS",380,338,"1200x900",800,1,600,400,"False",813,253,416,163,163,1
"C19AS",382,33,"1200x900",600,0,600,400,"True",198,533,540,7,7,1
"C19AS",383,227,"1200x900",800,0,600,400,"True",196,551,533,-18,18,1
"C19AS",384,202,"1200x900",600,2,600,400,"True",966,460,447,-13,13,0
"C19AS",386,570,"1200x900",1000,1,600,400,"False",315,352,578,226,226,0
"C19AS",387,302,"1200x900",800,1,600,400,"True",479,467,480,13,13,1
"C19AS",389,577,"1200x900",1000,2,600,400,"False",455,420,550,130,130,0
"C19AS",390,41,"1200x900",600,0,600,400,"True",370,452,514,62,62,1
"C19AS",392,317,"1200x900",800,1,600,400,"True",185,564,564,0,0,0
"C19AS",394,366,"1200x900",800,2,600,400,"False",931,464,210,-254,254,0
"C19AS",395,575,"1200x900",1000,1,600,400,"False",272,693,409,-284,284,0
"C19AS",396,171,"1200x900",600,2,600,400,"False",909,200,403,203,203,0
"C19AS",397,598,"1200x900",1000,2,600,400,"False",706,559,410,-149,149,0
"C19AS",398,578,"1200x900",1000,2,600,400,"False",966,276,722,446,446,0
"C19AS",399,381,"1200x900",800,2,600,400,"True",705,408,468,60,60,0
"C19AS",400,504,"1200x900",1000,0,600,400,"True",107,699,677,-22,22,1
"C19AS",401,557,"1200x900",1000,1,600,400,"False",677,505,580,75,75,1
"C19AS",402,520,"1200x900",1000,1,600,400,"False",564,260,444,184,184,0
"C19AS",403,234,"1200x900",800,0,600,400,"True",72,344,323,-21,21,1
"C19AS",404,487,"1200x900",1000,0,600,400,"True",78,670,616,-54,54,1
"C19AS",405,591,"1200x900",1000,2,600,400,"False",698,336,594,258,258,0
"C19AS",406,289,"1200x900",800,1,600,400,"False",421,703,496,-207,207,1
"C19AS",407,490,"1200x900",1000,0,600,400,"False",114,183,327,144,144,1
"C19AS",408,168,"1200x900",600,2,600,400,"True",1001,439,383,-56,56,0
"C19AS",409,595,"1200x900",1000,2,600,400,"False",687,640,494,-146,146,0
"C19AS",410,332,"1200x900",800,1,600,400,"False",260,699,505,-194,194,0
"C19AS",411,405,"1200x900",800,2,600,400,"False",790,307,395,88,88,0
"C19AS",412,465,"1200x900",1000,0,600,400,"False",85,203,292,89,89,1
"C19AS",413,53,"1200x900",600,0,600,400,"True",177,189,250,61,61,0
"C19AS",414,429,"1200x900",800,2,600,400,"False",682,692,391,-301,301,0
"C19AS",415,251,"1200x900",800,0,600,400,"True",88,352,350,-2,2,1
"C19AS",416,639,"1200x900",1000,2,600,400,"False",504,456,339,-117,117,0
"C19AS",418,330,"1200x900",800,1,600,400,"False",759,301,584,283,283,1
"C19AS",419,23,"1200x900",600,0,600,400,"True",308,463,514,51,51,1
"C19AS",421,3,"1200x900",600,0,600,400,"True",298,443,474,31,31,1
"C19AS",422,24,"1200x900",600,0,600,400,"True",430,538,558,20,20,1
"C19AS",423,222,"1200x900",800,0,600,400,"True",152,206,261,55,55,1
"C19AS",424,404,"1200x900",800,2,600,400,"True",842,396,476,80,80,0
"C19AS",425,425,"1200x900",800,2,600,400,"True",621,438,405,-33,33,0
"C19AS",426,196,"1200x900",600,2,600,400,"False",1030,397,301,-96,96,0
"C19AS",427,545,"1200x900",1000,1,600,400,"True",358,562,553,-9,9,0
"C19AS",428,326,"1200x900",800,1,600,400,"True",103,482,455,-27,27,0
"C19AS",429,445,"1200x900",1000,0,600,400,"False",78,302,374,72,72,1
"C19AS",430,618,"1200x900",1000,2,600,400,"False",276,671,484,-187,187,0
"C19AS",431,12,"1200x900",600,0,600,400,"False",365,336,414,78,78,1
"C19AS",432,478,"1200x900",1000,0,600,400,"False",79,672,587,-85,85,1
"C19AS",433,97,"1200x900",600,1,600,400,"True",760,643,601,-42,42,1
"C19AS",434,608,"1200x900",1000,2,600,400,"False",742,250,495,245,245,0
"C19AS",435,433,"1200x900",1000,0,600,400,"False",76,222,295,73,73,1
"C19AS",436,221,"1200x900",800,0,600,400,"True",132,520,533,13,13,1
"C19AS",437,241,"1200x900",800,0,600,400,"True",129,227,267,40,40,1
"C19AS",438,370,"1200x900",800,2,600,400,"True",874,336,349,13,13,0
"C19AS",439,219,"1200x900",800,0,600,400,"False",202,502,409,-93,93,1
"C19AS",440,596,"1200x900",1000,2,600,400,"True",706,513,519,6,6,0
"C19AS",441,394,"1200x900",800,2,600,400,"False",847,292,401,109,109,0
"C19AS",442,456,"1200x900",1000,0,600,400,"True",91,257,299,42,42,1
"C19AS",443,597,"1200x900",1000,2,600,400,"False",352,239,490,251,251,0
"C19AS",444,467,"1200x900",1000,0,600,400,"False",74,712,630,-82,82,1
"C19AS",445,573,"1200x900",1000,1,600,400,"True",486,615,636,21,21,0
"C19AS",446,514,"1200x900",1000,1,600,400,"True",539,690,647,-43,43,0
"C19AS",447,100,"1200x900",600,1,600,400,"True",453,511,589,78,78,0
"C19AS",448,606,"1200x900",1000,2,600,400,"True",653,627,568,-59,59,0
"C19AS",449,563,"1200x900",1000,1,600,400,"False",201,696,595,-101,101,0
"C19AS",450,57,"1200x900",600,0,600,400,"True",354,508,533,25,25,1
"C19AS",454,554,"1200x900",1000,1,600,400,"False",79,309,516,207,207,1
"C19AS",455,380,"1200x900",800,2,600,400,"True",942,228,242,14,14,0
"C19AS",456,11,"1200x900",600,0,600,400,"True",372,670,718,48,48,1
"C19AS",457,7,"1200x900",600,0,600,400,"False",431,654,585,-69,69,1
"C19AS",458,391,"1200x900",800,2,600,400,"True",895,521,481,-40,40,0
"C19AS",459,173,"1200x900",600,2,600,400,"False",948,693,552,-141,141,0
"C19AS",460,499,"1200x900",1000,0,600,400,"True",93,271,318,47,47,1
"C19AS",461,437,"1200x900",1000,0,600,400,"True",74,667,651,-16,16,1
"C19AS",462,18,"1200x900",600,0,600,400,"True",400,318,309,-9,9,1
"C19AS",463,637,"1200x900",1000,2,600,400,"True",750,460,415,-45,45,0
"C19AS",464,446,"1200x900",1000,0,600,400,"True",72,298,323,25,25,1
"C19AS",465,604,"1200x900",1000,2,600,400,"False",459,593,518,-75,75,0
"C19AS",467,282,"1200x900",800,0,600,400,"True",109,246,292,46,46,1
"C19AS",468,195,"1200x900",600,2,600,400,"True",942,249,218,-31,31,0
"C19AS",469,471,"1200x900",1000,0,600,400,"True",122,200,206,6,6,1
"C19AS",470,419,"1200x900",800,2,600,400,"True",769,351,397,46,46,0
"C19AS",471,423,"1200x900",800,2,600,400,"False",1051,710,536,-174,174,1
"C19AS",473,483,"1200x900",1000,0,600,400,"True",93,191,213,22,22,1
"C19AS",474,127,"1200x900",600,1,600,400,"False",309,691,425,-266,266,0
"C19AS",475,565,"1200x900",1000,1,600,400,"False",451,562,477,-85,85,0
"C19AS",476,194,"1200x900",600,2,600,400,"False",896,236,441,205,205,0
"C19AS",477,60,"1200x900",600,0,600,400,"True",365,213,239,26,26,1
"C19AS",478,228,"1200x900",800,0,600,400,"True",174,687,745,58,58,1
"C19AS",479,48,"1200x900",600,0,600,400,"True",323,645,705,60,60,1
"C19AS",480,320,"1200x900",800,1,600,400,"False",644,376,618,242,242,0
"C19AS",481,615,"1200x900",1000,2,600,400,"False",736,634,376,-258,258,0
"C19AS",482,414,"1200x900",800,2,600,400,"True",831,592,525,-67,67,0
"C19AS",483,558,"1200x900",1000,1,600,400,"False",72,464,676,212,212,1
"C19AS",484,508,"1200x900",1000,1,600,400,"False",596,485,616,131,131,0
"C19AS",485,149,"1200x900",600,2,600,400,"True",890,289,331,42,42,0
"C19AS",486,627,"1200x900",1000,2,600,400,"False",760,510,407,-103,103,0
"C19AS",487,484,"1200x900",1000,0,600,400,"True",100,223,241,18,18,1
"C19AS",489,607,"1200x900",1000,2,600,400,"True",900,573,515,-58,58,1
"C19AS",490,523,"1200x900",1000,1,600,400,"False",339,318,546,228,228,0
"C19AS",491,210,"1200x900",600,2,600,400,"True",835,506,513,7,7,0
"C19AS",492,417,"1200x900",800,2,600,400,"False",750,280,404,124,124,0
"C19AS",493,197,"1200x900",600,2,600,400,"False",903,212,487,275,275,0
"C19AS",494,457,"1200x900",1000,0,600,400,"True",97,630,638,8,8,1
"C19AS",495,204,"1200x900",600,2,600,400,"False",1053,432,354,-78,78,0
"C19AS",497,65,"1200x900",600,0,600,400,"True",442,645,642,-3,3,1
"C19AS",499,399,"1200x900",800,2,600,400,"False",603,602,505,-97,97,0
"C19AS",500,638,"1200x900",1000,2,600,400,"False",385,198,538,340,340,0
"C19AS",501,291,"1200x900",800,1,600,400,"True",522,694,699,5,5,0
"C19AS",502,163,"1200x900",600,2,600,400,"False",1046,665,775,110,110,0
"C19AS",503,113,"1200x900",600,1,600,400,"False",897,657,742,85,85,0
"C19AS",504,217,"1200x900",800,0,600,400,"True",85,573,646,73,73,1
"C19AS",506,297,"1200x900",800,1,600,400,"False",625,244,500,256,256,0
"C19AS",507,538,"1200x900",1000,1,600,400,"True",308,457,440,-17,17,1
"C19AS",508,327,"1200x900",800,1,600,400,"False",152,339,533,194,194,0
"C19AS",509,392,"1200x900",800,2,600,400,"False",1031,618,677,59,59,0
"C19AS",510,351,"1200x900",800,1,600,400,"False",122,581,390,-191,191,0
"C19AS",511,169,"1200x900",600,2,600,400,"False",924,290,403,113,113,0
"C19AS",512,142,"1200x900",600,1,600,400,"False",286,474,364,-110,110,0
"C19AS",513,292,"1200x900",800,1,600,400,"False",88,565,332,-233,233,0
"C19AS",514,375,"1200x900",800,2,600,400,"True",716,384,414,30,30,0
"C19AS",515,223,"1200x900",800,0,600,400,"True",179,191,214,23,23,1
"C19AS",516,485,"1200x900",1000,0,600,400,"False",121,694,608,-86,86,1
"C19AS",517,321,"1200x900",800,1,600,400,"False",601,190,368,178,178,0
"C19AS",518,372,"1200x900",800,2,600,400,"False",833,620,465,-155,155,0
"C19AS",519,450,"1200x900",1000,0,600,400,"True",130,204,251,47,47,1
"C19AS",520,161,"1200x900",600,2,600,400,"False",939,553,375,-178,178,0
"C19AS",521,512,"1200x900",1000,1,600,400,"False",139,261,168,-93,93,0
"C19AS",522,151,"1200x900",600,2,600,400,"True",828,680,702,22,22,0
"C19AS",523,201,"1200x900",600,2,600,400,"False",1005,462,250,-212,212,0
"C19AS",524,108,"1200x900",600,1,600,400,"False",830,239,321,82,82,0
"C19AS",525,389,"1200x900",800,2,600,400,"False",843,530,405,-125,125,0
"C19AS",527,328,"1200x900",800,1,600,400,"False",104,649,510,-139,139,0
"C19AS",528,208,"1200x900",600,2,600,400,"False",946,399,259,-140,140,0
"C19AS",529,373,"1200x900",800,2,600,400,"True",694,326,399,73,73,0
"C19AS",530,75,"1200x900",600,1,600,400,"True",635,558,505,-53,53,0
"C19AS",531,232,"1200x900",800,0,600,400,"False",84,511,610,99,99,1
"C19AS",533,352,"1200x900",800,1,600,400,"False",235,717,466,-251,251,0
"C19AS",534,4,"1200x900",600,0,600,400,"False",602,200,339,139,139,1
"C19AS",535,271,"1200x900",800,0,600,400,"True",74,360,367,7,7,1
"C19AS",536,180,"1200x900",600,2,600,400,"True",929,270,253,-17,17,0
"C19AS",537,293,"1200x900",800,1,600,400,"False",561,396,305,-91,91,0
"C19AS",539,476,"1200x900",1000,0,600,400,"True",76,359,313,-46,46,1
"C19AS",540,159,"1200x900",600,2,600,400,"False",992,309,173,-136,136,0
"C19AS",541,274,"1200x900",800,0,600,400,"False",146,497,714,217,217,1
"C19AS",542,17,"1200x900",600,0,600,400,"True",402,496,455,-41,41,1
"C19AS",543,386,"1200x900",800,2,600,400,"True",774,301,370,69,69,0
"C19AS",544,528,"1200x900",1000,1,600,400,"False",839,227,510,283,283,1
"C19AS",545,39,"1200x900",600,0,600,400,"False",210,609,497,-112,112,0
"C19AS",546,19,"1200x900",600,0,600,400,"True",286,686,704,18,18,0
"C19AS",547,239,"1200x900",800,0,600,400,"True",114,231,178,-53,53,1
"C19AS",548,390,"1200x900",800,2,600,400,"True",982,674,655,-19,19,1
"C19AS",549,43,"1200x900",600,0,600,400,"True",277,446,479,33,33,1
"C19AS",550,589,"1200x900",1000,2,600,400,"False",856,418,285,-133,133,0
"C19AS",551,617,"1200x900",1000,2,600,400,"False",294,180,609,429,429,0
"C19AS",552,176,"1200x900",600,2,600,400,"True",1033,281,316,35,35,0
"C19AS",555,120,"1200x900",600,1,600,400,"False",690,655,456,-199,199,0
"C19AS",556,349,"1200x900",800,1,600,400,"False",402,665,559,-106,106,0
"C19AS",557,564,"1200x900",1000,1,600,400,"False",215,264,502,238,238,0
"C19AS",558,507,"1200x900",1000,1,600,400,"True",608,583,539,-44,44,1
"C19AS",559,377,"1200x900",800,2,600,400,"False",683,388,288,-100,100,0
"C19AS",560,592,"1200x900",1000,2,600,400,"False",492,392,539,147,147,0
"C19AS",561,215,"1200x900",600,2,600,400,"False",939,596,336,-260,260,0
"C19AS",562,243,"1200x900",800,0,600,400,"True",114,332,335,3,3,1
"C19AS",563,107,"1200x900",600,1,600,400,"False",878,678,480,-198,198,0
"C19AS",564,152,"1200x900",600,2,600,400,"False",971,399,314,-85,85,0
"C19AS",566,129,"1200x900",600,1,600,400,"True",859,482,441,-41,41,1
"C19AS",567,440,"1200x900",1000,0,600,400,"False",71,237,114,-123,123,1
"C19AS",568,646,"1200x900",1000,2,600,400,"False",829,227,446,219,219,1
"C19AS",569,633,"1200x900",1000,2,600,400,"False",564,253,324,71,71,0
"C19AS",570,102,"1200x900",600,1,600,400,"True",861,603,651,48,48,0
"C19AS",572,529,"1200x900",1000,1,600,400,"True",267,412,491,79,79,1
"C19AS",573,358,"1200x900",800,1,600,400,"False",263,635,462,-173,173,0
"C19AS",574,233,"1200x900",800,0,600,400,"True",164,700,671,-29,29,1
"C19AS",575,183,"1200x900",600,2,600,400,"False",927,289,206,-83,83,0
"C19AS",576,137,"1200x900",600,1,600,400,"False",789,577,391,-186,186,0
"C19AS",577,449,"1200x900",1000,0,600,400,"True",105,683,623,-60,60,1
"C19AS",579,347,"1200x900",800,1,600,400,"True",757,295,214,-81,81,1
"C19AS",580,175,"1200x900",600,2,600,400,"True",1028,432,511,79,79,0
"C19AS",581,415,"1200x900",800,2,600,400,"False",823,684,191,-493,493,0
"C19AS",583,486,"1200x900",1000,0,600,400,"True",102,676,660,-16,16,1
"C19AS",584,79,"1200x900",600,1,600,400,"True",731,289,280,-9,9,0
"C19AS",585,410,"1200x900",800,2,600,400,"False",916,477,391,-86,86,0
"C19AS",586,622,"1200x900",1000,2,600,400,"False",307,683,110,-573,573,0
"C19AS",587,331,"1200x900",800,1,600,400,"False",240,620,717,97,97,0
"C19AS",588,265,"1200x900",800,0,600,400,"True",229,353,384,31,31,1
"C19AS",589,348,"1200x900",800,1,600,400,"True",764,294,311,17,17,0
"C19AS",590,50,"1200x900",600,0,600,400,"False",75,582,514,-68,68,0
"C19AS",591,407,"1200x900",800,2,600,400,"True",989,340,325,-15,15,0
"C19AS",592,495,"1200x900",1000,0,600,400,"True",93,692,737,45,45,1
"C19AS",593,469,"1200x900",1000,0,600,400,"False",73,227,298,71,71,1
"C19AS",594,383,"1200x900",800,2,600,400,"False",855,407,219,-188,188,0
"C19AS",595,160,"1200x900",600,2,600,400,"False",863,606,419,-187,187,0
"C19AS",596,121,"1200x900",600,1,600,400,"False",884,364,664,300,300,0
"C19AS",597,400,"1200x900",800,2,600,400,"False",733,297,441,144,144,0
"C19AS",598,566,"1200x900",1000,1,600,400,"True",378,472,524,52,52,1
"C19AS",599,288,"1200x900",800,0,600,400,"True",180,547,545,-2,2,1
"C19AS",600,301,"1200x900",800,1,600,400,"False",162,574,414,-160,160,0
"C19AS",601,539,"1200x900",1000,1,600,400,"False",510,383,470,87,87,0
"C19AS",602,319,"1200x900",800,1,600,400,"False",494,587,374,-213,213,1
"C19AS",604,267,"1200x900",800,0,600,400,"True",145,665,648,-17,17,1
"C19AS",605,535,"1200x900",1000,1,600,400,"False",372,410,489,79,79,0
"C19AS",606,88,"1200x900",600,1,600,400,"False",186,554,406,-148,148,0
"C19AS",607,409,"1200x900",800,2,600,400,"True",501,659,594,-65,65,0
"C19AS",608,290,"1200x900",800,1,600,400,"False",789,603,772,169,169,0
"C19AS",609,242,"1200x900",800,0,600,400,"False",117,448,532,84,84,1
"C19AS",612,259,"1200x900",800,0,600,400,"False",156,180,278,98,98,1
"C19AS",613,141,"1200x900",600,1,600,400,"True",671,582,619,37,37,0
"C19AS",614,594,"1200x900",1000,2,600,400,"False",537,637,250,-387,387,0
"C19AS",615,364,"1200x900",800,2,600,400,"False",1018,204,420,216,216,0
"C19AS",616,178,"1200x900",600,2,600,400,"True",1041,510,502,-8,8,0
"C19AS",617,312,"1200x900",800,1,600,400,"False",238,683,362,-321,321,0
"C19AS",618,96,"1200x900",600,1,600,400,"False",433,458,671,213,213,0
"C19AS",620,92,"1200x900",600,1,600,400,"False",624,605,387,-218,218,0
"C19AS",621,318,"1200x900",800,1,600,400,"False",788,534,302,-232,232,0
"C19AS",623,51,"1200x900",600,0,600,400,"True",272,181,235,54,54,1
"C19AS",624,357,"1200x900",800,1,600,400,"False",109,594,237,-357,357,0
"C19AS",625,54,"1200x900",600,0,600,400,"False",474,564,271,-293,293,1
"C19AS",626,398,"1200x900",800,2,600,400,"False",944,698,580,-118,118,0
"C19AS",627,548,"1200x900",1000,1,600,400,"False",103,278,338,60,60,0
"C19AS",628,356,"1200x900",800,1,600,400,"False",123,484,325,-159,159,0
"C19AS",630,447,"1200x900",1000,0,600,400,"True",71,339,296,-43,43,1
"C19AS",631,261,"1200x900",800,0,600,400,"False",86,713,546,-167,167,1
"C19AS",632,333,"1200x900",800,1,600,400,"False",521,548,629,81,81,0
"C19AS",634,335,"1200x900",800,1,600,400,"True",124,360,285,-75,75,0
"C19AS",635,306,"1200x900",800,1,600,400,"True",164,524,501,-23,23,0
"C19AS",636,426,"1200x900",800,2,600,400,"True",830,263,235,-28,28,0
"C19AS",637,26,"1200x900",600,0,600,400,"True",70,712,714,2,2,0
"C19AS",638,118,"1200x900",600,1,600,400,"True",190,588,530,-58,58,0
"C19AS",639,212,"1200x900",600,2,600,400,"False",841,206,389,183,183,0
"C19AS",640,571,"1200x900",1000,1,600,400,"False",239,522,241,-281,281,1
"C19AS",641,56,"1200x900",600,0,600,400,"True",148,491,475,-16,16,0
"C19AS",642,260,"1200x900",800,0,600,400,"True",103,525,508,-17,17,1
"C19AS",643,403,"1200x900",800,2,600,400,"False",625,704,366,-338,338,0
"C19AS",644,263,"1200x900",800,0,600,400,"False",82,396,320,-76,76,1
"C19AS",645,199,"1200x900",600,2,600,400,"False",992,467,374,-93,93,0
"C19AS",646,494,"1200x900",1000,0,600,400,"True",127,692,634,-58,58,1
"C19AS",647,272,"1200x900",800,0,600,400,"True",200,181,138,-43,43,1
"C19AS",648,371,"1200x900",800,2,600,400,"False",730,560,156,-404,404,0
"D01AB",1,310,"1200x900",800,1,600,400,"False",559,592,371,-221,221,0
"D01AB",2,63,"1200x900",600,0,600,400,"True",311,188,223,35,35,1
"D01AB",3,448,"1200x900",1000,0,600,400,"False",107,641,266,-375,375,1
"D01AB",4,161,"1200x900",600,2,600,400,"False",939,553,834,281,281,0
"D01AB",5,2,"1200x900",600,0,600,400,"False",159,323,589,266,266,0
"D01AB",6,582,"1200x900",1000,2,600,400,"False",554,347,146,-201,201,0
"D01AB",7,576,"1200x900",1000,1,600,400,"False",376,713,350,-363,363,0
"D01AB",8,46,"1200x900",600,0,600,400,"False",193,355,89,-266,266,1
"D01AB",9,274,"1200x900",800,0,600,400,"False",146,497,741,244,244,1
"D01AB",10,266,"1200x900",800,0,600,400,"False",126,303,541,238,238,1
"D01AB",11,96,"1200x900",600,1,600,400,"True",433,458,501,43,43,0
"D01AB",12,471,"1200x900",1000,0,600,400,"False",122,200,357,157,157,1
"D01AB",13,407,"1200x900",800,2,600,400,"False",989,340,254,-86,86,0
"D01AB",14,279,"1200x900",800,0,600,400,"False",252,202,676,474,474,1
"D01AB",15,166,"1200x900",600,2,600,400,"True",896,274,333,59,59,0
"D01AB",16,83,"1200x900",600,1,600,400,"False",763,568,715,147,147,1
"D01AB",17,647,"1200x900",1000,2,600,400,"False",560,637,300,-337,337,0
"D01AB",18,429,"1200x900",800,2,600,400,"False",682,692,408,-284,284,0
"D01AB",19,79,"1200x900",600,1,600,400,"False",731,289,192,-97,97,0
"D01AB",20,220,"1200x900",800,0,600,400,"True",108,699,641,-58,58,1
"D01AB",21,600,"1200x900",1000,2,600,400,"True",765,207,161,-46,46,0
"D01AB",22,65,"1200x900",600,0,600,400,"False",442,645,580,-65,65,1
"D01AB",23,163,"1200x900",600,2,600,400,"True",1046,665,677,12,12,0
"D01AB",24,233,"1200x900",800,0,600,400,"False",164,700,486,-214,214,1
"D01AB",25,190,"1200x900",600,2,600,400,"True",977,238,215,-23,23,0
"D01AB",26,85,"1200x900",600,1,600,400,"True",434,347,348,1,1,0
"D01AB",27,522,"1200x900",1000,1,600,400,"False",223,379,603,224,224,0
"D01AB",28,606,"1200x900",1000,2,600,400,"False",653,627,251,-376,376,0
"D01AB",29,446,"1200x900",1000,0,600,400,"True",72,298,358,60,60,1
"D01AB",30,445,"1200x900",1000,0,600,400,"True",78,302,354,52,52,1
"D01AB",31,251,"1200x900",800,0,600,400,"True",88,352,289,-63,63,1
"D01AB",32,221,"1200x900",800,0,600,400,"False",132,520,729,209,209,1
"D01AB",33,512,"1200x900",1000,1,600,400,"False",139,261,414,153,153,0
"D01AB",34,420,"1200x900",800,2,600,400,"False",519,223,558,335,335,0
"D01AB",35,623,"1200x900",1000,2,600,400,"False",636,527,297,-230,230,0
"D01AB",36,158,"1200x900",600,2,600,400,"False",939,300,622,322,322,0
"D01AB",37,129,"1200x900",600,1,600,400,"False",859,482,353,-129,129,1
"D01AB",38,379,"1200x900",800,2,600,400,"False",994,325,429,104,104,0
"D01AB",39,333,"1200x900",800,1,600,400,"False",521,548,730,182,182,0
"D01AB",40,625,"1200x900",1000,2,600,400,"False",279,228,394,166,166,0
"D01AB",41,176,"1200x900",600,2,600,400,"True",1033,281,306,25,25,0
"D01AB",42,225,"1200x900",800,0,600,400,"False",178,423,205,-218,218,1
"D01AB",43,427,"1200x900",800,2,600,400,"False",812,380,175,-205,205,0
"D01AB",44,349,"1200x900",800,1,600,400,"False",402,665,298,-367,367,0
"D01AB",45,222,"1200x900",800,0,600,400,"False",152,206,319,113,113,1
"D01AB",46,436,"1200x900",1000,0,600,400,"False",82,617,462,-155,155,1
"D01AB",47,101,"1200x900",600,1,600,400,"False",541,656,814,158,158,0
"D01AB",48,21,"1200x900",600,0,600,400,"False",314,383,518,135,135,1
"D01AB",49,115,"1200x900",600,1,600,400,"False",545,307,50,-257,257,0
"D01AB",50,211,"1200x900",600,2,600,400,"True",986,407,487,80,80,0
"D01AB",51,472,"1200x900",1000,0,600,400,"False",77,685,293,-392,392,1
"D01AB",52,467,"1200x900",1000,0,600,400,"True",74,712,755,43,43,1
"D01AB",53,276,"1200x900",800,0,600,400,"False",281,217,286,69,69,1
"D01AB",54,368,"1200x900",800,2,600,400,"False",778,515,74,-441,441,0
"D01AB",55,542,"1200x900",1000,1,600,400,"False",304,401,528,127,127,0
"D01AB",56,642,"1200x900",1000,2,600,400,"True",776,316,284,-32,32,0
"D01AB",57,458,"1200x900",1000,0,600,400,"True",78,624,568,-56,56,1
"D01AB",58,500,"1200x900",1000,0,600,400,"False",105,700,172,-528,528,1
"D01AB",59,630,"1200x900",1000,2,600,400,"False",754,559,284,-275,275,0
"D01AB",60,488,"1200x900",1000,0,600,400,"True",129,687,680,-7,7,1
"D01AB",61,358,"1200x900",800,1,600,400,"False",263,635,582,-53,53,0
"D01AB",62,206,"1200x900",600,2,600,400,"True",975,223,280,57,57,0
"D01AB",63,584,"1200x900",1000,2,600,400,"False",731,413,555,142,142,0
"D01AB",64,184,"1200x900",600,2,600,400,"True",1067,441,343,-98,98,0
"D01AB",65,441,"1200x900",1000,0,600,400,"False",85,684,584,-100,100,1
"D01AB",66,641,"1200x900",1000,2,600,400,"True",897,272,311,39,39,0
"D01AB",67,563,"1200x900",1000,1,600,400,"False",201,696,508,-188,188,0
"D01AB",68,384,"1200x900",800,2,600,400,"False",821,707,502,-205,205,0
"D01AB",69,415,"1200x900",800,2,600,400,"True",823,684,706,22,22,0
"D01AB",70,464,"1200x900",1000,0,600,400,"False",82,222,534,312,312,1
"D01AB",71,261,"1200x900",800,0,600,400,"False",86,713,397,-316,316,1
"D01AB",72,167,"1200x900",600,2,600,400,"True",956,241,186,-55,55,0
"D01AB",73,317,"1200x900",800,1,600,400,"True",185,564,483,-81,81,0
"D01AB",74,549,"1200x900",1000,1,600,400,"False",657,366,459,93,93,0
"D01AB",75,230,"1200x900",800,0,600,400,"False",99,678,491,-187,187,1
"D01AB",76,173,"1200x900",600,2,600,400,"False",948,693,401,-292,292,0
"D01AB",77,29,"1200x900",600,0,600,400,"False",385,533,612,79,79,1
"D01AB",78,43,"1200x900",600,0,600,400,"False",277,446,380,-66,66,1
"D01AB",79,186,"1200x900",600,2,600,400,"False",997,197,713,516,516,0
"D01AB",80,308,"1200x900",800,1,600,400,"False",437,425,720,295,295,0
"D01AB",81,8,"1200x900",600,0,600,400,"True",156,679,649,-30,30,0
"D01AB",83,555,"1200x900",1000,1,600,400,"False",444,556,284,-272,272,0
"D01AB",84,556,"1200x900",1000,1,600,400,"False",415,420,592,172,172,0
"D01AB",85,185,"1200x900",600,2,600,400,"True",907,212,232,20,20,0
"D01AB",86,592,"1200x900",1000,2,600,400,"False",492,392,115,-277,277,0
"D01AB",87,444,"1200x900",1000,0,600,400,"False",101,714,555,-159,159,1
"D01AB",88,193,"1200x900",600,2,600,400,"False",874,588,684,96,96,0
"D01AB",89,97,"1200x900",600,1,600,400,"False",760,643,437,-206,206,1
"D01AB",90,98,"1200x900",600,1,600,400,"False",625,530,704,174,174,0
"D01AB",91,111,"1200x900",600,1,600,400,"False",922,552,445,-107,107,1
"D01AB",92,313,"1200x900",800,1,600,400,"False",588,421,747,326,326,0
"D01AB",93,439,"1200x900",1000,0,600,400,"False",110,229,313,84,84,1
"D01AB",94,348,"1200x900",800,1,600,400,"False",764,294,589,295,295,0
"D01AB",95,315,"1200x900",800,1,600,400,"False",105,211,370,159,159,0
"D01AB",96,554,"1200x900",1000,1,600,400,"False",79,309,555,246,246,1
"D01AB",97,575,"1200x900",1000,1,600,400,"False",272,693,398,-295,295,0
"D01AB",98,451,"1200x900",1000,0,600,400,"False",110,702,489,-213,213,1
"D01AB",99,475,"1200x900",1000,0,600,400,"False",101,715,297,-418,418,1
"D01AB",100,305,"1200x900",800,1,600,400,"False",471,716,510,-206,206,0
"D01AB",101,86,"1200x900",600,1,600,400,"False",692,388,665,277,277,1
"D01AB",102,72,"1200x900",600,0,600,400,"True",158,537,568,31,31,0
"D01AB",103,437,"1200x900",1000,0,600,400,"False",74,667,301,-366,366,1
"D01AB",104,503,"1200x900",1000,0,600,400,"False",86,279,475,196,196,1
"D01AB",105,601,"1200x900",1000,2,600,400,"False",735,697,296,-401,401,0
"D01AB",106,320,"1200x900",800,1,600,400,"False",644,376,456,80,80,0
"D01AB",108,201,"1200x900",600,2,600,400,"False",1005,462,242,-220,220,0
"D01AB",109,425,"1200x900",800,2,600,400,"False",621,438,193,-245,245,0
"D01AB",110,536,"1200x900",1000,1,600,400,"False",580,213,483,270,270,0
"D01AB",111,604,"1200x900",1000,2,600,400,"False",459,593,232,-361,361,0
"D01AB",112,226,"1200x900",800,0,600,400,"False",187,229,659,430,430,1
"D01AB",113,41,"1200x900",600,0,600,400,"False",370,452,365,-87,87,1
"D01AB",114,119,"1200x900",600,1,600,400,"False",168,563,768,205,205,0
"D01AB",115,169,"1200x900",600,2,600,400,"True",924,290,257,-33,33,0
"D01AB",116,268,"1200x900",800,0,600,400,"True",148,400,341,-59,59,1
"D01AB",117,17,"1200x900",600,0,600,400,"False",402,496,305,-191,191,1
"D01AB",118,267,"1200x900",800,0,600,400,"True",145,665,715,50,50,1
"D01AB",119,269,"1200x900",800,0,600,400,"False",160,295,399,104,104,1
"D01AB",120,496,"1200x900",1000,0,600,400,"False",70,639,469,-170,170,1
"D01AB",121,491,"1200x900",1000,0,600,400,"False",108,198,412,214,214,1
"D01AB",122,290,"1200x900",800,1,600,400,"False",789,603,410,-193,193,0
"D01AB",123,224,"1200x900",800,0,600,400,"False",161,474,600,126,126,1
"D01AB",124,495,"1200x900",1000,0,600,400,"False",93,692,329,-363,363,1
"D01AB",125,80,"1200x900",600,1,600,400,"False",616,423,724,301,301,1
"D01AB",126,638,"1200x900",1000,2,600,400,"False",385,198,349,151,151,0
"D01AB",127,168,"1200x900",600,2,600,400,"False",1001,439,210,-229,229,0
"D01AB",128,104,"1200x900",600,1,600,400,"True",448,584,516,-68,68,0
"D01AB",129,615,"1200x900",1000,2,600,400,"False",736,634,446,-188,188,0
"D01AB",130,302,"1200x900",800,1,600,400,"False",479,467,773,306,306,1
"D01AB",131,538,"1200x900",1000,1,600,400,"False",308,457,711,254,254,1
"D01AB",132,634,"1200x900",1000,2,600,400,"False",735,313,715,402,402,0
"D01AB",133,520,"1200x900",1000,1,600,400,"False",564,260,405,145,145,0
"D01AB",134,637,"1200x900",1000,2,600,400,"False",750,460,600,140,140,0
"D01AB",135,198,"1200x900",600,2,600,400,"False",976,500,850,350,350,0
"D01AB",136,24,"1200x900",600,0,600,400,"False",430,538,450,-88,88,1
"D01AB",137,546,"1200x900",1000,1,600,400,"True",305,374,404,30,30,0
"D01AB",139,515,"1200x900",1000,1,600,400,"False",307,217,664,447,447,0
"D01AB",140,607,"1200x900",1000,2,600,400,"False",900,573,725,152,152,1
"D01AB",141,416,"1200x900",800,2,600,400,"False",748,617,374,-243,243,0
"D01AB",142,254,"1200x900",800,0,600,400,"True",136,583,579,-4,4,1
"D01AB",143,139,"1200x900",600,1,600,400,"True",192,695,620,-75,75,0
"D01AB",144,291,"1200x900",800,1,600,400,"False",522,694,460,-234,234,0
"D01AB",145,297,"1200x900",800,1,600,400,"False",625,244,399,155,155,0
"D01AB",146,588,"1200x900",1000,2,600,400,"True",585,350,373,23,23,0
"D01AB",147,165,"1200x900",600,2,600,400,"True",912,554,574,20,20,0
"D01AB",148,214,"1200x900",600,2,600,400,"True",1046,305,282,-23,23,0
"D01AB",149,242,"1200x900",800,0,600,400,"False",117,448,348,-100,100,1
"D01AB",150,543,"1200x900",1000,1,600,400,"False",88,202,682,480,480,0
"D01AB",151,400,"1200x900",800,2,600,400,"False",733,297,435,138,138,0
"D01AB",152,335,"1200x900",800,1,600,400,"False",124,360,564,204,204,0
"D01AB",153,509,"1200x900",1000,1,600,400,"True",509,434,455,21,21,0
"D01AB",154,447,"1200x900",1000,0,600,400,"False",71,339,557,218,218,1
"D01AB",155,199,"1200x900",600,2,600,400,"False",992,467,340,-127,127,0
"D01AB",156,28,"1200x900",600,0,600,400,"True",336,410,414,4,4,1
"D01AB",157,577,"1200x900",1000,2,600,400,"False",455,420,336,-84,84,0
"D01AB",158,430,"1200x900",800,2,600,400,"False",922,254,540,286,286,0
"D01AB",159,609,"1200x900",1000,2,600,400,"True",697,627,677,50,50,0
"D01AB",160,77,"1200x900",600,1,600,400,"True",780,525,573,48,48,0
"D01AB",161,494,"1200x900",1000,0,600,400,"False",127,692,449,-243,243,1
"D01AB",162,391,"1200x900",800,2,600,400,"False",895,521,320,-201,201,0
"D01AB",163,187,"1200x900",600,2,600,400,"False",857,639,354,-285,285,0
"D01AB",164,234,"1200x900",800,0,600,400,"False",72,344,434,90,90,1
"D01AB",165,385,"1200x900",800,2,600,400,"True",740,456,481,25,25,0
"D01AB",166,25,"1200x900",600,0,600,400,"False",263,403,327,-76,76,1
"D01AB",167,138,"1200x900",600,1,600,400,"False",844,580,345,-235,235,1
"D01AB",168,331,"1200x900",800,1,600,400,"False",240,620,294,-326,326,0
"D01AB",169,247,"1200x900",800,0,600,400,"False",160,424,293,-131,131,1
"D01AB",170,390,"1200x900",800,2,600,400,"False",982,674,438,-236,236,1
"D01AB",171,78,"1200x900",600,1,600,400,"False",885,684,531,-153,153,0
"D01AB",172,128,"1200x900",600,1,600,400,"False",661,258,385,127,127,1
"D01AB",173,142,"1200x900",600,1,600,400,"True",286,474,452,-22,22,0
"D01AB",174,56,"1200x900",600,0,600,400,"True",148,491,508,17,17,0
"D01AB",175,583,"1200x900",1000,2,600,400,"False",949,284,536,252,252,1
"D01AB",176,292,"1200x900",800,1,600,400,"False",88,565,407,-158,158,0
"D01AB",177,54,"1200x900",600,0,600,400,"False",474,564,484,-80,80,1
"D01AB",178,443,"1200x900",1000,0,600,400,"False",99,651,426,-225,225,1
"D01AB",179,613,"1200x900",1000,2,600,400,"False",690,374,671,297,297,0
"D01AB",180,381,"1200x900",800,2,600,400,"False",705,408,339,-69,69,0
"D01AB",181,271,"1200x900",800,0,600,400,"True",74,360,356,-4,4,1
"D01AB",182,285,"1200x900",800,0,600,400,"True",237,396,396,0,0,1
"D01AB",183,33,"1200x900",600,0,600,400,"True",198,533,584,51,51,1
"D01AB",184,628,"1200x900",1000,2,600,400,"False",768,410,309,-101,101,0
"D01AB",185,409,"1200x900",800,2,600,400,"True",501,659,669,10,10,0
"D01AB",186,304,"1200x900",800,1,600,400,"False",667,605,272,-333,333,0
"D01AB",187,426,"1200x900",800,2,600,400,"False",830,263,533,270,270,0
"D01AB",188,34,"1200x900",600,0,600,400,"False",361,242,459,217,217,1
"D01AB",189,306,"1200x900",800,1,600,400,"True",164,524,546,22,22,0
"D01AB",190,560,"1200x900",1000,1,600,400,"False",516,693,555,-138,138,0
"D01AB",191,631,"1200x900",1000,2,600,400,"False",699,479,550,71,71,0
"D01AB",192,44,"1200x900",600,0,600,400,"False",305,554,419,-135,135,1
"D01AB",193,620,"1200x900",1000,2,600,400,"False",832,649,558,-91,91,0
"D01AB",194,16,"1200x900",600,0,600,400,"False",297,514,700,186,186,1
"D01AB",195,232,"1200x900",800,0,600,400,"False",84,511,377,-134,134,1
"D01AB",196,250,"1200x900",800,0,600,400,"False",290,248,565,317,317,1
"D01AB",197,336,"1200x900",800,1,600,400,"False",251,587,422,-165,165,0
"D01AB",198,259,"1200x900",800,0,600,400,"False",156,180,457,277,277,1
"D01AB",199,81,"1200x900",600,1,600,400,"True",696,225,224,-1,1,0
"D01AB",200,66,"1200x900",600,0,600,400,"False",155,673,407,-266,266,0
"D01AB",201,3,"1200x900",600,0,600,400,"False",298,443,165,-278,278,1
"D01AB",202,289,"1200x900",800,1,600,400,"False",421,703,580,-123,123,1
"D01AB",203,342,"1200x900",800,1,600,400,"False",677,204,514,310,310,0
"D01AB",204,246,"1200x900",800,0,600,400,"True",196,418,461,43,43,1
"D01AB",205,258,"1200x900",800,0,600,400,"False",126,664,366,-298,298,1
"D01AB",206,534,"1200x900",1000,1,600,400,"False",328,504,569,65,65,1
"D01AB",207,312,"1200x900",800,1,600,400,"True",238,683,696,13,13,0
"D01AB",208,71,"1200x900",600,0,600,400,"False",219,248,472,224,224,0
"D01AB",209,39,"1200x900",600,0,600,400,"False",210,609,403,-206,206,0
"D01AB",210,364,"1200x900",800,2,600,400,"False",1018,204,601,397,397,0
"D01AB",211,532,"1200x900",1000,1,600,400,"False",215,207,276,69,69,0
"D01AB",212,545,"1200x900",1000,1,600,400,"False",358,562,492,-70,70,0
"D01AB",213,191,"1200x900",600,2,600,400,"False",962,396,271,-125,125,0
"D01AB",214,141,"1200x900",600,1,600,400,"True",671,582,621,39,39,0
"D01AB",215,42,"1200x900",600,0,600,400,"True",233,479,470,-9,9,0
"D01AB",217,140,"1200x900",600,1,600,400,"False",700,523,388,-135,135,0
"D01AB",218,387,"1200x900",800,2,600,400,"False",990,444,387,-57,57,0
"D01AB",219,339,"1200x900",800,1,600,400,"False",273,545,702,157,157,1
"D01AB",220,459,"1200x900",1000,0,600,400,"False",70,645,376,-269,269,1
"D01AB",221,482,"1200x900",1000,0,600,400,"True",79,686,659,-27,27,1
"D01AB",222,568,"1200x900",1000,1,600,400,"False",286,475,691,216,216,1
"D01AB",223,144,"1200x900",600,1,600,400,"False",718,371,478,107,107,0
"D01AB",224,347,"1200x900",800,1,600,400,"False",757,295,744,449,449,1
"D01AB",225,252,"1200x900",800,0,600,400,"False",224,673,596,-77,77,1
"D01AB",226,157,"1200x900",600,2,600,400,"True",1016,323,336,13,13,0
"D01AB",227,337,"1200x900",800,1,600,400,"True",299,622,564,-58,58,0
"D01AB",228,460,"1200x900",1000,0,600,400,"False",155,189,371,182,182,1
"D01AB",229,50,"1200x900",600,0,600,400,"True",75,582,622,40,40,0
"D01AB",230,288,"1200x900",800,0,600,400,"False",180,547,422,-125,125,1
"D01AB",231,328,"1200x900",800,1,600,400,"False",104,649,717,68,68,0
"D01AB",232,114,"1200x900",600,1,600,400,"True",183,697,738,41,41,0
"D01AB",233,329,"1200x900",800,1,600,400,"False",517,239,442,203,203,0
"D01AB",234,530,"1200x900",1000,1,600,400,"True",584,405,501,96,96,1
"D01AB",235,270,"1200x900",800,0,600,400,"False",192,418,321,-97,97,1
"D01AB",236,22,"1200x900",600,0,600,400,"True",398,591,541,-50,50,1
"D01AB",237,486,"1200x900",1000,0,600,400,"False",102,676,364,-312,312,1
"D01AB",238,12,"1200x900",600,0,600,400,"True",365,336,307,-29,29,1
"D01AB",239,282,"1200x900",800,0,600,400,"False",109,246,541,295,295,1
"D01AB",240,566,"1200x900",1000,1,600,400,"False",378,472,324,-148,148,1
"D01AB",241,524,"1200x900",1000,1,600,400,"False",534,470,300,-170,170,0
"D01AB",242,424,"1200x900",800,2,600,400,"False",903,545,112,-433,433,0
"D01AB",243,69,"1200x900",600,0,600,400,"False",322,268,457,189,189,0
"D01AB",244,207,"1200x900",600,2,600,400,"True",838,235,220,-15,15,0
"D01AB",245,117,"1200x900",600,1,600,400,"True",711,456,409,-47,47,0
"D01AB",246,134,"1200x900",600,1,600,400,"True",300,188,263,75,75,0
"D01AB",247,432,"1200x900",800,2,600,400,"True",792,380,330,-50,50,0
"D01AB",248,75,"1200x900",600,1,600,400,"True",635,558,489,-69,69,0
"D01AB",249,547,"1200x900",1000,1,600,400,"False",369,384,501,117,117,1
"D01AB",250,525,"1200x900",1000,1,600,400,"False",123,690,459,-231,231,0
"D01AB",251,253,"1200x900",800,0,600,400,"True",177,424,463,39,39,1
"D01AB",252,602,"1200x900",1000,2,600,400,"False",865,452,207,-245,245,0
"D01AB",253,350,"1200x900",800,1,600,400,"False",182,566,425,-141,141,0
"D01AB",254,470,"1200x900",1000,0,600,400,"True",91,666,643,-23,23,1
"D01AB",255,321,"1200x900",800,1,600,400,"False",601,190,303,113,113,0
"D01AB",256,612,"1200x900",1000,2,600,400,"True",706,198,275,77,77,0
"D01AB",257,523,"1200x900",1000,1,600,400,"False",339,318,137,-181,181,0
"D01AB",258,421,"1200x900",800,2,600,400,"False",898,394,148,-246,246,0
"D01AB",259,189,"1200x900",600,2,600,400,"False",881,397,261,-136,136,0
"D01AB",260,116,"1200x900",600,1,600,400,"True",767,289,285,-4,4,0
"D01AB",261,32,"1200x900",600,0,600,400,"False",152,563,286,-277,277,1
"D01AB",264,529,"1200x900",1000,1,600,400,"True",267,412,394,-18,18,1
"D01AB",265,240,"1200x900",800,0,600,400,"True",330,656,596,-60,60,1
"D01AB",266,492,"1200x900",1000,0,600,400,"False",76,692,219,-473,473,1
"D01AB",267,307,"1200x900",800,1,600,400,"False",716,247,647,400,400,0
"D01AB",268,435,"1200x900",1000,0,600,400,"False",119,200,583,383,383,1
"D01AB",269,422,"1200x900",800,2,600,400,"True",712,558,582,24,24,0
"D01AB",276,181,"1200x900",600,2,600,400,"False",1018,223,532,309,309,0
"D01AB",285,332,"1200x900",800,1,600,400,"False",260,699,785,86,86,0
"D01AB",287,301,"1200x900",800,1,600,400,"False",162,574,771,197,197,0
"D01AB",288,6,"1200x900",600,0,600,400,"False",217,689,597,-92,92,1
"D01AB",289,581,"1200x900",1000,2,600,400,"False",310,357,209,-148,148,0
"D01AB",295,340,"1200x900",800,1,600,400,"False",226,240,620,380,380,0
"D01AB",296,401,"1200x900",800,2,600,400,"False",821,260,619,359,359,0
"D01AB",299,18,"1200x900",600,0,600,400,"False",400,318,580,262,262,1
"D01AB",300,561,"1200x900",1000,1,600,400,"False",231,406,709,303,303,0
"D01AB",304,31,"1200x900",600,0,600,400,"False",365,338,525,187,187,1
"D01AB",305,537,"1200x900",1000,1,600,400,"False",621,412,598,186,186,1
"D01AB",306,586,"1200x900",1000,2,600,400,"False",802,262,385,123,123,0
"D01AB",307,26,"1200x900",600,0,600,400,"False",70,712,551,-161,161,0
"D01AB",308,375,"1200x900",800,2,600,400,"False",716,384,535,151,151,0
"D01AB",310,195,"1200x900",600,2,600,400,"False",942,249,550,301,301,0
"D01AB",311,514,"1200x900",1000,1,600,400,"False",539,690,501,-189,189,0
"D01AB",312,635,"1200x900",1000,2,600,400,"False",833,402,499,97,97,0
"D01AB",313,505,"1200x900",1000,1,600,400,"True",191,484,448,-36,36,1
"D01AB",314,360,"1200x900",800,1,600,400,"True",203,608,515,-93,93,0
"D01AB",315,564,"1200x900",1000,1,600,400,"False",215,264,571,307,307,0
"D01AB",316,644,"1200x900",1000,2,600,400,"False",495,486,372,-114,114,0
"D01AB",317,579,"1200x900",1000,2,600,400,"False",803,394,581,187,187,0
"D01AB",318,405,"1200x900",800,2,600,400,"False",790,307,534,227,227,0
"D01AB",319,571,"1200x900",1000,1,600,400,"False",239,522,209,-313,313,1
"D01AB",322,474,"1200x900",1000,0,600,400,"False",85,339,532,193,193,1
"D01AB",323,621,"1200x900",1000,2,600,400,"False",540,478,624,146,146,0
"D01AB",325,442,"1200x900",1000,0,600,400,"False",87,183,311,128,128,1
"D01AB",326,151,"1200x900",600,2,600,400,"False",828,680,471,-209,209,0
"D01AB",327,64,"1200x900",600,0,600,400,"True",102,339,373,34,34,0
"D01AB",328,366,"1200x900",800,2,600,400,"False",931,464,389,-75,75,0
"D01AB",329,197,"1200x900",600,2,600,400,"False",903,212,383,171,171,0
"D01AB",330,440,"1200x900",1000,0,600,400,"True",71,237,281,44,44,1
"D01AB",331,172,"1200x900",600,2,600,400,"True",912,444,422,-22,22,0
"D01AB",332,73,"1200x900",600,1,600,400,"True",94,665,716,51,51,0
"D01AB",333,303,"1200x900",800,1,600,400,"False",241,431,347,-84,84,0
"D01AB",334,462,"1200x900",1000,0,600,400,"True",102,672,614,-58,58,1
"D01AB",335,357,"1200x900",800,1,600,400,"True",109,594,538,-56,56,0
"D01AB",336,154,"1200x900",600,2,600,400,"True",941,454,456,2,2,0
"D01AB",337,130,"1200x900",600,1,600,400,"True",741,428,447,19,19,0
"D01AB",338,404,"1200x900",800,2,600,400,"False",842,396,532,136,136,0
"D01AB",339,516,"1200x900",1000,1,600,400,"True",440,559,620,61,61,0
"D01AB",340,594,"1200x900",1000,2,600,400,"False",537,637,769,132,132,0
"D01AB",341,286,"1200x900",800,0,600,400,"True",105,378,387,9,9,1
"D01AB",342,359,"1200x900",800,1,600,400,"False",653,241,375,134,134,0
"D01AB",343,229,"1200x900",800,0,600,400,"False",117,697,540,-157,157,1
"D01AB",344,120,"1200x900",600,1,600,400,"False",690,655,369,-286,286,0
"D01AB",345,48,"1200x900",600,0,600,400,"False",323,645,506,-139,139,1
"D01AB",346,376,"1200x900",800,2,600,400,"False",788,275,453,178,178,0
"D01AB",347,569,"1200x900",1000,1,600,400,"False",494,720,357,-363,363,0
"D01AB",348,645,"1200x900",1000,2,600,400,"False",619,396,491,95,95,0
"D01AB",349,145,"1200x900",600,2,600,400,"False",1004,630,415,-215,215,0
"D01AB",350,489,"1200x900",1000,0,600,400,"True",88,604,609,5,5,1
"D01AB",351,300,"1200x900",800,1,600,400,"False",620,693,520,-173,173,0
"D01AB",352,619,"1200x900",1000,2,600,400,"False",803,247,334,87,87,0
"D01AB",353,35,"1200x900",600,0,600,400,"False",366,555,296,-259,259,1
"D01AB",354,100,"1200x900",600,1,600,400,"True",453,511,474,-37,37,0
"D01AB",355,296,"1200x900",800,1,600,400,"False",89,279,444,165,165,0
"D01AB",356,143,"1200x900",600,1,600,400,"False",479,284,383,99,99,1
"D01AB",357,646,"1200x900",1000,2,600,400,"False",829,227,385,158,158,1
"D01AB",363,327,"1200x900",800,1,600,400,"False",152,339,469,130,130,0
"D01AB",367,260,"1200x900",800,0,600,400,"True",103,525,570,45,45,1
"D01AB",369,624,"1200x900",1000,2,600,400,"True",693,501,572,71,71,0
"D01AB",370,127,"1200x900",600,1,600,400,"True",309,691,682,-9,9,0
"D01AB",371,170,"1200x900",600,2,600,400,"True",996,468,545,77,77,0
"D01AB",372,27,"1200x900",600,0,600,400,"False",373,309,507,198,198,1
"D01AB",373,223,"1200x900",800,0,600,400,"False",179,191,735,544,544,1
"D01AB",374,590,"1200x900",1000,2,600,400,"False",636,278,506,228,228,0
"D01AB",375,324,"1200x900",800,1,600,400,"False",719,712,532,-180,180,1
"D01AB",376,353,"1200x900",800,1,600,400,"False",90,476,575,99,99,0
"D01AB",377,535,"1200x900",1000,1,600,400,"True",372,410,468,58,58,0
"D01AB",378,413,"1200x900",800,2,600,400,"True",849,506,501,-5,5,0
"D01AB",379,617,"1200x900",1000,2,600,400,"False",294,180,500,320,320,0
"D01AB",380,351,"1200x900",800,1,600,400,"True",122,581,510,-71,71,0
"D01AB",381,280,"1200x900",800,0,600,400,"False",104,302,486,184,184,1
"D01AB",382,177,"1200x900",600,2,600,400,"False",912,236,354,118,118,0
"D01AB",383,118,"1200x900",600,1,600,400,"False",190,588,691,103,103,0
"D01AB",384,374,"1200x900",800,2,600,400,"False",755,450,590,140,140,0
"D01AB",385,565,"1200x900",1000,1,600,400,"False",451,562,397,-165,165,0
"D01AB",386,541,"1200x900",1000,1,600,400,"False",339,478,395,-83,83,0
"D01AB",387,92,"1200x900",600,1,600,400,"False",624,605,408,-197,197,0
"D01AB",391,263,"1200x900",800,0,600,400,"True",82,396,379,-17,17,1
"D01AB",392,19,"1200x900",600,0,600,400,"False",286,686,563,-123,123,0
"D01AB",396,122,"1200x900",600,1,600,400,"False",817,709,495,-214,214,0
"D01AB",397,231,"1200x900",800,0,600,400,"True",251,718,697,-21,21,1
"D01AB",398,153,"1200x900",600,2,600,400,"False",1037,601,695,94,94,0
"D01AB",400,13,"1200x900",600,0,600,400,"False",296,211,589,378,378,1
"D01AB",401,636,"1200x900",1000,2,600,400,"False",575,583,424,-159,159,0
"D01AB",414,481,"1200x900",1000,0,600,400,"False",80,185,425,240,240,1
"D01AB",415,257,"1200x900",800,0,600,400,"False",97,219,441,222,222,1
"D01AB",417,213,"1200x900",600,2,600,400,"False",822,275,417,142,142,0
"D01AB",418,36,"1200x900",600,0,600,400,"True",128,346,284,-62,62,1
"D01AB",419,203,"1200x900",600,2,600,400,"False",938,603,509,-94,94,0
"D01AB",420,182,"1200x900",600,2,600,400,"False",933,389,270,-119,119,0
"D01AB",421,456,"1200x900",1000,0,600,400,"False",91,257,435,178,178,1
"D01AB",422,477,"1200x900",1000,0,600,400,"False",88,640,541,-99,99,1
"D01AB",423,587,"1200x900",1000,2,600,400,"False",741,686,395,-291,291,0
"D01AB",424,265,"1200x900",800,0,600,400,"True",229,353,370,17,17,1
"D01AB",425,196,"1200x900",600,2,600,400,"True",1030,397,397,0,0,0
"D01AB",426,341,"1200x900",800,1,600,400,"False",735,632,430,-202,202,1
"D01AB",427,633,"1200x900",1000,2,600,400,"False",564,253,363,110,110,0
"D01AB",428,175,"1200x900",600,2,600,400,"False",1028,432,237,-195,195,0
"D01AB",429,52,"1200x900",600,0,600,400,"False",171,188,273,85,85,0
"D01AB",430,235,"1200x900",800,0,600,400,"False",146,646,362,-284,284,1
"D01AB",431,287,"1200x900",800,0,600,400,"False",120,567,475,-92,92,1
"D01AB",432,273,"1200x900",800,0,600,400,"False",180,309,388,79,79,1
"D01AB",434,506,"1200x900",1000,1,600,400,"False",559,567,363,-204,204,1
"D01AB",435,591,"1200x900",1000,2,600,400,"True",698,336,394,58,58,0
"D01AB",436,507,"1200x900",1000,1,600,400,"False",608,583,512,-71,71,1
"D01AB",455,611,"1200x900",1000,2,600,400,"True",414,511,511,0,0,0
"D01AB",467,403,"1200x900",800,2,600,400,"False",625,704,509,-195,195,0
"D01AB",468,7,"1200x900",600,0,600,400,"False",431,654,418,-236,236,1
"D01AB",469,45,"1200x900",600,0,600,400,"False",487,678,401,-277,277,1
"D01AB",470,323,"1200x900",800,1,600,400,"False",388,348,607,259,259,0
"D01AB",471,552,"1200x900",1000,1,600,400,"False",255,412,324,-88,88,0
"D01AB",472,192,"1200x900",600,2,600,400,"False",1064,320,188,-132,132,0
"D01AB",473,113,"1200x900",600,1,600,400,"False",897,657,195,-462,462,0
"D01AB",474,150,"1200x900",600,2,600,400,"False",897,345,673,328,328,0
"D01AB",475,95,"1200x900",600,1,600,400,"False",749,425,826,401,401,1
"D01AB",478,237,"1200x900",800,0,600,400,"False",204,481,679,198,198,1
"D01AB",479,205,"1200x900",600,2,600,400,"True",1021,504,506,2,2,0
"D01AB",480,510,"1200x900",1000,1,600,400,"True",486,338,289,-49,49,1
"D01AB",481,504,"1200x900",1000,0,600,400,"False",107,699,461,-238,238,1
"D01AB",483,5,"1200x900",600,0,600,400,"False",228,587,435,-152,152,0
"D01AB",484,283,"1200x900",800,0,600,400,"False",90,264,547,283,283,1
"D01AB",488,465,"1200x900",1000,0,600,400,"False",85,203,405,202,202,1
"D01AB",489,108,"1200x900",600,1,600,400,"False",830,239,356,117,117,0
"D01AB",490,479,"1200x900",1000,0,600,400,"False",74,705,527,-178,178,1
"D01AB",491,216,"1200x900",600,2,600,400,"False",1029,286,373,87,87,0
"D01AB",492,262,"1200x900",800,0,600,400,"False",196,481,273,-208,208,1
"D01AB",493,23,"1200x900",600,0,600,400,"False",308,463,307,-156,156,1
"D01AB",494,487,"1200x900",1000,0,600,400,"False",78,670,527,-143,143,1
"D01AB",495,386,"1200x900",800,2,600,400,"False",774,301,390,89,89,0
"D01AB",496,295,"1200x900",800,1,600,400,"True",471,334,331,-3,3,0
"D01AB",497,382,"1200x900",800,2,600,400,"False",870,523,438,-85,85,0
"D01AB",498,160,"1200x900",600,2,600,400,"False",863,606,310,-296,296,0
"D01AB",499,343,"1200x900",800,1,600,400,"False",407,557,482,-75,75,0
"D01AB",500,595,"1200x900",1000,2,600,400,"False",687,640,466,-174,174,0
"D01AB",501,501,"1200x900",1000,0,600,400,"False",96,323,440,117,117,1
"D01AB",502,20,"1200x900",600,0,600,400,"True",204,545,578,33,33,1
"D01AB",503,485,"1200x900",1000,0,600,400,"False",121,694,614,-80,80,1
"D01AB",504,498,"1200x900",1000,0,600,400,"False",100,260,471,211,211,1
"D01AB",505,553,"1200x900",1000,1,600,400,"False",116,712,442,-270,270,0
"D01AB",506,417,"1200x900",800,2,600,400,"False",750,280,359,79,79,0
"D01AB",507,155,"1200x900",600,2,600,400,"True",940,269,273,4,4,0
"D01AB",508,469,"1200x900",1000,0,600,400,"True",73,227,268,41,41,1
"D01AB",509,558,"1200x900",1000,1,600,400,"False",72,464,283,-181,181,1
"D01AB",512,125,"1200x900",600,1,600,400,"False",750,531,396,-135,135,0
"D01AB",513,326,"1200x900",800,1,600,400,"True",103,482,430,-52,52,0
"D01AB",514,562,"1200x900",1000,1,600,400,"False",347,540,332,-208,208,0
"D01AB",515,434,"1200x900",1000,0,600,400,"False",89,657,572,-85,85,1
"D01AB",516,483,"1200x900",1000,0,600,400,"False",93,191,382,191,191,1
"D01AB",517,548,"1200x900",1000,1,600,400,"False",103,278,577,299,299,0
"D01AB",518,377,"1200x900",800,2,600,400,"True",683,388,376,-12,12,0
"D01AB",519,238,"1200x900",800,0,600,400,"False",162,283,388,105,105,1
"D01AB",520,449,"1200x900",1000,0,600,400,"False",105,683,432,-251,251,1
"D01AB",521,428,"1200x900",800,2,600,400,"False",732,665,304,-361,361,0
"D01AB",522,70,"1200x900",600,0,600,400,"False",309,703,126,-577,577,1
"D01AB",523,91,"1200x900",600,1,600,400,"False",417,630,278,-352,352,1
"D01AB",524,528,"1200x900",1000,1,600,400,"True",839,227,177,-50,50,1
"D01AB",525,580,"1200x900",1000,2,600,400,"True",651,267,323,56,56,0
"D01AB",526,388,"1200x900",800,2,600,400,"False",930,320,528,208,208,0
"D01AB",527,88,"1200x900",600,1,600,400,"False",186,554,438,-116,116,0
"D01AB",528,367,"1200x900",800,2,600,400,"True",613,464,465,1,1,0
"D01AB",529,210,"1200x900",600,2,600,400,"True",835,506,521,15,15,0
"D01AB",530,550,"1200x900",1000,1,600,400,"True",301,459,476,17,17,0
"D01AB",531,47,"1200x900",600,0,600,400,"True",303,499,522,23,23,1
"D01AB",532,618,"1200x900",1000,2,600,400,"True",276,671,626,-45,45,0
"D01AB",533,58,"1200x900",600,0,600,400,"False",353,655,515,-140,140,1
"D01AB",534,346,"1200x900",800,1,600,400,"True",269,635,681,46,46,0
"D01AB",535,60,"1200x900",600,0,600,400,"False",365,213,517,304,304,1
"D01AB",536,373,"1200x900",800,2,600,400,"False",694,326,560,234,234,0
"D01AB",537,124,"1200x900",600,1,600,400,"False",345,467,295,-172,172,0
"D01AB",538,531,"1200x900",1000,1,600,400,"False",233,362,521,159,159,0
"D01AB",539,156,"1200x900",600,2,600,400,"False",913,197,320,123,123,0
"D01AB",540,148,"1200x900",600,2,600,400,"False",907,330,252,-78,78,0
"D01AB",541,123,"1200x900",600,1,600,400,"False",761,365,162,-203,203,1
"D01AB",542,10,"1200x900",600,0,600,400,"False",400,499,332,-167,167,1
"D01AB",543,345,"1200x900",800,1,600,400,"False",841,566,244,-322,322,1
"D01AB",544,412,"1200x900",800,2,600,400,"True",842,280,318,38,38,0
"D01AB",545,578,"1200x900",1000,2,600,400,"False",966,276,554,278,278,0
"D01AB",546,395,"1200x900",800,2,600,400,"False",743,334,203,-131,131,0
"D01AB",547,227,"1200x900",800,0,600,400,"True",196,551,526,-25,25,1
"D01AB",548,146,"1200x900",600,2,600,400,"False",989,492,276,-216,216,0
"D01AB",549,497,"1200x900",1000,0,600,400,"False",106,696,436,-260,260,1
"D01AB",550,585,"1200x900",1000,2,600,400,"False",698,688,434,-254,254,1
"D01AB",551,277,"1200x900",800,0,600,400,"False",140,310,403,93,93,1
"D01AB",552,394,"1200x900",800,2,600,400,"False",847,292,424,132,132,0
"D01AB",553,461,"1200x900",1000,0,600,400,"True",95,711,680,-31,31,1
"D01AB",554,244,"1200x900",800,0,600,400,"False",194,203,474,271,271,1
"D01AB",555,293,"1200x900",800,1,600,400,"True",561,396,424,28,28,0
"D01AB",556,484,"1200x900",1000,0,600,400,"False",100,223,613,390,390,1
"D01AB",557,103,"1200x900",600,1,600,400,"True",528,320,386,66,66,1
"D01AB",558,398,"1200x900",800,2,600,400,"False",944,698,571,-127,127,0
"D01AB",559,149,"1200x900",600,2,600,400,"False",890,289,507,218,218,0
"D01AB",560,9,"1200x900",600,0,600,400,"False",509,654,514,-140,140,1
"D01AB",561,294,"1200x900",800,1,600,400,"False",262,287,508,221,221,0
"D01AB",562,256,"1200x900",800,0,600,400,"False",192,656,434,-222,222,1
"D01AB",563,408,"1200x900",800,2,600,400,"False",758,567,327,-240,240,0
"D01AB",564,319,"1200x900",800,1,600,400,"False",494,587,267,-320,320,1
"D01AB",565,76,"1200x900",600,1,600,400,"False",647,614,270,-344,344,0
"D01AB",566,228,"1200x900",800,0,600,400,"False",174,687,242,-445,445,1
"D01AB",567,414,"1200x900",800,2,600,400,"False",831,592,437,-155,155,0
"D01AB",568,362,"1200x900",800,2,600,400,"True",819,338,383,45,45,0
"D01AB",569,453,"1200x900",1000,0,600,400,"False",71,393,203,-190,190,1
"D01AB",570,1,"1200x900",600,0,600,400,"True",136,502,568,66,66,0
"D01AB",571,410,"1200x900",800,2,600,400,"False",916,477,328,-149,149,0
"D01AB",572,450,"1200x900",1000,0,600,400,"False",130,204,486,282,282,1
"D01AB",573,334,"1200x900",800,1,600,400,"False",481,665,494,-171,171,0
"D01AB",574,59,"1200x900",600,0,600,400,"False",391,692,365,-327,327,1
"D01AB",575,219,"1200x900",800,0,600,400,"False",202,502,374,-128,128,1
"D01AB",576,137,"1200x900",600,1,600,400,"False",789,577,210,-367,367,0
"D01AB",577,202,"1200x900",600,2,600,400,"False",966,460,632,172,172,0
"D01AB",579,40,"1200x900",600,0,600,400,"True",143,513,550,37,37,0
"D01AB",580,380,"1200x900",800,2,600,400,"False",942,228,506,278,278,0
"D01AB",581,431,"1200x900",800,2,600,400,"False",694,382,603,221,221,0
"D01AB",582,476,"1200x900",1000,0,600,400,"True",76,359,329,-30,30,1
"D01AB",583,132,"1200x900",600,1,600,400,"False",333,185,50,-135,135,0
"D01AB",584,511,"1200x900",1000,1,600,400,"False",408,390,577,187,187,1
"D01AB",585,361,"1200x900",800,2,600,400,"False",931,328,468,140,140,0
"D01AB",586,372,"1200x900",800,2,600,400,"False",833,620,485,-135,135,0
"D01AB",587,99,"1200x900",600,1,600,400,"False",811,407,489,82,82,0
"D01AB",588,152,"1200x900",600,2,600,400,"True",971,399,459,60,60,0
"D01AB",589,570,"1200x900",1000,1,600,400,"False",315,352,484,132,132,0
"D01AB",590,89,"1200x900",600,1,600,400,"False",917,366,464,98,98,1
"D01AB",591,38,"1200x900",600,0,600,400,"False",120,628,465,-163,163,1
"D01AB",592,389,"1200x900",800,2,600,400,"False",843,530,412,-118,118,0
"D01AB",594,174,"1200x900",600,2,600,400,"True",998,457,425,-32,32,0
"D01AB",595,281,"1200x900",800,0,600,400,"False",112,611,468,-143,143,1
"D01AB",596,521,"1200x900",1000,1,600,400,"False",111,303,459,156,156,1
"D01AB",597,572,"1200x900",1000,1,600,400,"False",302,260,375,115,115,0
"D01AB",598,392,"1200x900",800,2,600,400,"False",1031,618,337,-281,281,0
"D01AB",599,264,"1200x900",800,0,600,400,"False",198,660,377,-283,283,1
"D01AB",600,212,"1200x900",600,2,600,400,"True",841,206,205,-1,1,0
"D01AB",601,136,"1200x900",600,1,600,400,"True",264,205,206,1,1,0
"D01AB",603,318,"1200x900",800,1,600,400,"True",788,534,474,-60,60,0
"D01AB",604,239,"1200x900",800,0,600,400,"False",114,231,389,158,158,1
"D01AB",605,106,"1200x900",600,1,600,400,"False",803,659,391,-268,268,1
"D01AB",606,147,"1200x900",600,2,600,400,"True",942,418,377,-41,41,0
"D01AB",607,419,"1200x900",800,2,600,400,"False",769,351,469,118,118,0
"D01AB",608,616,"1200x900",1000,2,600,400,"True",854,357,450,93,93,1
"D01AB",609,37,"1200x900",600,0,600,400,"True",258,403,393,-10,10,1
"D01AB",610,90,"1200x900",600,1,600,400,"True",560,474,584,110,110,0
"D01AB",611,539,"1200x900",1000,1,600,400,"True",510,383,373,-10,10,0
"D01AB",612,255,"1200x900",800,0,600,400,"False",93,709,560,-149,149,1
"D01AB",613,365,"1200x900",800,2,600,400,"False",1055,305,533,228,228,0
"D01AB",614,610,"1200x900",1000,2,600,400,"True",702,293,370,77,77,0
"D01AB",615,316,"1200x900",800,1,600,400,"True",362,319,351,32,32,0
"D01AB",617,67,"1200x900",600,0,600,400,"False",289,308,564,256,256,1
"D01AB",618,452,"1200x900",1000,0,600,400,"True",97,273,264,-9,9,1
"D01AB",619,200,"1200x900",600,2,600,400,"False",897,302,573,271,271,0
"D01AB",620,322,"1200x900",800,1,600,400,"False",703,206,488,282,282,1
"D01AB",622,309,"1200x900",800,1,600,400,"False",186,225,489,264,264,0
"D01AB",623,284,"1200x900",800,0,600,400,"False",135,293,490,197,197,1
"D01AB",624,399,"1200x900",800,2,600,400,"False",603,602,141,-461,461,0
"D01AB",625,278,"1200x900",800,0,600,400,"False",251,711,385,-326,326,1
"D01AB",626,648,"1200x900",1000,2,600,400,"False",557,394,318,-76,76,0
"D01AB",627,455,"1200x900",1000,0,600,400,"False",107,718,534,-184,184,1
"D01AB",628,217,"1200x900",800,0,600,400,"True",85,573,535,-38,38,1
"D01AB",629,371,"1200x900",800,2,600,400,"True",730,560,534,-26,26,0
"D01AB",630,325,"1200x900",800,1,600,400,"False",105,394,533,139,139,0
"D01AB",631,4,"1200x900",600,0,600,400,"False",602,200,429,229,229,1
"D01AB",632,248,"1200x900",800,0,600,400,"False",94,240,396,156,156,1
"D01AB",633,74,"1200x900",600,1,600,400,"True",115,358,431,73,73,0
"D01AB",634,589,"1200x900",1000,2,600,400,"False",856,418,580,162,162,0
"D01AB",635,236,"1200x900",800,0,600,400,"False",162,350,479,129,129,1
"D01AB",636,121,"1200x900",600,1,600,400,"False",884,364,520,156,156,0
"D01AB",637,62,"1200x900",600,0,600,400,"False",345,346,621,275,275,1
"D01AB",638,61,"1200x900",600,0,600,400,"False",272,670,575,-95,95,1
"D01AB",639,179,"1200x900",600,2,600,400,"False",908,602,491,-111,111,0
"D01AB",640,178,"1200x900",600,2,600,400,"True",1041,510,518,8,8,0
"D01AB",641,603,"1200x900",1000,2,600,400,"False",693,280,577,297,297,0
"D01AB",642,608,"1200x900",1000,2,600,400,"False",742,250,550,300,300,0
"D01AB",643,508,"1200x900",1000,1,600,400,"True",596,485,492,7,7,0
"D01AB",644,544,"1200x900",1000,1,600,400,"False",602,620,485,-135,135,0
"D01AB",645,133,"1200x900",600,1,600,400,"True",345,551,487,-64,64,0
"D01AB",646,454,"1200x900",1000,0,600,400,"False",78,687,488,-199,199,1
"D01AB",647,55,"1200x900",600,0,600,400,"False",211,305,473,168,168,1
"D01AB",648,567,"1200x900",1000,1,600,400,"False",655,297,136,-161,161,1
"D02SC",1,640,"1200x900",1000,2,600,400,"True",361,334,287,-47,47,0
"D02SC",2,246,"1200x900",800,0,600,400,"True",196,418,358,-60,60,1
"D02SC",3,455,"1200x900",1000,0,600,400,"False",107,718,595,-123,123,1
"D02SC",4,566,"1200x900",1000,1,600,400,"False",378,472,298,-174,174,1
"D02SC",5,547,"1200x900",1000,1,600,400,"True",369,384,412,28,28,1
"D02SC",6,470,"1200x900",1000,0,600,400,"False",91,666,587,-79,79,1
"D02SC",7,608,"1200x900",1000,2,600,400,"True",742,250,251,1,1,0
"D02SC",8,518,"1200x900",1000,1,600,400,"True",583,717,666,-51,51,0
"D02SC",9,624,"1200x900",1000,2,600,400,"False",693,501,404,-97,97,0
"D02SC",10,187,"1200x900",600,2,600,400,"False",857,639,503,-136,136,0
"D02SC",11,465,"1200x900",1000,0,600,400,"True",85,203,181,-22,22,1
"D02SC",12,88,"1200x900",600,1,600,400,"False",186,554,652,98,98,0
"D02SC",13,589,"1200x900",1000,2,600,400,"False",856,418,522,104,104,0
"D02SC",14,500,"1200x900",1000,0,600,400,"True",105,700,767,67,67,1
"D02SC",15,457,"1200x900",1000,0,600,400,"False",97,630,546,-84,84,1
"D02SC",16,421,"1200x900",800,2,600,400,"False",898,394,148,-246,246,0
"D02SC",17,353,"1200x900",800,1,600,400,"True",90,476,429,-47,47,0
"D02SC",18,444,"1200x900",1000,0,600,400,"False",101,714,592,-122,122,1
"D02SC",19,468,"1200x900",1000,0,600,400,"False",121,219,345,126,126,1
"D02SC",20,170,"1200x900",600,2,600,400,"False",996,468,304,-164,164,0
"D02SC",21,408,"1200x900",800,2,600,400,"False",758,567,458,-109,109,0
"D02SC",22,411,"1200x900",800,2,600,400,"False",805,361,522,161,161,0
"D02SC",23,137,"1200x900",600,1,600,400,"True",789,577,598,21,21,0
"D02SC",24,296,"1200x900",800,1,600,400,"False",89,279,436,157,157,0
"D02SC",25,452,"1200x900",1000,0,600,400,"False",97,273,395,122,122,1
"D02SC",26,290,"1200x900",800,1,600,400,"True",789,603,581,-22,22,0
"D02SC",27,333,"1200x900",800,1,600,400,"True",521,548,561,13,13,0
"D02SC",28,272,"1200x900",800,0,600,400,"True",200,181,153,-28,28,1
"D02SC",29,210,"1200x900",600,2,600,400,"False",835,506,590,84,84,0
"D02SC",30,469,"1200x900",1000,0,600,400,"False",73,227,369,142,142,1
"D02SC",31,354,"1200x900",800,1,600,400,"True",118,236,308,72,72,0
"D02SC",32,329,"1200x900",800,1,600,400,"False",517,239,337,98,98,0
"D02SC",33,298,"1200x900",800,1,600,400,"True",311,457,405,-52,52,0
"D02SC",34,596,"1200x900",1000,2,600,400,"True",706,513,570,57,57,0
"D02SC",35,580,"1200x900",1000,2,600,400,"True",651,267,332,65,65,0
"D02SC",36,424,"1200x900",800,2,600,400,"False",903,545,407,-138,138,0
"D02SC",37,29,"1200x900",600,0,600,400,"True",385,533,477,-56,56,1
"D02SC",38,52,"1200x900",600,0,600,400,"True",171,188,155,-33,33,0
"D02SC",39,433,"1200x900",1000,0,600,400,"True",76,222,153,-69,69,1
"D02SC",41,567,"1200x900",1000,1,600,400,"True",655,297,348,51,51,1
"D02SC",42,89,"1200x900",600,1,600,400,"True",917,366,349,-17,17,1
"D02SC",43,623,"1200x900",1000,2,600,400,"False",636,527,171,-356,356,0
"D02SC",44,174,"1200x900",600,2,600,400,"False",998,457,138,-319,319,0
"D02SC",45,622,"1200x900",1000,2,600,400,"False",307,683,388,-295,295,0
"D02SC",46,534,"1200x900",1000,1,600,400,"False",328,504,176,-328,328,1
"D02SC",47,35,"1200x900",600,0,600,400,"True",366,555,569,14,14,1
"D02SC",48,66,"1200x900",600,0,600,400,"True",155,673,614,-59,59,0
"D02SC",49,599,"1200x900",1000,2,600,400,"False",316,570,353,-217,217,0
"D02SC",50,191,"1200x900",600,2,600,400,"True",962,396,352,-44,44,0
"D02SC",51,159,"1200x900",600,2,600,400,"False",992,309,164,-145,145,0
"D02SC",52,265,"1200x900",800,0,600,400,"False",229,353,250,-103,103,1
"D02SC",53,153,"1200x900",600,2,600,400,"False",1037,601,445,-156,156,0
"D02SC",54,286,"1200x900",800,0,600,400,"True",105,378,381,3,3,1
"D02SC",55,636,"1200x900",1000,2,600,400,"False",575,583,380,-203,203,0
"D02SC",56,243,"1200x900",800,0,600,400,"True",114,332,339,7,7,1
"D02SC",57,642,"1200x900",1000,2,600,400,"False",776,316,504,188,188,0
"D02SC",58,275,"1200x900",800,0,600,400,"True",120,594,659,65,65,0
"D02SC",59,308,"1200x900",800,1,600,400,"True",437,425,452,27,27,0
"D02SC",60,312,"1200x900",800,1,600,400,"True",238,683,617,-66,66,0
"D02SC",61,334,"1200x900",800,1,600,400,"True",481,665,643,-22,22,0
"D02SC",62,140,"1200x900",600,1,600,400,"True",700,523,532,9,9,0
"D02SC",63,643,"1200x900",1000,2,600,400,"False",740,325,110,-215,215,0
"D02SC",64,102,"1200x900",600,1,600,400,"True",861,603,626,23,23,0
"D02SC",65,206,"1200x900",600,2,600,400,"True",975,223,208,-15,15,0
"D02SC",66,401,"1200x900",800,2,600,400,"False",821,260,360,100,100,0
"D02SC",67,280,"1200x900",800,0,600,400,"True",104,302,284,-18,18,1
"D02SC",68,387,"1200x900",800,2,600,400,"False",990,444,552,108,108,0
"D02SC",69,576,"1200x900",1000,1,600,400,"True",376,713,718,5,5,0
"D02SC",70,495,"1200x900",1000,0,600,400,"True",93,692,685,-7,7,1
"D02SC",71,226,"1200x900",800,0,600,400,"False",187,229,130,-99,99,1
"D02SC",72,564,"1200x900",1000,1,600,400,"True",215,264,268,4,4,0
"D02SC",73,558,"1200x900",1000,1,600,400,"False",72,464,637,173,173,1
"D02SC",74,488,"1200x900",1000,0,600,400,"True",129,687,684,-3,3,1
"D02SC",75,98,"1200x900",600,1,600,400,"True",625,530,541,11,11,0
"D02SC",76,48,"1200x900",600,0,600,400,"True",323,645,639,-6,6,1
"D02SC",77,172,"1200x900",600,2,600,400,"False",912,444,264,-180,180,0
"D02SC",78,33,"1200x900",600,0,600,400,"True",198,533,524,-9,9,1
"D02SC",79,244,"1200x900",800,0,600,400,"True",194,203,250,47,47,1
"D02SC",80,24,"1200x900",600,0,600,400,"True",430,538,511,-27,27,1
"D02SC",81,157,"1200x900",600,2,600,400,"True",1016,323,376,53,53,0
"D02SC",82,330,"1200x900",800,1,600,400,"False",759,301,245,-56,56,1
"D02SC",83,173,"1200x900",600,2,600,400,"True",948,693,692,-1,1,0
"D02SC",84,261,"1200x900",800,0,600,400,"True",86,713,748,35,35,1
"D02SC",85,99,"1200x900",600,1,600,400,"True",811,407,464,57,57,0
"D02SC",86,180,"1200x900",600,2,600,400,"False",929,270,207,-63,63,0
"D02SC",87,171,"1200x900",600,2,600,400,"False",909,200,312,112,112,0
"D02SC",88,150,"1200x900",600,2,600,400,"False",897,345,278,-67,67,0
"D02SC",89,611,"1200x900",1000,2,600,400,"True",414,511,585,74,74,0
"D02SC",90,78,"1200x900",600,1,600,400,"True",885,684,720,36,36,0
"D02SC",91,82,"1200x900",600,1,600,400,"False",108,213,360,147,147,0
"D02SC",92,373,"1200x900",800,2,600,400,"False",694,326,582,256,256,0
"D02SC",93,340,"1200x900",800,1,600,400,"False",226,240,311,71,71,0
"D02SC",94,355,"1200x900",800,1,600,400,"False",77,386,107,-279,279,0
"D02SC",95,224,"1200x900",800,0,600,400,"False",161,474,330,-144,144,1
"D02SC",96,429,"1200x900",800,2,600,400,"False",682,692,605,-87,87,0
"D02SC",97,610,"1200x900",1000,2,600,400,"True",702,293,266,-27,27,0
"D02SC",98,242,"1200x900",800,0,600,400,"True",117,448,408,-40,40,1
"D02SC",99,303,"1200x900",800,1,600,400,"True",241,431,448,17,17,0
"D02SC",100,104,"1200x900",600,1,600,400,"False",448,584,353,-231,231,0
"D02SC",101,5,"1200x900",600,0,600,400,"True",228,587,551,-36,36,0
"D02SC",102,114,"1200x900",600,1,600,400,"True",183,697,671,-26,26,0
"D02SC",103,535,"1200x900",1000,1,600,400,"False",372,410,553,143,143,0
"D02SC",104,554,"1200x900",1000,1,600,400,"True",79,309,315,6,6,1
"D02SC",105,607,"1200x900",1000,2,600,400,"True",900,573,574,1,1,1
"D02SC",106,606,"1200x900",1000,2,600,400,"False",653,627,441,-186,186,0
"D02SC",107,318,"1200x900",800,1,600,400,"True",788,534,502,-32,32,0
"D02SC",108,109,"1200x900",600,1,600,400,"True",691,589,574,-15,15,0
"D02SC",109,119,"1200x900",600,1,600,400,"True",168,563,509,-54,54,0
"D02SC",110,446,"1200x900",1000,0,600,400,"True",72,298,337,39,39,1
"D02SC",111,203,"1200x900",600,2,600,400,"True",938,603,644,41,41,0
"D02SC",112,115,"1200x900",600,1,600,400,"True",545,307,400,93,93,0
"D02SC",113,14,"1200x900",600,0,600,400,"True",399,224,282,58,58,1
"D02SC",114,341,"1200x900",800,1,600,400,"False",735,632,468,-164,164,1
"D02SC",115,67,"1200x900",600,0,600,400,"True",289,308,322,14,14,1
"D02SC",116,16,"1200x900",600,0,600,400,"False",297,514,404,-110,110,1
"D02SC",117,183,"1200x900",600,2,600,400,"True",927,289,285,-4,4,0
"D02SC",118,145,"1200x900",600,2,600,400,"False",1004,630,445,-185,185,0
"D02SC",119,146,"1200x900",600,2,600,400,"True",989,492,453,-39,39,0
"D02SC",120,255,"1200x900",800,0,600,400,"True",93,709,696,-13,13,1
"D02SC",121,181,"1200x900",600,2,600,400,"False",1018,223,349,126,126,0
"D02SC",122,194,"1200x900",600,2,600,400,"True",896,236,285,49,49,0
"D02SC",123,597,"1200x900",1000,2,600,400,"False",352,239,378,139,139,0
"D02SC",124,125,"1200x900",600,1,600,400,"True",750,531,496,-35,35,0
"D02SC",125,507,"1200x900",1000,1,600,400,"True",608,583,637,54,54,1
"D02SC",126,211,"1200x900",600,2,600,400,"False",986,407,300,-107,107,0
"D02SC",127,2,"1200x900",600,0,600,400,"True",159,323,352,29,29,0
"D02SC",128,264,"1200x900",800,0,600,400,"False",198,660,578,-82,82,1
"D02SC",129,345,"1200x900",800,1,600,400,"False",841,566,656,90,90,1
"D02SC",130,55,"1200x900",600,0,600,400,"True",211,305,266,-39,39,1
"D02SC",131,37,"1200x900",600,0,600,400,"True",258,403,383,-20,20,1
"D02SC",132,367,"1200x900",800,2,600,400,"True",613,464,415,-49,49,0
"D02SC",133,86,"1200x900",600,1,600,400,"True",692,388,361,-27,27,1
"D02SC",134,394,"1200x900",800,2,600,400,"False",847,292,387,95,95,0
"D02SC",135,418,"1200x900",800,2,600,400,"False",754,507,421,-86,86,0
"D02SC",136,310,"1200x900",800,1,600,400,"False",559,592,482,-110,110,0
"D02SC",137,382,"1200x900",800,2,600,400,"True",870,523,566,43,43,0
"D02SC",138,230,"1200x900",800,0,600,400,"True",99,678,668,-10,10,1
"D02SC",139,381,"1200x900",800,2,600,400,"False",705,408,622,214,214,0
"D02SC",140,209,"1200x900",600,2,600,400,"False",937,637,507,-130,130,0
"D02SC",141,229,"1200x900",800,0,600,400,"True",117,697,756,59,59,1
"D02SC",142,162,"1200x900",600,2,600,400,"False",849,279,383,104,104,0
"D02SC",143,258,"1200x900",800,0,600,400,"True",126,664,615,-49,49,1
"D02SC",144,342,"1200x900",800,1,600,400,"False",677,204,389,185,185,0
"D02SC",145,15,"1200x900",600,0,600,400,"True",473,352,315,-37,37,1
"D02SC",147,80,"1200x900",600,1,600,400,"True",616,423,463,40,40,1
"D02SC",148,598,"1200x900",1000,2,600,400,"True",706,559,487,-72,72,0
"D02SC",149,397,"1200x900",800,2,600,400,"False",817,692,545,-147,147,0
"D02SC",150,348,"1200x900",800,1,600,400,"False",764,294,379,85,85,0
"D02SC",151,139,"1200x900",600,1,600,400,"False",192,695,446,-249,249,0
"D02SC",152,523,"1200x900",1000,1,600,400,"False",339,318,504,186,186,0
"D02SC",153,155,"1200x900",600,2,600,400,"True",940,269,347,78,78,0
"D02SC",154,161,"1200x900",600,2,600,400,"True",939,553,587,34,34,0
"D02SC",155,293,"1200x900",800,1,600,400,"True",561,396,451,55,55,0
"D02SC",156,251,"1200x900",800,0,600,400,"True",88,352,332,-20,20,1
"D02SC",157,84,"1200x900",600,1,600,400,"False",144,184,333,149,149,0
"D02SC",158,472,"1200x900",1000,0,600,400,"False",77,685,581,-104,104,1
"D02SC",159,583,"1200x900",1000,2,600,400,"False",949,284,184,-100,100,1
"D02SC",160,92,"1200x900",600,1,600,400,"True",624,605,592,-13,13,0
"D02SC",161,221,"1200x900",800,0,600,400,"False",132,520,607,87,87,1
"D02SC",162,222,"1200x900",800,0,600,400,"True",152,206,256,50,50,1
"D02SC",163,259,"1200x900",800,0,600,400,"True",156,180,189,9,9,1
"D02SC",165,248,"1200x900",800,0,600,400,"True",94,240,206,-34,34,1
"D02SC",166,621,"1200x900",1000,2,600,400,"False",540,478,371,-107,107,0
"D02SC",167,501,"1200x900",1000,0,600,400,"True",96,323,276,-47,47,1
"D02SC",169,241,"1200x900",800,0,600,400,"True",129,227,244,17,17,1
"D02SC",170,478,"1200x900",1000,0,600,400,"False",79,672,574,-98,98,1
"D02SC",172,127,"1200x900",600,1,600,400,"True",309,691,607,-84,84,0
"D02SC",173,447,"1200x900",1000,0,600,400,"True",71,339,357,18,18,1
"D02SC",174,216,"1200x900",600,2,600,400,"True",1029,286,356,70,70,0
"D02SC",175,320,"1200x900",800,1,600,400,"True",644,376,379,3,3,0
"D02SC",176,435,"1200x900",1000,0,600,400,"True",119,200,237,37,37,1
"D02SC",177,561,"1200x900",1000,1,600,400,"False",231,406,184,-222,222,0
"D02SC",178,407,"1200x900",800,2,600,400,"False",989,340,262,-78,78,0
"D02SC",179,511,"1200x900",1000,1,600,400,"False",408,390,568,178,178,1
"D02SC",180,374,"1200x900",800,2,600,400,"True",755,450,432,-18,18,0
"D02SC",181,613,"1200x900",1000,2,600,400,"True",690,374,328,-46,46,0
"D02SC",182,3,"1200x900",600,0,600,400,"True",298,443,456,13,13,1
"D02SC",183,8,"1200x900",600,0,600,400,"True",156,679,736,57,57,0
"D02SC",184,483,"1200x900",1000,0,600,400,"True",93,191,194,3,3,1
"D02SC",185,343,"1200x900",800,1,600,400,"False",407,557,386,-171,171,0
"D02SC",186,595,"1200x900",1000,2,600,400,"False",687,640,314,-326,326,0
"D02SC",187,405,"1200x900",800,2,600,400,"True",790,307,317,10,10,0
"D02SC",188,225,"1200x900",800,0,600,400,"True",178,423,401,-22,22,1
"D02SC",189,451,"1200x900",1000,0,600,400,"True",110,702,689,-13,13,1
"D02SC",190,175,"1200x900",600,2,600,400,"False",1028,432,370,-62,62,0
"D02SC",191,370,"1200x900",800,2,600,400,"True",874,336,393,57,57,0
"D02SC",192,513,"1200x900",1000,1,600,400,"False",235,602,374,-228,228,0
"D02SC",193,644,"1200x900",1000,2,600,400,"False",495,486,136,-350,350,0
"D02SC",194,118,"1200x900",600,1,600,400,"False",190,588,382,-206,206,0
"D02SC",195,351,"1200x900",800,1,600,400,"True",122,581,561,-20,20,0
"D02SC",196,309,"1200x900",800,1,600,400,"False",186,225,426,201,201,0
"D02SC",197,634,"1200x900",1000,2,600,400,"True",735,313,335,22,22,0
"D02SC",198,277,"1200x900",800,0,600,400,"True",140,310,239,-71,71,1
"D02SC",199,349,"1200x900",800,1,600,400,"False",402,665,387,-278,278,0
"D02SC",200,300,"1200x900",800,1,600,400,"True",620,693,709,16,16,0
"D02SC",201,571,"1200x900",1000,1,600,400,"False",239,522,358,-164,164,1
"D02SC",202,167,"1200x900",600,2,600,400,"False",956,241,373,132,132,0
"D02SC",203,415,"1200x900",800,2,600,400,"False",823,684,575,-109,109,0
"D02SC",204,112,"1200x900",600,1,600,400,"False",681,490,627,137,137,0
"D02SC",205,577,"1200x900",1000,2,600,400,"False",455,420,622,202,202,0
"D02SC",206,629,"1200x900",1000,2,600,400,"True",681,257,299,42,42,0
"D02SC",207,385,"1200x900",800,2,600,400,"True",740,456,384,-72,72,0
"D02SC",208,18,"1200x900",600,0,600,400,"True",400,318,327,9,9,1
"D02SC",209,64,"1200x900",600,0,600,400,"True",102,339,277,-62,62,0
"D02SC",210,250,"1200x900",800,0,600,400,"True",290,248,276,28,28,1
"D02SC",211,449,"1200x900",1000,0,600,400,"True",105,683,686,3,3,1
"D02SC",212,529,"1200x900",1000,1,600,400,"False",267,412,349,-63,63,1
"D02SC",213,551,"1200x900",1000,1,600,400,"True",146,445,475,30,30,1
"D02SC",214,32,"1200x900",600,0,600,400,"True",152,563,621,58,58,1
"D02SC",215,268,"1200x900",800,0,600,400,"True",148,400,418,18,18,1
"D02SC",216,639,"1200x900",1000,2,600,400,"False",504,456,255,-201,201,0
"D02SC",217,618,"1200x900",1000,2,600,400,"False",276,671,470,-201,201,0
"D02SC",218,592,"1200x900",1000,2,600,400,"False",492,392,703,311,311,0
"D02SC",219,219,"1200x900",800,0,600,400,"True",202,502,524,22,22,1
"D02SC",221,404,"1200x900",800,2,600,400,"True",842,396,435,39,39,0
"D02SC",222,602,"1200x900",1000,2,600,400,"False",865,452,349,-103,103,0
"D02SC",223,448,"1200x900",1000,0,600,400,"False",107,641,554,-87,87,1
"D02SC",224,317,"1200x900",800,1,600,400,"False",185,564,147,-417,417,0
"D02SC",225,263,"1200x900",800,0,600,400,"False",82,396,319,-77,77,1
"D02SC",226,563,"1200x900",1000,1,600,400,"True",201,696,658,-38,38,0
"D02SC",227,442,"1200x900",1000,0,600,400,"True",87,183,213,30,30,1
"D02SC",228,646,"1200x900",1000,2,600,400,"True",829,227,313,86,86,1
"D02SC",229,389,"1200x900",800,2,600,400,"True",843,530,552,22,22,0
"D02SC",231,537,"1200x900",1000,1,600,400,"True",621,412,406,-6,6,1
"D02SC",232,132,"1200x900",600,1,600,400,"True",333,185,275,90,90,0
"D02SC",233,463,"1200x900",1000,0,600,400,"True",115,693,633,-60,60,1
"D02SC",234,235,"1200x900",800,0,600,400,"True",146,646,632,-14,14,1
"D02SC",235,279,"1200x900",800,0,600,400,"True",252,202,184,-18,18,1
"D02SC",236,638,"1200x900",1000,2,600,400,"True",385,198,277,79,79,0
"D02SC",237,136,"1200x900",600,1,600,400,"True",264,205,264,59,59,0
"D02SC",238,593,"1200x900",1000,2,600,400,"False",246,719,322,-397,397,0
"D02SC",239,579,"1200x900",1000,2,600,400,"False",803,394,507,113,113,0
"D02SC",240,581,"1200x900",1000,2,600,400,"False",310,357,670,313,313,0
"D02SC",241,103,"1200x900",600,1,600,400,"False",528,320,405,85,85,1
"D02SC",242,22,"1200x900",600,0,600,400,"True",398,591,607,16,16,1
"D02SC",243,218,"1200x900",800,0,600,400,"False",106,397,469,72,72,1
"D02SC",244,208,"1200x900",600,2,600,400,"False",946,399,556,157,157,0
"D02SC",245,512,"1200x900",1000,1,600,400,"False",139,261,323,62,62,0
"D02SC",246,276,"1200x900",800,0,600,400,"True",281,217,250,33,33,1
"D02SC",247,388,"1200x900",800,2,600,400,"False",930,320,611,291,291,0
"D02SC",248,426,"1200x900",800,2,600,400,"False",830,263,363,100,100,0
"D02SC",249,358,"1200x900",800,1,600,400,"False",263,635,489,-146,146,0
"D02SC",250,142,"1200x900",600,1,600,400,"False",286,474,578,104,104,0
"D02SC",251,319,"1200x900",800,1,600,400,"True",494,587,598,11,11,1
"D02SC",252,126,"1200x900",600,1,600,400,"False",849,354,476,122,122,0
"D02SC",253,75,"1200x900",600,1,600,400,"True",635,558,538,-20,20,0
"D02SC",255,541,"1200x900",1000,1,600,400,"True",339,478,483,5,5,0
"D02SC",256,143,"1200x900",600,1,600,400,"False",479,284,465,181,181,1
"D02SC",257,195,"1200x900",600,2,600,400,"False",942,249,141,-108,108,0
"D02SC",258,332,"1200x900",800,1,600,400,"False",260,699,574,-125,125,0
"D02SC",259,464,"1200x900",1000,0,600,400,"True",82,222,198,-24,24,1
"D02SC",260,270,"1200x900",800,0,600,400,"False",192,418,296,-122,122,1
"D02SC",261,363,"1200x900",800,2,600,400,"False",800,218,310,92,92,0
"D02SC",262,93,"1200x900",600,1,600,400,"True",139,540,525,-15,15,0
"D02SC",263,588,"1200x900",1000,2,600,400,"True",585,350,304,-46,46,0
"D02SC",264,26,"1200x900",600,0,600,400,"True",70,712,741,29,29,0
"D02SC",265,490,"1200x900",1000,0,600,400,"True",114,183,148,-35,35,1
"D02SC",266,453,"1200x900",1000,0,600,400,"False",71,393,227,-166,166,1
"D02SC",267,628,"1200x900",1000,2,600,400,"True",768,410,445,35,35,0
"D02SC",268,207,"1200x900",600,2,600,400,"True",838,235,309,74,74,0
"D02SC",269,517,"1200x900",1000,1,600,400,"False",548,182,288,106,106,0
"D02SC",270,284,"1200x900",800,0,600,400,"True",135,293,252,-41,41,1
"D02SC",271,384,"1200x900",800,2,600,400,"False",821,707,427,-280,280,0
"D02SC",272,68,"1200x900",600,0,600,400,"True",165,367,380,13,13,0
"D02SC",273,481,"1200x900",1000,0,600,400,"True",80,185,174,-11,11,1
"D02SC",274,352,"1200x900",800,1,600,400,"False",235,717,592,-125,125,0
"D02SC",275,20,"1200x900",600,0,600,400,"True",204,545,608,63,63,1
"D02SC",276,569,"1200x900",1000,1,600,400,"False",494,720,628,-92,92,0
"D02SC",277,386,"1200x900",800,2,600,400,"False",774,301,532,231,231,0
"D02SC",278,428,"1200x900",800,2,600,400,"False",732,665,391,-274,274,0
"D02SC",279,223,"1200x900",800,0,600,400,"True",179,191,213,22,22,1
"D02SC",280,362,"1200x900",800,2,600,400,"False",819,338,191,-147,147,0
"D02SC",281,617,"1200x900",1000,2,600,400,"False",294,180,312,132,132,0
"D02SC",282,480,"1200x900",1000,0,600,400,"False",100,231,138,-93,93,1
"D02SC",283,393,"1200x900",800,2,600,400,"False",657,620,348,-272,272,0
"D02SC",284,568,"1200x900",1000,1,600,400,"False",286,475,539,64,64,1
"D02SC",285,43,"1200x900",600,0,600,400,"True",277,446,512,66,66,1
"D02SC",286,196,"1200x900",600,2,600,400,"True",1030,397,382,-15,15,0
"D02SC",287,573,"1200x900",1000,1,600,400,"True",486,615,559,-56,56,0
"D02SC",288,591,"1200x900",1000,2,600,400,"True",698,336,397,61,61,0
"D02SC",289,36,"1200x900",600,0,600,400,"True",128,346,367,21,21,1
"D02SC",290,169,"1200x900",600,2,600,400,"True",924,290,344,54,54,0
"D02SC",291,177,"1200x900",600,2,600,400,"True",912,236,248,12,12,0
"D02SC",292,163,"1200x900",600,2,600,400,"True",1046,665,691,26,26,0
"D02SC",293,377,"1200x900",800,2,600,400,"False",683,388,493,105,105,0
"D02SC",294,168,"1200x900",600,2,600,400,"True",1001,439,427,-12,12,0
"D02SC",295,254,"1200x900",800,0,600,400,"True",136,583,607,24,24,1
"D02SC",296,38,"1200x900",600,0,600,400,"True",120,628,653,25,25,1
"D02SC",297,637,"1200x900",1000,2,600,400,"True",750,460,507,47,47,0
"D02SC",298,410,"1200x900",800,2,600,400,"True",916,477,427,-50,50,0
"D02SC",299,474,"1200x900",1000,0,600,400,"True",85,339,379,40,40,1
"D02SC",300,120,"1200x900",600,1,600,400,"True",690,655,609,-46,46,0
"D02SC",301,402,"1200x900",800,2,600,400,"False",878,234,412,178,178,0
"D02SC",302,123,"1200x900",600,1,600,400,"False",761,365,271,-94,94,1
"D02SC",303,376,"1200x900",800,2,600,400,"False",788,275,406,131,131,0
"D02SC",304,462,"1200x900",1000,0,600,400,"True",102,672,635,-37,37,1
"D02SC",305,450,"1200x900",1000,0,600,400,"False",130,204,276,72,72,1
"D02SC",306,503,"1200x900",1000,0,600,400,"True",86,279,292,13,13,1
"D02SC",307,605,"1200x900",1000,2,600,400,"True",493,665,599,-66,66,0
"D02SC",308,7,"1200x900",600,0,600,400,"True",431,654,703,49,49,1
"D02SC",309,525,"1200x900",1000,1,600,400,"True",123,690,680,-10,10,0
"D02SC",310,49,"1200x900",600,0,600,400,"True",109,380,369,-11,11,0
"D02SC",311,616,"1200x900",1000,2,600,400,"True",854,357,351,-6,6,1
"D02SC",312,70,"1200x900",600,0,600,400,"True",309,703,731,28,28,1
"D02SC",313,188,"1200x900",600,2,600,400,"False",900,195,477,282,282,0
"D02SC",314,278,"1200x900",800,0,600,400,"True",251,711,701,-10,10,1
"D02SC",315,100,"1200x900",600,1,600,400,"True",453,511,479,-32,32,0
"D02SC",316,107,"1200x900",600,1,600,400,"True",878,678,687,9,9,0
"D02SC",317,556,"1200x900",1000,1,600,400,"False",415,420,493,73,73,0
"D02SC",318,134,"1200x900",600,1,600,400,"False",300,188,417,229,229,0
"D02SC",319,217,"1200x900",800,0,600,400,"True",85,573,626,53,53,1
"D02SC",320,83,"1200x900",600,1,600,400,"True",763,568,566,-2,2,1
"D02SC",321,620,"1200x900",1000,2,600,400,"False",832,649,505,-144,144,0
"D02SC",322,179,"1200x900",600,2,600,400,"True",908,602,604,2,2,0
"D02SC",323,505,"1200x900",1000,1,600,400,"False",191,484,678,194,194,1
"D02SC",324,166,"1200x900",600,2,600,400,"False",896,274,443,169,169,0
"D02SC",325,231,"1200x900",800,0,600,400,"True",251,718,705,-13,13,1
"D02SC",326,594,"1200x900",1000,2,600,400,"True",537,637,677,40,40,0
"D02SC",327,461,"1200x900",1000,0,600,400,"False",95,711,811,100,100,1
"D02SC",328,506,"1200x900",1000,1,600,400,"False",559,567,449,-118,118,1
"D02SC",329,315,"1200x900",800,1,600,400,"False",105,211,369,158,158,0
"D02SC",330,570,"1200x900",1000,1,600,400,"True",315,352,331,-21,21,0
"D02SC",331,413,"1200x900",800,2,600,400,"True",849,506,492,-14,14,0
"D02SC",332,559,"1200x900",1000,1,600,400,"False",641,244,373,129,129,0
"D02SC",333,422,"1200x900",800,2,600,400,"False",712,558,320,-238,238,0
"D02SC",334,492,"1200x900",1000,0,600,400,"True",76,692,630,-62,62,1
"D02SC",335,232,"1200x900",800,0,600,400,"False",84,511,591,80,80,1
"D02SC",336,520,"1200x900",1000,1,600,400,"False",564,260,393,133,133,0
"D02SC",337,113,"1200x900",600,1,600,400,"True",897,657,602,-55,55,0
"D02SC",338,138,"1200x900",600,1,600,400,"False",844,580,641,61,61,1
"D02SC",339,375,"1200x900",800,2,600,400,"True",716,384,397,13,13,0
"D02SC",340,69,"1200x900",600,0,600,400,"True",322,268,314,46,46,0
"D02SC",341,366,"1200x900",800,2,600,400,"False",931,464,239,-225,225,0
"D02SC",342,133,"1200x900",600,1,600,400,"False",345,551,398,-153,153,0
"D02SC",343,575,"1200x900",1000,1,600,400,"False",272,693,622,-71,71,0
"D02SC",344,557,"1200x900",1000,1,600,400,"False",677,505,639,134,134,1
"D02SC",345,574,"1200x900",1000,1,600,400,"False",614,194,475,281,281,0
"D02SC",346,396,"1200x900",800,2,600,400,"False",678,663,555,-108,108,0
"D02SC",347,34,"1200x900",600,0,600,400,"True",361,242,292,50,50,1
"D02SC",348,204,"1200x900",600,2,600,400,"False",1053,432,150,-282,282,0
"D02SC",349,213,"1200x900",600,2,600,400,"False",822,275,412,137,137,0
"D02SC",350,228,"1200x900",800,0,600,400,"True",174,687,631,-56,56,1
"D02SC",351,368,"1200x900",800,2,600,400,"True",778,515,491,-24,24,0
"D02SC",352,71,"1200x900",600,0,600,400,"True",219,248,254,6,6,0
"D02SC",353,427,"1200x900",800,2,600,400,"True",812,380,442,62,62,0
"D02SC",354,439,"1200x900",1000,0,600,400,"False",110,229,319,90,90,1
"D02SC",355,62,"1200x900",600,0,600,400,"True",345,346,343,-3,3,1
"D02SC",356,524,"1200x900",1000,1,600,400,"False",534,470,228,-242,242,0
"D02SC",357,434,"1200x900",1000,0,600,400,"True",89,657,656,-1,1,1
"D02SC",358,322,"1200x900",800,1,600,400,"True",703,206,263,57,57,1
"D02SC",359,59,"1200x900",600,0,600,400,"True",391,692,704,12,12,1
"D02SC",360,327,"1200x900",800,1,600,400,"False",152,339,433,94,94,0
"D02SC",361,395,"1200x900",800,2,600,400,"True",743,334,332,-2,2,0
"D02SC",362,214,"1200x900",600,2,600,400,"True",1046,305,252,-53,53,0
"D02SC",363,430,"1200x900",800,2,600,400,"False",922,254,438,184,184,0
"D02SC",364,467,"1200x900",1000,0,600,400,"True",74,712,717,5,5,1
"D02SC",365,306,"1200x900",800,1,600,400,"False",164,524,383,-141,141,0
"D02SC",366,65,"1200x900",600,0,600,400,"True",442,645,614,-31,31,1
"D02SC",367,504,"1200x900",1000,0,600,400,"True",107,699,696,-3,3,1
"D02SC",368,197,"1200x900",600,2,600,400,"False",903,212,545,333,333,0
"D02SC",369,360,"1200x900",800,1,600,400,"False",203,608,490,-118,118,0
"D02SC",370,445,"1200x900",1000,0,600,400,"True",78,302,251,-51,51,1
"D02SC",371,46,"1200x900",600,0,600,400,"True",193,355,329,-26,26,1
"D02SC",372,441,"1200x900",1000,0,600,400,"True",85,684,651,-33,33,1
"D02SC",373,347,"1200x900",800,1,600,400,"True",757,295,314,19,19,1
"D02SC",374,542,"1200x900",1000,1,600,400,"False",304,401,499,98,98,0
"D02SC",375,544,"1200x900",1000,1,600,400,"True",602,620,569,-51,51,0
"D02SC",376,149,"1200x900",600,2,600,400,"False",890,289,422,133,133,0
"D02SC",377,641,"1200x900",1000,2,600,400,"False",897,272,484,212,212,0
"D02SC",379,339,"1200x900",800,1,600,400,"False",273,545,434,-111,111,1
"D02SC",380,528,"1200x900",1000,1,600,400,"True",839,227,261,34,34,1
"D02SC",381,91,"1200x900",600,1,600,400,"False",417,630,240,-390,390,1
"D02SC",382,234,"1200x900",800,0,600,400,"True",72,344,275,-69,69,1
"D02SC",383,647,"1200x900",1000,2,600,400,"False",560,637,511,-126,126,0
"D02SC",384,238,"1200x900",800,0,600,400,"True",162,283,298,15,15,1
"D02SC",385,41,"1200x900",600,0,600,400,"True",370,452,425,-27,27,1
"D02SC",386,54,"1200x900",600,0,600,400,"True",474,564,525,-39,39,1
"D02SC",387,260,"1200x900",800,0,600,400,"True",103,525,550,25,25,1
"D02SC",388,631,"1200x900",1000,2,600,400,"True",699,479,456,-23,23,0
"D02SC",389,151,"1200x900",600,2,600,400,"False",828,680,578,-102,102,0
"D02SC",390,190,"1200x900",600,2,600,400,"True",977,238,327,89,89,0
"D02SC",391,90,"1200x900",600,1,600,400,"False",560,474,272,-202,202,0
"D02SC",392,321,"1200x900",800,1,600,400,"False",601,190,283,93,93,0
"D02SC",393,51,"1200x900",600,0,600,400,"True",272,181,185,4,4,1
"D02SC",394,31,"1200x900",600,0,600,400,"True",365,338,298,-40,40,1
"D02SC",395,359,"1200x900",800,1,600,400,"True",653,241,259,18,18,0
"D02SC",396,274,"1200x900",800,0,600,400,"False",146,497,406,-91,91,1
"D02SC",397,543,"1200x900",1000,1,600,400,"False",88,202,573,371,371,0
"D02SC",398,297,"1200x900",800,1,600,400,"True",625,244,303,59,59,0
"D02SC",399,485,"1200x900",1000,0,600,400,"False",121,694,499,-195,195,1
"D02SC",400,141,"1200x900",600,1,600,400,"True",671,582,529,-53,53,0
"D02SC",401,292,"1200x900",800,1,600,400,"False",88,565,441,-124,124,0
"D02SC",402,356,"1200x900",800,1,600,400,"True",123,484,529,45,45,0
"D02SC",403,590,"1200x900",1000,2,600,400,"True",636,278,335,57,57,0
"D02SC",404,443,"1200x900",1000,0,600,400,"False",99,651,538,-113,113,1
"D02SC",405,257,"1200x900",800,0,600,400,"False",97,219,294,75,75,1
"D02SC",406,291,"1200x900",800,1,600,400,"False",522,694,568,-126,126,0
"D02SC",407,57,"1200x900",600,0,600,400,"True",354,508,532,24,24,1
"D02SC",408,201,"1200x900",600,2,600,400,"True",1005,462,409,-53,53,0
"D02SC",409,301,"1200x900",800,1,600,400,"False",162,574,453,-121,121,0
"D02SC",410,459,"1200x900",1000,0,600,400,"True",70,645,672,27,27,1
"D02SC",411,21,"1200x900",600,0,600,400,"True",314,383,421,38,38,1
"D02SC",412,178,"1200x900",600,2,600,400,"False",1041,510,625,115,115,0
"D02SC",413,437,"1200x900",1000,0,600,400,"True",74,667,714,47,47,1
"D02SC",414,110,"1200x900",600,1,600,400,"False",776,550,646,96,96,1
"D02SC",415,487,"1200x900",1000,0,600,400,"False",78,670,794,124,124,1
"D02SC",416,365,"1200x900",800,2,600,400,"False",1055,305,90,-215,215,0
"D02SC",417,122,"1200x900",600,1,600,400,"True",817,709,703,-6,6,0
"D02SC",418,614,"1200x900",1000,2,600,400,"True",823,563,567,4,4,0
"D02SC",419,538,"1200x900",1000,1,600,400,"True",308,457,396,-61,61,1
"D02SC",420,11,"1200x900",600,0,600,400,"True",372,670,629,-41,41,1
"D02SC",421,482,"1200x900",1000,0,600,400,"True",79,686,714,28,28,1
"D02SC",422,493,"1200x900",1000,0,600,400,"True",80,582,600,18,18,1
"D02SC",423,476,"1200x900",1000,0,600,400,"False",76,359,467,108,108,1
"D02SC",424,47,"1200x900",600,0,600,400,"True",303,499,531,32,32,1
"D02SC",425,193,"1200x900",600,2,600,400,"True",874,588,612,24,24,0
"D02SC",426,325,"1200x900",800,1,600,400,"False",105,394,540,146,146,0
"D02SC",427,144,"1200x900",600,1,600,400,"False",718,371,452,81,81,0
"D02SC",428,497,"1200x900",1000,0,600,400,"True",106,696,660,-36,36,1
"D02SC",429,305,"1200x900",800,1,600,400,"True",471,716,734,18,18,0
"D02SC",430,9,"1200x900",600,0,600,400,"True",509,654,669,15,15,1
"D02SC",431,338,"1200x900",800,1,600,400,"False",813,253,333,80,80,1
"D02SC",432,578,"1200x900",1000,2,600,400,"False",966,276,653,377,377,0
"D02SC",433,527,"1200x900",1000,1,600,400,"True",565,601,634,33,33,0
"D02SC",434,283,"1200x900",800,0,600,400,"True",90,264,251,-13,13,1
"D02SC",435,160,"1200x900",600,2,600,400,"False",863,606,460,-146,146,0
"D02SC",436,307,"1200x900",800,1,600,400,"False",716,247,320,73,73,0
"D02SC",437,398,"1200x900",800,2,600,400,"False",944,698,566,-132,132,0
"D02SC",438,414,"1200x900",800,2,600,400,"False",831,592,650,58,58,0
"D02SC",439,473,"1200x900",1000,0,600,400,"False",75,323,466,143,143,1
"D02SC",440,635,"1200x900",1000,2,600,400,"False",833,402,341,-61,61,0
"D02SC",441,129,"1200x900",600,1,600,400,"True",859,482,452,-30,30,1
"D02SC",443,496,"1200x900",1000,0,600,400,"True",70,639,629,-10,10,1
"D02SC",444,357,"1200x900",800,1,600,400,"True",109,594,582,-12,12,0
"D02SC",445,425,"1200x900",800,2,600,400,"True",621,438,491,53,53,0
"D02SC",446,499,"1200x900",1000,0,600,400,"True",93,271,333,62,62,1
"D02SC",447,532,"1200x900",1000,1,600,400,"False",215,207,319,112,112,0
"D02SC",448,460,"1200x900",1000,0,600,400,"False",155,189,263,74,74,1
"D02SC",449,147,"1200x900",600,2,600,400,"False",942,418,353,-65,65,0
"D02SC",450,371,"1200x900",800,2,600,400,"False",730,560,456,-104,104,0
"D02SC",451,128,"1200x900",600,1,600,400,"True",661,258,271,13,13,1
"D02SC",452,10,"1200x900",600,0,600,400,"True",400,499,491,-8,8,1
"D02SC",453,582,"1200x900",1000,2,600,400,"True",554,347,324,-23,23,0
"D02SC",454,526,"1200x900",1000,1,600,400,"True",497,710,701,-9,9,0
"D02SC",455,419,"1200x900",800,2,600,400,"False",769,351,526,175,175,0
"D02SC",456,42,"1200x900",600,0,600,400,"False",233,479,559,80,80,0
"D02SC",457,335,"1200x900",800,1,600,400,"True",124,360,304,-56,56,0
"D02SC",458,324,"1200x900",800,1,600,400,"False",719,712,485,-227,227,1
"D02SC",459,555,"1200x900",1000,1,600,400,"True",444,556,524,-32,32,0
"D02SC",460,285,"1200x900",800,0,600,400,"True",237,396,459,63,63,1
"D02SC",461,302,"1200x900",800,1,600,400,"True",479,467,507,40,40,1
"D02SC",462,423,"1200x900",800,2,600,400,"True",1051,710,678,-32,32,1
"D02SC",463,549,"1200x900",1000,1,600,400,"True",657,366,397,31,31,0
"D02SC",464,509,"1200x900",1000,1,600,400,"True",509,434,402,-32,32,0
"D02SC",465,131,"1200x900",600,1,600,400,"False",531,367,605,238,238,0
"D02SC",466,403,"1200x900",800,2,600,400,"False",625,704,378,-326,326,0
"D02SC",467,281,"1200x900",800,0,600,400,"True",112,611,603,-8,8,1
"D02SC",468,106,"1200x900",600,1,600,400,"True",803,659,635,-24,24,1
"D02SC",469,240,"1200x900",800,0,600,400,"True",330,656,699,43,43,1
"D02SC",470,185,"1200x900",600,2,600,400,"False",907,212,314,102,102,0
"D02SC",471,19,"1200x900",600,0,600,400,"True",286,686,662,-24,24,0
"D02SC",472,124,"1200x900",600,1,600,400,"True",345,467,519,52,52,0
"D02SC",473,17,"1200x900",600,0,600,400,"True",402,496,494,-2,2,1
"D02SC",474,601,"1200x900",1000,2,600,400,"False",735,697,308,-389,389,0
"D02SC",475,627,"1200x900",1000,2,600,400,"False",760,510,674,164,164,0
"D02SC",476,25,"1200x900",600,0,600,400,"True",263,403,409,6,6,1
"D02SC",478,252,"1200x900",800,0,600,400,"True",224,673,738,65,65,1
"D02SC",479,304,"1200x900",800,1,600,400,"False",667,605,359,-246,246,0
"D02SC",480,30,"1200x900",600,0,600,400,"True",107,353,357,4,4,0
"D02SC",481,220,"1200x900",800,0,600,400,"True",108,699,720,21,21,1
"D02SC",482,479,"1200x900",1000,0,600,400,"True",74,705,735,30,30,1
"D02SC",484,267,"1200x900",800,0,600,400,"True",145,665,715,50,50,1
"D02SC",485,154,"1200x900",600,2,600,400,"False",941,454,281,-173,173,0
"D02SC",486,95,"1200x900",600,1,600,400,"False",749,425,320,-105,105,1
"D02SC",487,420,"1200x900",800,2,600,400,"False",519,223,394,171,171,0
"D02SC",488,510,"1200x900",1000,1,600,400,"False",486,338,204,-134,134,1
"D02SC",489,316,"1200x900",800,1,600,400,"False",362,319,558,239,239,0
"D02SC",490,475,"1200x900",1000,0,600,400,"True",101,715,661,-54,54,1
"D02SC",491,73,"1200x900",600,1,600,400,"True",94,665,609,-56,56,0
"D02SC",492,239,"1200x900",800,0,600,400,"False",114,231,329,98,98,1
"D02SC",493,361,"1200x900",800,2,600,400,"False",931,328,215,-113,113,0
"D02SC",494,148,"1200x900",600,2,600,400,"True",907,330,342,12,12,0
"D02SC",495,562,"1200x900",1000,1,600,400,"True",347,540,477,-63,63,0
"D02SC",496,326,"1200x900",800,1,600,400,"True",103,482,508,26,26,0
"D02SC",497,269,"1200x900",800,0,600,400,"True",160,295,313,18,18,1
"D02SC",498,72,"1200x900",600,0,600,400,"True",158,537,488,-49,49,0
"D02SC",499,116,"1200x900",600,1,600,400,"True",767,289,333,44,44,0
"D02SC",500,630,"1200x900",1000,2,600,400,"True",754,559,544,-15,15,0
"D02SC",501,164,"1200x900",600,2,600,400,"True",1051,268,262,-6,6,0
"D02SC",502,514,"1200x900",1000,1,600,400,"False",539,690,536,-154,154,0
"D02SC",503,432,"1200x900",800,2,600,400,"True",792,380,422,42,42,0
"D02SC",504,101,"1200x900",600,1,600,400,"True",541,656,565,-91,91,0
"D02SC",505,282,"1200x900",800,0,600,400,"False",109,246,338,92,92,1
"D02SC",506,380,"1200x900",800,2,600,400,"True",942,228,257,29,29,0
"D02SC",507,392,"1200x900",800,2,600,400,"True",1031,618,630,12,12,0
"D02SC",508,313,"1200x900",800,1,600,400,"False",588,421,497,76,76,0
"D02SC",509,350,"1200x900",800,1,600,400,"True",182,566,520,-46,46,0
"D02SC",510,619,"1200x900",1000,2,600,400,"True",803,247,256,9,9,0
"D02SC",511,87,"1200x900",600,1,600,400,"False",231,604,495,-109,109,0
"D02SC",512,632,"1200x900",1000,2,600,400,"False",984,227,563,336,336,0
"D02SC",513,409,"1200x900",800,2,600,400,"False",501,659,420,-239,239,0
"D02SC",514,189,"1200x900",600,2,600,400,"True",881,397,468,71,71,0
"D02SC",515,6,"1200x900",600,0,600,400,"True",217,689,671,-18,18,1
"D02SC",516,586,"1200x900",1000,2,600,400,"False",802,262,378,116,116,0
"D02SC",517,12,"1200x900",600,0,600,400,"False",365,336,252,-84,84,1
"D02SC",518,645,"1200x900",1000,2,600,400,"True",619,396,449,53,53,0
"D02SC",519,288,"1200x900",800,0,600,400,"False",180,547,450,-97,97,1
"D02SC",520,121,"1200x900",600,1,600,400,"True",884,364,424,60,60,0
"D02SC",521,39,"1200x900",600,0,600,400,"True",210,609,549,-60,60,0
"D02SC",522,237,"1200x900",800,0,600,400,"True",204,481,484,3,3,1
"D02SC",523,633,"1200x900",1000,2,600,400,"False",564,253,415,162,162,0
"D02SC",524,44,"1200x900",600,0,600,400,"True",305,554,544,-10,10,1
"D02SC",525,531,"1200x900",1000,1,600,400,"False",233,362,444,82,82,0
"D02SC",526,40,"1200x900",600,0,600,400,"True",143,513,475,-38,38,0
"D02SC",527,406,"1200x900",800,2,600,400,"False",971,233,525,292,292,0
"D02SC",528,53,"1200x900",600,0,600,400,"False",177,189,257,68,68,0
"D02SC",529,458,"1200x900",1000,0,600,400,"False",78,624,532,-92,92,1
"D02SC",530,521,"1200x900",1000,1,600,400,"True",111,303,338,35,35,1
"D02SC",531,336,"1200x900",800,1,600,400,"True",251,587,609,22,22,0
"D02SC",532,233,"1200x900",800,0,600,400,"True",164,700,633,-67,67,1
"D02SC",533,289,"1200x900",800,1,600,400,"True",421,703,675,-28,28,1
"D02SC",534,81,"1200x900",600,1,600,400,"False",696,225,495,270,270,0
"D02SC",535,245,"1200x900",800,0,600,400,"True",296,235,277,42,42,1
"D02SC",536,61,"1200x900",600,0,600,400,"False",272,670,581,-89,89,1
"D02SC",537,236,"1200x900",800,0,600,400,"True",162,350,373,23,23,1
"D02SC",538,135,"1200x900",600,1,600,400,"True",759,569,554,-15,15,0
"D02SC",539,489,"1200x900",1000,0,600,400,"True",88,604,596,-8,8,1
"D02SC",540,522,"1200x900",1000,1,600,400,"False",223,379,575,196,196,0
"D02SC",541,609,"1200x900",1000,2,600,400,"False",697,627,418,-209,209,0
"D02SC",542,96,"1200x900",600,1,600,400,"False",433,458,552,94,94,0
"D02SC",543,105,"1200x900",600,1,600,400,"False",527,440,632,192,192,0
"D02SC",544,56,"1200x900",600,0,600,400,"True",148,491,484,-7,7,0
"D02SC",545,486,"1200x900",1000,0,600,400,"True",102,676,701,25,25,1
"D02SC",546,379,"1200x900",800,2,600,400,"False",994,325,452,127,127,0
"D02SC",547,553,"1200x900",1000,1,600,400,"False",116,712,342,-370,370,0
"D02SC",548,477,"1200x900",1000,0,600,400,"True",88,640,586,-54,54,1
"D02SC",549,27,"1200x900",600,0,600,400,"False",373,309,410,101,101,1
"D02SC",550,50,"1200x900",600,0,600,400,"True",75,582,603,21,21,0
"D02SC",551,600,"1200x900",1000,2,600,400,"False",765,207,426,219,219,0
"D02SC",552,253,"1200x900",800,0,600,400,"True",177,424,430,6,6,1
"D02SC",553,294,"1200x900",800,1,600,400,"False",262,287,164,-123,123,0
"D02SC",554,295,"1200x900",800,1,600,400,"False",471,334,237,-97,97,0
"D02SC",555,45,"1200x900",600,0,600,400,"True",487,678,629,-49,49,1
"D02SC",556,550,"1200x900",1000,1,600,400,"True",301,459,519,60,60,0
"D02SC",557,587,"1200x900",1000,2,600,400,"False",741,686,395,-291,291,0
"D02SC",558,186,"1200x900",600,2,600,400,"False",997,197,394,197,197,0
"D02SC",559,152,"1200x900",600,2,600,400,"False",971,399,248,-151,151,0
"D02SC",560,498,"1200x900",1000,0,600,400,"True",100,260,236,-24,24,1
"D02SC",561,328,"1200x900",800,1,600,400,"False",104,649,407,-242,242,0
"D02SC",562,158,"1200x900",600,2,600,400,"True",939,300,294,-6,6,0
"D02SC",563,502,"1200x900",1000,0,600,400,"False",111,639,554,-85,85,1
"D02SC",564,60,"1200x900",600,0,600,400,"False",365,213,289,76,76,1
"D02SC",565,182,"1200x900",600,2,600,400,"False",933,389,213,-176,176,0
"D02SC",566,13,"1200x900",600,0,600,400,"False",296,211,275,64,64,1
"D02SC",567,156,"1200x900",600,2,600,400,"False",913,197,373,176,176,0
"D02SC",568,79,"1200x900",600,1,600,400,"True",731,289,231,-58,58,0
"D02SC",569,299,"1200x900",800,1,600,400,"False",779,274,353,79,79,0
"D02SC",570,249,"1200x900",800,0,600,400,"True",126,306,303,-3,3,1
"D02SC",571,378,"1200x900",800,2,600,400,"False",1018,708,438,-270,270,0
"D02SC",572,372,"1200x900",800,2,600,400,"True",833,620,564,-56,56,0
"D02SC",573,515,"1200x900",1000,1,600,400,"True",307,217,244,27,27,0
"D02SC",574,494,"1200x900",1000,0,600,400,"False",127,692,618,-74,74,1
"D02SC",575,337,"1200x900",800,1,600,400,"True",299,622,601,-21,21,0
"D02SC",576,416,"1200x900",800,2,600,400,"False",748,617,415,-202,202,0
"D02SC",577,552,"1200x900",1000,1,600,400,"False",255,412,547,135,135,0
"D02SC",578,227,"1200x900",800,0,600,400,"True",196,551,484,-67,67,1
"D02SC",579,331,"1200x900",800,1,600,400,"True",240,620,591,-29,29,0
"D02SC",580,560,"1200x900",1000,1,600,400,"False",516,693,609,-84,84,0
"D02SC",581,346,"1200x900",800,1,600,400,"True",269,635,610,-25,25,0
"D02SC",582,117,"1200x900",600,1,600,400,"False",711,456,309,-147,147,0
"D02SC",583,533,"1200x900",1000,1,600,400,"False",355,483,614,131,131,0
"D02SC",584,369,"1200x900",800,2,600,400,"True",903,594,627,33,33,0
"D02SC",585,323,"1200x900",800,1,600,400,"False",388,348,475,127,127,0
"D02SC",586,200,"1200x900",600,2,600,400,"True",897,302,288,-14,14,0
"D02SC",587,215,"1200x900",600,2,600,400,"False",939,596,378,-218,218,0
"D02SC",588,516,"1200x900",1000,1,600,400,"True",440,559,532,-27,27,0
"D02SC",589,94,"1200x900",600,1,600,400,"True",729,482,526,44,44,0
"D02SC",590,176,"1200x900",600,2,600,400,"False",1033,281,225,-56,56,0
"D02SC",591,266,"1200x900",800,0,600,400,"False",126,303,197,-106,106,1
"D02SC",592,466,"1200x900",1000,0,600,400,"True",82,205,190,-15,15,1
"D02SC",593,471,"1200x900",1000,0,600,400,"True",122,200,189,-11,11,1
"D02SC",595,604,"1200x900",1000,2,600,400,"True",459,593,555,-38,38,0
"D02SC",597,546,"1200x900",1000,1,600,400,"False",305,374,527,153,153,0
"D02SC",598,256,"1200x900",800,0,600,400,"False",192,656,583,-73,73,1
"D02SC",599,648,"1200x900",1000,2,600,400,"True",557,394,408,14,14,0
"D02SC",600,205,"1200x900",600,2,600,400,"False",1021,504,565,61,61,0
"D02SC",601,271,"1200x900",800,0,600,400,"True",74,360,413,53,53,1
"D02SC",602,4,"1200x900",600,0,600,400,"False",602,200,264,64,64,1
"D02SC",603,108,"1200x900",600,1,600,400,"True",830,239,286,47,47,0
"D02SC",604,390,"1200x900",800,2,600,400,"True",982,674,592,-82,82,1
"D02SC",605,612,"1200x900",1000,2,600,400,"False",706,198,379,181,181,0
"D02SC",606,85,"1200x900",600,1,600,400,"False",434,347,540,193,193,0
"D02SC",607,63,"1200x900",600,0,600,400,"True",311,188,202,14,14,1
"D02SC",608,130,"1200x900",600,1,600,400,"True",741,428,468,40,40,0
"D02SC",609,198,"1200x900",600,2,600,400,"True",976,500,474,-26,26,0
"D02SC",610,400,"1200x900",800,2,600,400,"True",733,297,294,-3,3,0
"D02SC",611,584,"1200x900",1000,2,600,400,"False",731,413,339,-74,74,0
"D02SC",613,77,"1200x900",600,1,600,400,"False",780,525,447,-78,78,0
"D02SC",614,184,"1200x900",600,2,600,400,"False",1067,441,728,287,287,0
"D02SC",615,311,"1200x900",800,1,600,400,"False",710,261,591,330,330,0
"D02SC",616,548,"1200x900",1000,1,600,400,"False",103,278,344,66,66,0
"D02SC",617,540,"1200x900",1000,1,600,400,"True",389,568,519,-49,49,1
"D02SC",618,572,"1200x900",1000,1,600,400,"False",302,260,411,151,151,0
"D02SC",619,97,"1200x900",600,1,600,400,"True",760,643,688,45,45,1
"D02SC",620,626,"1200x900",1000,2,600,400,"False",329,449,573,124,124,0
"D02SC",621,585,"1200x900",1000,2,600,400,"False",698,688,412,-276,276,1
"D02SC",622,383,"1200x900",800,2,600,400,"True",855,407,352,-55,55,0
"D02SC",623,565,"1200x900",1000,1,600,400,"True",451,562,593,31,31,0
"D02SC",624,530,"1200x900",1000,1,600,400,"False",584,405,233,-172,172,1
"D02SC",625,28,"1200x900",600,0,600,400,"True",336,410,453,43,43,1
"D02SC",626,436,"1200x900",1000,0,600,400,"True",82,617,620,3,3,1
"D02SC",627,262,"1200x900",800,0,600,400,"True",196,481,452,-29,29,1
"D02SC",628,399,"1200x900",800,2,600,400,"True",603,602,611,9,9,0
"D02SC",629,287,"1200x900",800,0,600,400,"False",120,567,645,78,78,1
"D02SC",630,491,"1200x900",1000,0,600,400,"False",108,198,351,153,153,1
"D02SC",631,536,"1200x900",1000,1,600,400,"True",580,213,256,43,43,0
"D02SC",632,519,"1200x900",1000,1,600,400,"False",319,565,681,116,116,1
"D02SC",633,438,"1200x900",1000,0,600,400,"True",77,713,769,56,56,1
"D02SC",634,417,"1200x900",800,2,600,400,"False",750,280,471,191,191,0
"D02SC",635,440,"1200x900",1000,0,600,400,"True",71,237,297,60,60,1
"D02SC",636,454,"1200x900",1000,0,600,400,"False",78,687,620,-67,67,1
"D02SC",637,23,"1200x900",600,0,600,400,"False",308,463,531,68,68,1
"D02SC",638,314,"1200x900",800,1,600,400,"True",277,616,646,30,30,1
"D02SC",639,603,"1200x900",1000,2,600,400,"True",693,280,326,46,46,0
"D02SC",640,344,"1200x900",800,1,600,400,"False",589,408,331,-77,77,0
"D02SC",641,273,"1200x900",800,0,600,400,"True",180,309,264,-45,45,1
"D02SC",642,202,"1200x900",600,2,600,400,"False",966,460,376,-84,84,0
"D02SC",643,484,"1200x900",1000,0,600,400,"True",100,223,270,47,47,1
"D02SC",644,545,"1200x900",1000,1,600,400,"True",358,562,623,61,61,0
"D02SC",645,58,"1200x900",600,0,600,400,"True",353,655,654,-1,1,1
"D02SC",646,539,"1200x900",1000,1,600,400,"False",510,383,505,122,122,0
"D02SC",647,364,"1200x900",800,2,600,400,"False",1018,204,327,123,123,0
"D02SC",648,391,"1200x900",800,2,600,400,"True",895,521,517,-4,4,0
"D03KT",1,627,"1200x900",1000,2,600,400,"False",760,510,601,91,91,0
"D03KT",2,574,"1200x900",1000,1,600,400,"False",614,194,837,643,643,0
"D03KT",3,319,"1200x900",800,1,600,400,"False",494,587,728,141,141,1
"D03KT",4,606,"1200x900",1000,2,600,400,"False",653,627,537,-90,90,0
"D03KT",5,629,"1200x900",1000,2,600,400,"False",681,257,709,452,452,0
"D03KT",6,78,"1200x900",600,1,600,400,"True",885,684,681,-3,3,0
"D03KT",7,245,"1200x900",800,0,600,400,"False",296,235,447,212,212,1
"D03KT",8,5,"1200x900",600,0,600,400,"True",228,587,548,-39,39,0
"D03KT",9,631,"1200x900",1000,2,600,400,"True",699,479,513,34,34,0
"D03KT",10,160,"1200x900",600,2,600,400,"True",863,606,568,-38,38,0
"D03KT",11,487,"1200x900",1000,0,600,400,"False",78,670,444,-226,226,1
"D03KT",12,91,"1200x900",600,1,600,400,"False",417,630,850,220,220,1
"D03KT",13,378,"1200x900",800,2,600,400,"False",1018,708,374,-334,334,0
"D03KT",14,422,"1200x900",800,2,600,400,"False",712,558,471,-87,87,0
"D03KT",15,18,"1200x900",600,0,600,400,"False",400,318,590,272,272,1
"D03KT",16,202,"1200x900",600,2,600,400,"True",966,460,457,-3,3,0
"D03KT",17,497,"1200x900",1000,0,600,400,"True",106,696,672,-24,24,1
"D03KT",18,373,"1200x900",800,2,600,400,"True",694,326,364,38,38,0
"D03KT",19,526,"1200x900",1000,1,600,400,"True",497,710,777,67,67,0
"D03KT",20,287,"1200x900",800,0,600,400,"True",120,567,506,-61,61,1
"D03KT",21,257,"1200x900",800,0,600,400,"False",97,219,391,172,172,1
"D03KT",22,459,"1200x900",1000,0,600,400,"True",70,645,643,-2,2,1
"D03KT",23,235,"1200x900",800,0,600,400,"False",146,646,575,-71,71,1
"D03KT",24,527,"1200x900",1000,1,600,400,"True",565,601,564,-37,37,0
"D03KT",25,129,"1200x900",600,1,600,400,"False",859,482,417,-65,65,1
"D03KT",26,294,"1200x900",800,1,600,400,"False",262,287,850,563,563,0
"D03KT",27,508,"1200x900",1000,1,600,400,"False",596,485,556,71,71,0
"D03KT",28,230,"1200x900",800,0,600,400,"False",99,678,586,-92,92,1
"D03KT",29,243,"1200x900",800,0,600,400,"True",114,332,334,2,2,1
"D03KT",30,83,"1200x900",600,1,600,400,"False",763,568,410,-158,158,1
"D03KT",31,374,"1200x900",800,2,600,400,"True",755,450,424,-26,26,0
"D03KT",32,41,"1200x900",600,0,600,400,"True",370,452,485,33,33,1
"D03KT",33,334,"1200x900",800,1,600,400,"False",481,665,416,-249,249,0
"D03KT",34,388,"1200x900",800,2,600,400,"False",930,320,488,168,168,0
"D03KT",35,495,"1200x900",1000,0,600,400,"False",93,692,464,-228,228,1
"D03KT",36,93,"1200x900",600,1,600,400,"False",139,540,378,-162,162,0
"D03KT",37,417,"1200x900",800,2,600,400,"False",750,280,386,106,106,0
"D03KT",38,99,"1200x900",600,1,600,400,"True",811,407,466,59,59,0
"D03KT",39,261,"1200x900",800,0,600,400,"False",86,713,521,-192,192,1
"D03KT",40,172,"1200x900",600,2,600,400,"False",912,444,373,-71,71,0
"D03KT",41,276,"1200x900",800,0,600,400,"False",281,217,327,110,110,1
"D03KT",42,569,"1200x900",1000,1,600,400,"False",494,720,464,-256,256,0
"D03KT",43,592,"1200x900",1000,2,600,400,"True",492,392,403,11,11,0
"D03KT",44,386,"1200x900",800,2,600,400,"True",774,301,335,34,34,0
"D03KT",45,6,"1200x900",600,0,600,400,"False",217,689,617,-72,72,1
"D03KT",46,163,"1200x900",600,2,600,400,"True",1046,665,561,-104,104,0
"D03KT",47,127,"1200x900",600,1,600,400,"True",309,691,697,6,6,0
"D03KT",48,504,"1200x900",1000,0,600,400,"False",107,699,518,-181,181,1
"D03KT",49,412,"1200x900",800,2,600,400,"False",842,280,537,257,257,0
"D03KT",50,647,"1200x900",1000,2,600,400,"False",560,637,424,-213,213,0
"D03KT",51,263,"1200x900",800,0,600,400,"True",82,396,442,46,46,1
"D03KT",52,73,"1200x900",600,1,600,400,"False",94,665,850,185,185,0
"D03KT",53,357,"1200x900",800,1,600,400,"False",109,594,682,88,88,0
"D03KT",54,86,"1200x900",600,1,600,400,"False",692,388,502,114,114,1
"D03KT",55,546,"1200x900",1000,1,600,400,"True",305,374,395,21,21,0
"D03KT",56,458,"1200x900",1000,0,600,400,"False",78,624,426,-198,198,1
"D03KT",57,518,"1200x900",1000,1,600,400,"False",583,717,296,-421,421,0
"D03KT",58,301,"1200x900",800,1,600,400,"False",162,574,806,232,232,0
"D03KT",59,250,"1200x900",800,0,600,400,"False",290,248,406,158,158,1
"D03KT",60,168,"1200x900",600,2,600,400,"True",1001,439,504,65,65,0
"D03KT",61,498,"1200x900",1000,0,600,400,"False",100,260,399,139,139,1
"D03KT",62,153,"1200x900",600,2,600,400,"False",1037,601,850,249,249,0
"D03KT",63,298,"1200x900",800,1,600,400,"True",311,457,497,40,40,0
"D03KT",64,295,"1200x900",800,1,600,400,"False",471,334,462,128,128,0
"D03KT",65,539,"1200x900",1000,1,600,400,"True",510,383,356,-27,27,0
"D03KT",66,11,"1200x900",600,0,600,400,"False",372,670,577,-93,93,1
"D03KT",67,268,"1200x900",800,0,600,400,"True",148,400,352,-48,48,1
"D03KT",68,379,"1200x900",800,2,600,400,"True",994,325,351,26,26,0
"D03KT",69,642,"1200x900",1000,2,600,400,"False",776,316,423,107,107,0
"D03KT",70,135,"1200x900",600,1,600,400,"False",759,569,399,-170,170,0
"D03KT",71,573,"1200x900",1000,1,600,400,"False",486,615,512,-103,103,0
"D03KT",72,13,"1200x900",600,0,600,400,"False",296,211,446,235,235,1
"D03KT",73,599,"1200x900",1000,2,600,400,"False",316,570,353,-217,217,0
"D03KT",74,372,"1200x900",800,2,600,400,"False",833,620,409,-211,211,0
"D03KT",75,360,"1200x900",800,1,600,400,"False",203,608,681,73,73,0
"D03KT",76,328,"1200x900",800,1,600,400,"True",104,649,612,-37,37,0
"D03KT",77,643,"1200x900",1000,2,600,400,"False",740,325,452,127,127,0
"D03KT",78,29,"1200x900",600,0,600,400,"False",385,533,619,86,86,1
"D03KT",79,628,"1200x900",1000,2,600,400,"False",768,410,597,187,187,0
"D03KT",80,177,"1200x900",600,2,600,400,"False",912,236,553,317,317,0
"D03KT",81,170,"1200x900",600,2,600,400,"False",996,468,407,-61,61,0
"D03KT",82,194,"1200x900",600,2,600,400,"False",896,236,391,155,155,0
"D03KT",83,626,"1200x900",1000,2,600,400,"False",329,449,593,144,144,0
"D03KT",84,589,"1200x900",1000,2,600,400,"False",856,418,675,257,257,0
"D03KT",85,330,"1200x900",800,1,600,400,"True",759,301,291,-10,10,1
"D03KT",86,415,"1200x900",800,2,600,400,"False",823,684,504,-180,180,0
"D03KT",87,403,"1200x900",800,2,600,400,"True",625,704,670,-34,34,0
"D03KT",88,345,"1200x900",800,1,600,400,"False",841,566,691,125,125,1
"D03KT",89,105,"1200x900",600,1,600,400,"False",527,440,630,190,190,0
"D03KT",90,421,"1200x900",800,2,600,400,"False",898,394,529,135,135,0
"D03KT",91,56,"1200x900",600,0,600,400,"True",148,491,431,-60,60,0
"D03KT",92,431,"1200x900",800,2,600,400,"False",694,382,484,102,102,0
"D03KT",93,280,"1200x900",800,0,600,400,"False",104,302,413,111,111,1
"D03KT",94,523,"1200x900",1000,1,600,400,"True",339,318,352,34,34,0
"D03KT",95,392,"1200x900",800,2,600,400,"True",1031,618,616,-2,2,0
"D03KT",96,210,"1200x900",600,2,600,400,"True",835,506,520,14,14,0
"D03KT",97,369,"1200x900",800,2,600,400,"True",903,594,499,-95,95,0
"D03KT",98,365,"1200x900",800,2,600,400,"False",1055,305,607,302,302,0
"D03KT",99,451,"1200x900",1000,0,600,400,"False",110,702,582,-120,120,1
"D03KT",100,81,"1200x900",600,1,600,400,"False",696,225,389,164,164,0
"D03KT",101,191,"1200x900",600,2,600,400,"False",962,396,264,-132,132,0
"D03KT",102,455,"1200x900",1000,0,600,400,"False",107,718,513,-205,205,1
"D03KT",103,271,"1200x900",800,0,600,400,"False",74,360,600,240,240,1
"D03KT",104,179,"1200x900",600,2,600,400,"False",908,602,751,149,149,0
"D03KT",105,515,"1200x900",1000,1,600,400,"False",307,217,336,119,119,0
"D03KT",106,447,"1200x900",1000,0,600,400,"False",71,339,423,84,84,1
"D03KT",107,617,"1200x900",1000,2,600,400,"True",294,180,242,62,62,0
"D03KT",108,548,"1200x900",1000,1,600,400,"False",103,278,567,289,289,0
"D03KT",109,645,"1200x900",1000,2,600,400,"True",619,396,358,-38,38,0
"D03KT",110,110,"1200x900",600,1,600,400,"False",776,550,415,-135,135,1
"D03KT",111,275,"1200x900",800,0,600,400,"False",120,594,487,-107,107,0
"D03KT",112,283,"1200x900",800,0,600,400,"True",90,264,319,55,55,1
"D03KT",113,62,"1200x900",600,0,600,400,"True",345,346,329,-17,17,1
"D03KT",114,572,"1200x900",1000,1,600,400,"True",302,260,311,51,51,0
"D03KT",115,389,"1200x900",800,2,600,400,"False",843,530,346,-184,184,0
"D03KT",116,444,"1200x900",1000,0,600,400,"False",101,714,466,-248,248,1
"D03KT",117,288,"1200x900",800,0,600,400,"True",180,547,577,30,30,1
"D03KT",118,306,"1200x900",800,1,600,400,"True",164,524,480,-44,44,0
"D03KT",119,520,"1200x900",1000,1,600,400,"False",564,260,389,129,129,0
"D03KT",120,471,"1200x900",1000,0,600,400,"False",122,200,332,132,132,1
"D03KT",121,549,"1200x900",1000,1,600,400,"False",657,366,459,93,93,0
"D03KT",122,383,"1200x900",800,2,600,400,"True",855,407,467,60,60,0
"D03KT",123,102,"1200x900",600,1,600,400,"False",861,603,407,-196,196,0
"D03KT",124,565,"1200x900",1000,1,600,400,"False",451,562,447,-115,115,0
"D03KT",125,401,"1200x900",800,2,600,400,"False",821,260,604,344,344,0
"D03KT",126,247,"1200x900",800,0,600,400,"True",160,424,424,0,0,1
"D03KT",127,593,"1200x900",1000,2,600,400,"False",246,719,485,-234,234,0
"D03KT",128,136,"1200x900",600,1,600,400,"False",264,205,383,178,178,0
"D03KT",129,611,"1200x900",1000,2,600,400,"False",414,511,273,-238,238,0
"D03KT",130,341,"1200x900",800,1,600,400,"False",735,632,317,-315,315,1
"D03KT",131,44,"1200x900",600,0,600,400,"True",305,554,539,-15,15,1
"D03KT",132,630,"1200x900",1000,2,600,400,"False",754,559,375,-184,184,0
"D03KT",133,30,"1200x900",600,0,600,400,"True",107,353,403,50,50,0
"D03KT",134,305,"1200x900",800,1,600,400,"False",471,716,382,-334,334,0
"D03KT",135,47,"1200x900",600,0,600,400,"True",303,499,445,-54,54,1
"D03KT",136,45,"1200x900",600,0,600,400,"False",487,678,503,-175,175,1
"D03KT",137,216,"1200x900",600,2,600,400,"False",1029,286,605,319,319,0
"D03KT",138,605,"1200x900",1000,2,600,400,"False",493,665,583,-82,82,0
"D03KT",139,246,"1200x900",800,0,600,400,"False",196,418,535,117,117,1
"D03KT",140,159,"1200x900",600,2,600,400,"False",992,309,542,233,233,0
"D03KT",141,150,"1200x900",600,2,600,400,"False",897,345,200,-145,145,0
"D03KT",142,443,"1200x900",1000,0,600,400,"False",99,651,470,-181,181,1
"D03KT",143,181,"1200x900",600,2,600,400,"False",1018,223,492,269,269,0
"D03KT",144,324,"1200x900",800,1,600,400,"False",719,712,259,-453,453,1
"D03KT",145,158,"1200x900",600,2,600,400,"False",939,300,414,114,114,0
"D03KT",146,156,"1200x900",600,2,600,400,"False",913,197,402,205,205,0
"D03KT",147,302,"1200x900",800,1,600,400,"False",479,467,748,281,281,1
"D03KT",148,480,"1200x900",1000,0,600,400,"False",100,231,447,216,216,1
"D03KT",149,251,"1200x900",800,0,600,400,"True",88,352,368,16,16,1
"D03KT",150,339,"1200x900",800,1,600,400,"False",273,545,397,-148,148,1
"D03KT",151,217,"1200x900",800,0,600,400,"False",85,573,436,-137,137,1
"D03KT",152,558,"1200x900",1000,1,600,400,"False",72,464,405,-59,59,1
"D03KT",153,433,"1200x900",1000,0,600,400,"False",76,222,410,188,188,1
"D03KT",154,94,"1200x900",600,1,600,400,"False",729,482,375,-107,107,0
"D03KT",155,561,"1200x900",1000,1,600,400,"False",231,406,709,303,303,0
"D03KT",156,82,"1200x900",600,1,600,400,"False",108,213,333,120,120,0
"D03KT",157,567,"1200x900",1000,1,600,400,"True",655,297,384,87,87,1
"D03KT",158,427,"1200x900",800,2,600,400,"True",812,380,398,18,18,0
"D03KT",159,481,"1200x900",1000,0,600,400,"False",80,185,313,128,128,1
"D03KT",160,586,"1200x900",1000,2,600,400,"False",802,262,391,129,129,0
"D03KT",161,620,"1200x900",1000,2,600,400,"False",832,649,430,-219,219,0
"D03KT",162,469,"1200x900",1000,0,600,400,"False",73,227,334,107,107,1
"D03KT",163,27,"1200x900",600,0,600,400,"False",373,309,377,68,68,1
"D03KT",164,138,"1200x900",600,1,600,400,"True",844,580,596,16,16,1
"D03KT",165,140,"1200x900",600,1,600,400,"True",700,523,509,-14,14,0
"D03KT",166,38,"1200x900",600,0,600,400,"False",120,628,513,-115,115,1
"D03KT",167,381,"1200x900",800,2,600,400,"True",705,408,455,47,47,0
"D03KT",168,103,"1200x900",600,1,600,400,"False",528,320,537,217,217,1
"D03KT",169,165,"1200x900",600,2,600,400,"True",912,554,490,-64,64,0
"D03KT",170,364,"1200x900",800,2,600,400,"False",1018,204,543,339,339,0
"D03KT",171,368,"1200x900",800,2,600,400,"True",778,515,493,-22,22,0
"D03KT",172,440,"1200x900",1000,0,600,400,"False",71,237,351,114,114,1
"D03KT",173,96,"1200x900",600,1,600,400,"True",433,458,458,0,0,0
"D03KT",174,155,"1200x900",600,2,600,400,"False",940,269,480,211,211,0
"D03KT",175,488,"1200x900",1000,0,600,400,"False",129,687,347,-340,340,1
"D03KT",176,503,"1200x900",1000,0,600,400,"False",86,279,462,183,183,1
"D03KT",177,164,"1200x900",600,2,600,400,"False",1051,268,531,263,263,0
"D03KT",178,614,"1200x900",1000,2,600,400,"False",823,563,431,-132,132,0
"D03KT",179,468,"1200x900",1000,0,600,400,"False",121,219,325,106,106,1
"D03KT",180,12,"1200x900",600,0,600,400,"True",365,336,298,-38,38,1
"D03KT",181,419,"1200x900",800,2,600,400,"False",769,351,612,261,261,0
"D03KT",182,85,"1200x900",600,1,600,400,"False",434,347,691,344,344,0
"D03KT",183,610,"1200x900",1000,2,600,400,"False",702,293,562,269,269,0
"D03KT",184,51,"1200x900",600,0,600,400,"True",272,181,134,-47,47,1
"D03KT",185,323,"1200x900",800,1,600,400,"False",388,348,425,77,77,0
"D03KT",186,234,"1200x900",800,0,600,400,"True",72,344,410,66,66,1
"D03KT",187,400,"1200x900",800,2,600,400,"False",733,297,424,127,127,0
"D03KT",188,190,"1200x900",600,2,600,400,"False",977,238,434,196,196,0
"D03KT",189,581,"1200x900",1000,2,600,400,"True",310,357,356,-1,1,0
"D03KT",190,536,"1200x900",1000,1,600,400,"False",580,213,333,120,120,0
"D03KT",191,75,"1200x900",600,1,600,400,"True",635,558,516,-42,42,0
"D03KT",192,542,"1200x900",1000,1,600,400,"True",304,401,469,68,68,0
"D03KT",193,126,"1200x900",600,1,600,400,"False",849,354,253,-101,101,0
"D03KT",194,248,"1200x900",800,0,600,400,"True",94,240,296,56,56,1
"D03KT",195,240,"1200x900",800,0,600,400,"False",330,656,349,-307,307,1
"D03KT",196,113,"1200x900",600,1,600,400,"False",897,657,355,-302,302,0
"D03KT",197,448,"1200x900",1000,0,600,400,"False",107,641,395,-246,246,1
"D03KT",198,396,"1200x900",800,2,600,400,"False",678,663,426,-237,237,0
"D03KT",199,462,"1200x900",1000,0,600,400,"False",102,672,466,-206,206,1
"D03KT",200,193,"1200x900",600,2,600,400,"True",874,588,520,-68,68,0
"D03KT",201,225,"1200x900",800,0,600,400,"False",178,423,342,-81,81,1
"D03KT",202,425,"1200x900",800,2,600,400,"False",621,438,355,-83,83,0
"D03KT",203,92,"1200x900",600,1,600,400,"True",624,605,546,-59,59,0
"D03KT",204,237,"1200x900",800,0,600,400,"True",204,481,521,40,40,1
"D03KT",205,457,"1200x900",1000,0,600,400,"False",97,630,518,-112,112,1
"D03KT",206,1,"1200x900",600,0,600,400,"True",136,502,532,30,30,0
"D03KT",207,16,"1200x900",600,0,600,400,"True",297,514,520,6,6,1
"D03KT",208,446,"1200x900",1000,0,600,400,"False",72,298,564,266,266,1
"D03KT",209,423,"1200x900",800,2,600,400,"False",1051,710,392,-318,318,1
"D03KT",210,17,"1200x900",600,0,600,400,"False",402,496,414,-82,82,1
"D03KT",211,49,"1200x900",600,0,600,400,"True",109,380,436,56,56,0
"D03KT",212,154,"1200x900",600,2,600,400,"False",941,454,565,111,111,0
"D03KT",213,279,"1200x900",800,0,600,400,"False",252,202,461,259,259,1
"D03KT",214,186,"1200x900",600,2,600,400,"False",997,197,381,184,184,0
"D03KT",215,242,"1200x900",800,0,600,400,"False",117,448,346,-102,102,1
"D03KT",216,640,"1200x900",1000,2,600,400,"True",361,334,316,-18,18,0
"D03KT",217,219,"1200x900",800,0,600,400,"True",202,502,507,5,5,1
"D03KT",218,209,"1200x900",600,2,600,400,"False",937,637,486,-151,151,0
"D03KT",219,227,"1200x900",800,0,600,400,"True",196,551,562,11,11,1
"D03KT",220,559,"1200x900",1000,1,600,400,"True",641,244,214,-30,30,0
"D03KT",221,355,"1200x900",800,1,600,400,"True",77,386,434,48,48,0
"D03KT",222,74,"1200x900",600,1,600,400,"True",115,358,435,77,77,0
"D03KT",223,318,"1200x900",800,1,600,400,"False",788,534,651,117,117,0
"D03KT",224,399,"1200x900",800,2,600,400,"False",603,602,441,-161,161,0
"D03KT",225,560,"1200x900",1000,1,600,400,"False",516,693,525,-168,168,0
"D03KT",226,134,"1200x900",600,1,600,400,"False",300,188,527,339,339,0
"D03KT",227,432,"1200x900",800,2,600,400,"True",792,380,399,19,19,0
"D03KT",228,460,"1200x900",1000,0,600,400,"False",155,189,365,176,176,1
"D03KT",229,48,"1200x900",600,0,600,400,"False",323,645,520,-125,125,1
"D03KT",230,615,"1200x900",1000,2,600,400,"False",736,634,524,-110,110,0
"D03KT",231,353,"1200x900",800,1,600,400,"False",90,476,555,79,79,0
"D03KT",232,34,"1200x900",600,0,600,400,"False",361,242,368,126,126,1
"D03KT",233,435,"1200x900",1000,0,600,400,"False",119,200,288,88,88,1
"D03KT",234,375,"1200x900",800,2,600,400,"False",716,384,294,-90,90,0
"D03KT",235,119,"1200x900",600,1,600,400,"False",168,563,321,-242,242,0
"D03KT",236,308,"1200x900",800,1,600,400,"False",437,425,508,83,83,0
"D03KT",237,218,"1200x900",800,0,600,400,"True",106,397,455,58,58,1
"D03KT",238,538,"1200x900",1000,1,600,400,"True",308,457,421,-36,36,1
"D03KT",239,587,"1200x900",1000,2,600,400,"False",741,686,453,-233,233,0
"D03KT",240,68,"1200x900",600,0,600,400,"True",165,367,371,4,4,0
"D03KT",241,123,"1200x900",600,1,600,400,"False",761,365,467,102,102,1
"D03KT",242,116,"1200x900",600,1,600,400,"False",767,289,436,147,147,0
"D03KT",243,397,"1200x900",800,2,600,400,"False",817,692,476,-216,216,0
"D03KT",244,639,"1200x900",1000,2,600,400,"True",504,456,429,-27,27,0
"D03KT",245,267,"1200x900",800,0,600,400,"True",145,665,614,-51,51,1
"D03KT",246,100,"1200x900",600,1,600,400,"True",453,511,612,101,101,0
"D03KT",247,352,"1200x900",800,1,600,400,"True",235,717,729,12,12,0
"D03KT",248,286,"1200x900",800,0,600,400,"False",105,378,475,97,97,1
"D03KT",249,371,"1200x900",800,2,600,400,"True",730,560,603,43,43,0
"D03KT",250,582,"1200x900",1000,2,600,400,"True",554,347,384,37,37,0
"D03KT",251,543,"1200x900",1000,1,600,400,"False",88,202,518,316,316,0
"D03KT",252,167,"1200x900",600,2,600,400,"False",956,241,151,-90,90,0
"D03KT",253,332,"1200x900",800,1,600,400,"False",260,699,597,-102,102,0
"D03KT",254,416,"1200x900",800,2,600,400,"True",748,617,562,-55,55,0
"D03KT",255,499,"1200x900",1000,0,600,400,"False",93,271,399,128,128,1
"D03KT",256,79,"1200x900",600,1,600,400,"True",731,289,340,51,51,0
"D03KT",257,438,"1200x900",1000,0,600,400,"False",77,713,450,-263,263,1
"D03KT",258,133,"1200x900",600,1,600,400,"False",345,551,846,295,295,0
"D03KT",259,199,"1200x900",600,2,600,400,"True",992,467,559,92,92,0
"D03KT",260,625,"1200x900",1000,2,600,400,"False",279,228,322,94,94,0
"D03KT",261,108,"1200x900",600,1,600,400,"True",830,239,233,-6,6,0
"D03KT",262,349,"1200x900",800,1,600,400,"False",402,665,489,-176,176,0
"D03KT",263,204,"1200x900",600,2,600,400,"True",1053,432,388,-44,44,0
"D03KT",264,215,"1200x900",600,2,600,400,"False",939,596,440,-156,156,0
"D03KT",265,145,"1200x900",600,2,600,400,"True",1004,630,598,-32,32,0
"D03KT",266,441,"1200x900",1000,0,600,400,"False",85,684,481,-203,203,1
"D03KT",267,61,"1200x900",600,0,600,400,"False",272,670,597,-73,73,1
"D03KT",268,148,"1200x900",600,2,600,400,"False",907,330,623,293,293,0
"D03KT",269,307,"1200x900",800,1,600,400,"False",716,247,317,70,70,0
"D03KT",270,72,"1200x900",600,0,600,400,"True",158,537,514,-23,23,0
"D03KT",271,490,"1200x900",1000,0,600,400,"False",114,183,457,274,274,1
"D03KT",272,476,"1200x900",1000,0,600,400,"False",76,359,238,-121,121,1
"D03KT",273,604,"1200x900",1000,2,600,400,"False",459,593,385,-208,208,0
"D03KT",274,505,"1200x900",1000,1,600,400,"False",191,484,331,-153,153,1
"D03KT",275,641,"1200x900",1000,2,600,400,"False",897,272,472,200,200,0
"D03KT",276,238,"1200x900",800,0,600,400,"False",162,283,366,83,83,1
"D03KT",277,104,"1200x900",600,1,600,400,"False",448,584,463,-121,121,0
"D03KT",278,273,"1200x900",800,0,600,400,"False",180,309,398,89,89,1
"D03KT",279,522,"1200x900",1000,1,600,400,"False",223,379,453,74,74,0
"D03KT",280,395,"1200x900",800,2,600,400,"False",743,334,465,131,131,0
"D03KT",281,101,"1200x900",600,1,600,400,"False",541,656,456,-200,200,0
"D03KT",282,478,"1200x900",1000,0,600,400,"False",79,672,511,-161,161,1
"D03KT",283,316,"1200x900",800,1,600,400,"False",362,319,598,279,279,0
"D03KT",284,571,"1200x900",1000,1,600,400,"False",239,522,620,98,98,1
"D03KT",285,130,"1200x900",600,1,600,400,"True",741,428,372,-56,56,0
"D03KT",286,139,"1200x900",600,1,600,400,"False",192,695,470,-225,225,0
"D03KT",287,19,"1200x900",600,0,600,400,"False",286,686,519,-167,167,0
"D03KT",288,122,"1200x900",600,1,600,400,"False",817,709,524,-185,185,0
"D03KT",289,157,"1200x900",600,2,600,400,"False",1016,323,446,123,123,0
"D03KT",290,147,"1200x900",600,2,600,400,"False",942,418,346,-72,72,0
"D03KT",291,609,"1200x900",1000,2,600,400,"False",697,627,460,-167,167,0
"D03KT",292,229,"1200x900",800,0,600,400,"False",117,697,518,-179,179,1
"D03KT",293,534,"1200x900",1000,1,600,400,"True",328,504,517,13,13,1
"D03KT",294,404,"1200x900",800,2,600,400,"True",842,396,454,58,58,0
"D03KT",295,281,"1200x900",800,0,600,400,"False",112,611,472,-139,139,1
"D03KT",296,289,"1200x900",800,1,600,400,"False",421,703,487,-216,216,1
"D03KT",297,585,"1200x900",1000,2,600,400,"False",698,688,415,-273,273,1
"D03KT",298,292,"1200x900",800,1,600,400,"True",88,565,512,-53,53,0
"D03KT",299,409,"1200x900",800,2,600,400,"False",501,659,490,-169,169,0
"D03KT",300,70,"1200x900",600,0,600,400,"True",309,703,732,29,29,1
"D03KT",301,80,"1200x900",600,1,600,400,"False",616,423,703,280,280,1
"D03KT",302,600,"1200x900",1000,2,600,400,"False",765,207,569,362,362,0
"D03KT",303,384,"1200x900",800,2,600,400,"False",821,707,363,-344,344,0
"D03KT",304,552,"1200x900",1000,1,600,400,"True",255,412,373,-39,39,0
"D03KT",305,406,"1200x900",800,2,600,400,"False",971,233,351,118,118,0
"D03KT",306,367,"1200x900",800,2,600,400,"False",613,464,348,-116,116,0
"D03KT",307,366,"1200x900",800,2,600,400,"False",931,464,359,-105,105,0
"D03KT",308,264,"1200x900",800,0,600,400,"False",198,660,548,-112,112,1
"D03KT",309,285,"1200x900",800,0,600,400,"False",237,396,469,73,73,1
"D03KT",310,335,"1200x900",800,1,600,400,"False",124,360,582,222,222,0
"D03KT",311,299,"1200x900",800,1,600,400,"False",779,274,564,290,290,0
"D03KT",312,473,"1200x900",1000,0,600,400,"False",75,323,567,244,244,1
"D03KT",313,358,"1200x900",800,1,600,400,"False",263,635,468,-167,167,0
"D03KT",314,253,"1200x900",800,0,600,400,"True",177,424,396,-28,28,1
"D03KT",315,344,"1200x900",800,1,600,400,"True",589,408,448,40,40,0
"D03KT",316,10,"1200x900",600,0,600,400,"False",400,499,379,-120,120,1
"D03KT",317,532,"1200x900",1000,1,600,400,"False",215,207,307,100,100,0
"D03KT",318,222,"1200x900",800,0,600,400,"False",152,206,355,149,149,1
"D03KT",319,28,"1200x900",600,0,600,400,"False",336,410,315,-95,95,1
"D03KT",320,530,"1200x900",1000,1,600,400,"False",584,405,179,-226,226,1
"D03KT",321,489,"1200x900",1000,0,600,400,"False",88,604,402,-202,202,1
"D03KT",322,325,"1200x900",800,1,600,400,"True",105,394,374,-20,20,0
"D03KT",323,232,"1200x900",800,0,600,400,"False",84,511,378,-133,133,1
"D03KT",324,206,"1200x900",600,2,600,400,"False",975,223,357,134,134,0
"D03KT",325,131,"1200x900",600,1,600,400,"True",531,367,346,-21,21,0
"D03KT",326,296,"1200x900",800,1,600,400,"False",89,279,395,116,116,0
"D03KT",327,297,"1200x900",800,1,600,400,"True",625,244,213,-31,31,0
"D03KT",328,309,"1200x900",800,1,600,400,"False",186,225,328,103,103,0
"D03KT",329,376,"1200x900",800,2,600,400,"False",788,275,482,207,207,0
"D03KT",330,391,"1200x900",800,2,600,400,"False",895,521,254,-267,267,0
"D03KT",331,613,"1200x900",1000,2,600,400,"True",690,374,353,-21,21,0
"D03KT",332,636,"1200x900",1000,2,600,400,"False",575,583,463,-120,120,0
"D03KT",333,596,"1200x900",1000,2,600,400,"False",706,513,404,-109,109,0
"D03KT",334,486,"1200x900",1000,0,600,400,"False",102,676,387,-289,289,1
"D03KT",335,185,"1200x900",600,2,600,400,"False",907,212,441,229,229,0
"D03KT",336,57,"1200x900",600,0,600,400,"True",354,508,517,9,9,1
"D03KT",337,322,"1200x900",800,1,600,400,"False",703,206,420,214,214,1
"D03KT",338,385,"1200x900",800,2,600,400,"False",740,456,332,-124,124,0
"D03KT",339,407,"1200x900",800,2,600,400,"False",989,340,510,170,170,0
"D03KT",340,42,"1200x900",600,0,600,400,"True",233,479,436,-43,43,0
"D03KT",341,205,"1200x900",600,2,600,400,"True",1021,504,550,46,46,0
"D03KT",342,426,"1200x900",800,2,600,400,"False",830,263,511,248,248,0
"D03KT",343,535,"1200x900",1000,1,600,400,"False",372,410,495,85,85,0
"D03KT",344,514,"1200x900",1000,1,600,400,"False",539,690,409,-281,281,0
"D03KT",345,434,"1200x900",1000,0,600,400,"False",89,657,404,-253,253,1
"D03KT",346,59,"1200x900",600,0,600,400,"True",391,692,678,-14,14,1
"D03KT",347,356,"1200x900",800,1,600,400,"False",123,484,544,60,60,0
"D03KT",348,525,"1200x900",1000,1,600,400,"False",123,690,600,-90,90,0
"D03KT",349,512,"1200x900",1000,1,600,400,"False",139,261,411,150,150,0
"D03KT",350,394,"1200x900",800,2,600,400,"False",847,292,505,213,213,0
"D03KT",351,424,"1200x900",800,2,600,400,"True",903,545,554,9,9,0
"D03KT",352,466,"1200x900",1000,0,600,400,"False",82,205,375,170,170,1
"D03KT",353,241,"1200x900",800,0,600,400,"False",129,227,324,97,97,1
"D03KT",354,87,"1200x900",600,1,600,400,"False",231,604,332,-272,272,0
"D03KT",355,453,"1200x900",1000,0,600,400,"True",71,393,355,-38,38,1
"D03KT",356,580,"1200x900",1000,2,600,400,"False",651,267,472,205,205,0
"D03KT",357,171,"1200x900",600,2,600,400,"False",909,200,382,182,182,0
"D03KT",358,635,"1200x900",1000,2,600,400,"True",833,402,362,-40,40,0
"D03KT",360,576,"1200x900",1000,1,600,400,"True",376,713,681,-32,32,0
"D03KT",361,363,"1200x900",800,2,600,400,"False",800,218,423,205,205,0
"D03KT",362,76,"1200x900",600,1,600,400,"False",647,614,469,-145,145,0
"D03KT",363,65,"1200x900",600,0,600,400,"False",442,645,420,-225,225,1
"D03KT",364,519,"1200x900",1000,1,600,400,"False",319,565,640,75,75,1
"D03KT",365,516,"1200x900",1000,1,600,400,"False",440,559,411,-148,148,0
"D03KT",366,284,"1200x900",800,0,600,400,"False",135,293,390,97,97,1
"D03KT",367,3,"1200x900",600,0,600,400,"True",298,443,405,-38,38,1
"D03KT",368,50,"1200x900",600,0,600,400,"False",75,582,451,-131,131,0
"D03KT",369,196,"1200x900",600,2,600,400,"True",1030,397,428,31,31,0
"D03KT",370,278,"1200x900",800,0,600,400,"False",251,711,508,-203,203,1
"D03KT",371,207,"1200x900",600,2,600,400,"True",838,235,197,-38,38,0
"D03KT",372,233,"1200x900",800,0,600,400,"True",164,700,675,-25,25,1
"D03KT",373,510,"1200x900",1000,1,600,400,"False",486,338,530,192,192,1
"D03KT",374,35,"1200x900",600,0,600,400,"True",366,555,533,-22,22,1
"D03KT",375,398,"1200x900",800,2,600,400,"False",944,698,387,-311,311,0
"D03KT",376,624,"1200x900",1000,2,600,400,"True",693,501,564,63,63,0
"D03KT",377,588,"1200x900",1000,2,600,400,"True",585,350,385,35,35,0
"D03KT",378,524,"1200x900",1000,1,600,400,"True",534,470,395,-75,75,0
"D03KT",379,359,"1200x900",800,1,600,400,"True",653,241,194,-47,47,0
"D03KT",380,15,"1200x900",600,0,600,400,"True",473,352,284,-68,68,1
"D03KT",381,555,"1200x900",1000,1,600,400,"False",444,556,381,-175,175,0
"D03KT",382,260,"1200x900",800,0,600,400,"False",103,525,450,-75,75,1
"D03KT",383,461,"1200x900",1000,0,600,400,"False",95,711,422,-289,289,1
"D03KT",384,180,"1200x900",600,2,600,400,"False",929,270,430,160,160,0
"D03KT",385,84,"1200x900",600,1,600,400,"False",144,184,489,305,305,0
"D03KT",386,583,"1200x900",1000,2,600,400,"False",949,284,537,253,253,1
"D03KT",387,290,"1200x900",800,1,600,400,"False",789,603,342,-261,261,0
"D03KT",388,117,"1200x900",600,1,600,400,"False",711,456,618,162,162,0
"D03KT",389,174,"1200x900",600,2,600,400,"True",998,457,501,44,44,0
"D03KT",390,258,"1200x900",800,0,600,400,"False",126,664,505,-159,159,1
"D03KT",391,304,"1200x900",800,1,600,400,"True",667,605,582,-23,23,0
"D03KT",392,612,"1200x900",1000,2,600,400,"False",706,198,379,181,181,0
"D03KT",393,20,"1200x900",600,0,600,400,"False",204,545,453,-92,92,1
"D03KT",394,494,"1200x900",1000,0,600,400,"False",127,692,377,-315,315,1
"D03KT",395,211,"1200x900",600,2,600,400,"True",986,407,477,70,70,0
"D03KT",396,212,"1200x900",600,2,600,400,"False",841,206,95,-111,111,0
"D03KT",397,98,"1200x900",600,1,600,400,"True",625,530,505,-25,25,0
"D03KT",398,259,"1200x900",800,0,600,400,"False",156,180,352,172,172,1
"D03KT",399,124,"1200x900",600,1,600,400,"True",345,467,427,-40,40,0
"D03KT",400,450,"1200x900",1000,0,600,400,"False",130,204,362,158,158,1
"D03KT",401,321,"1200x900",800,1,600,400,"False",601,190,407,217,217,0
"D03KT",402,638,"1200x900",1000,2,600,400,"False",385,198,282,84,84,0
"D03KT",403,340,"1200x900",800,1,600,400,"False",226,240,356,116,116,0
"D03KT",404,492,"1200x900",1000,0,600,400,"False",76,692,367,-325,325,1
"D03KT",405,252,"1200x900",800,0,600,400,"False",224,673,433,-240,240,1
"D03KT",406,509,"1200x900",1000,1,600,400,"True",509,434,463,29,29,0
"D03KT",407,528,"1200x900",1000,1,600,400,"False",839,227,383,156,156,1
"D03KT",408,597,"1200x900",1000,2,600,400,"True",352,239,232,-7,7,0
"D03KT",409,144,"1200x900",600,1,600,400,"True",718,371,313,-58,58,0
"D03KT",410,203,"1200x900",600,2,600,400,"False",938,603,436,-167,167,0
"D03KT",411,563,"1200x900",1000,1,600,400,"True",201,696,677,-19,19,0
"D03KT",412,608,"1200x900",1000,2,600,400,"False",742,250,506,256,256,0
"D03KT",413,547,"1200x900",1000,1,600,400,"False",369,384,583,199,199,1
"D03KT",414,637,"1200x900",1000,2,600,400,"True",750,460,436,-24,24,0
"D03KT",415,314,"1200x900",800,1,600,400,"False",277,616,431,-185,185,1
"D03KT",416,320,"1200x900",800,1,600,400,"False",644,376,496,120,120,0
"D03KT",417,60,"1200x900",600,0,600,400,"False",365,213,327,114,114,1
"D03KT",418,291,"1200x900",800,1,600,400,"False",522,694,401,-293,293,0
"D03KT",419,553,"1200x900",1000,1,600,400,"False",116,712,514,-198,198,0
"D03KT",420,402,"1200x900",800,2,600,400,"False",878,234,398,164,164,0
"D03KT",421,208,"1200x900",600,2,600,400,"False",946,399,572,173,173,0
"D03KT",422,622,"1200x900",1000,2,600,400,"False",307,683,428,-255,255,0
"D03KT",423,362,"1200x900",800,2,600,400,"False",819,338,527,189,189,0
"D03KT",424,132,"1200x900",600,1,600,400,"False",333,185,485,300,300,0
"D03KT",425,43,"1200x900",600,0,600,400,"True",277,446,421,-25,25,1
"D03KT",426,223,"1200x900",800,0,600,400,"True",179,191,158,-33,33,1
"D03KT",427,408,"1200x900",800,2,600,400,"False",758,567,252,-315,315,0
"D03KT",428,602,"1200x900",1000,2,600,400,"True",865,452,460,8,8,0
"D03KT",429,52,"1200x900",600,0,600,400,"True",171,188,239,51,51,0
"D03KT",430,40,"1200x900",600,0,600,400,"True",143,513,549,36,36,0
"D03KT",431,493,"1200x900",1000,0,600,400,"False",80,582,386,-196,196,1
"D03KT",432,95,"1200x900",600,1,600,400,"False",749,425,519,94,94,1
"D03KT",433,184,"1200x900",600,2,600,400,"True",1067,441,457,16,16,0
"D03KT",434,54,"1200x900",600,0,600,400,"False",474,564,395,-169,169,1
"D03KT",435,46,"1200x900",600,0,600,400,"True",193,355,413,58,58,1
"D03KT",436,479,"1200x900",1000,0,600,400,"False",74,705,389,-316,316,1
"D03KT",437,390,"1200x900",800,2,600,400,"False",982,674,370,-304,304,1
"D03KT",438,616,"1200x900",1000,2,600,400,"False",854,357,496,139,139,1
"D03KT",439,634,"1200x900",1000,2,600,400,"False",735,313,460,147,147,0
"D03KT",440,537,"1200x900",1000,1,600,400,"True",621,412,457,45,45,1
"D03KT",441,125,"1200x900",600,1,600,400,"True",750,531,475,-56,56,0
"D03KT",442,429,"1200x900",800,2,600,400,"False",682,692,526,-166,166,0
"D03KT",443,254,"1200x900",800,0,600,400,"False",136,583,460,-123,123,1
"D03KT",444,511,"1200x900",1000,1,600,400,"True",408,390,448,58,58,1
"D03KT",445,200,"1200x900",600,2,600,400,"True",897,302,363,61,61,0
"D03KT",446,545,"1200x900",1000,1,600,400,"True",358,562,530,-32,32,0
"D03KT",447,36,"1200x900",600,0,600,400,"True",128,346,395,49,49,1
"D03KT",448,570,"1200x900",1000,1,600,400,"False",315,352,229,-123,123,0
"D03KT",449,333,"1200x900",800,1,600,400,"False",521,548,252,-296,296,0
"D03KT",450,311,"1200x900",800,1,600,400,"False",710,261,541,280,280,0
"D03KT",451,270,"1200x900",800,0,600,400,"True",192,418,453,35,35,1
"D03KT",452,224,"1200x900",800,0,600,400,"True",161,474,497,23,23,1
"D03KT",453,22,"1200x900",600,0,600,400,"True",398,591,526,-65,65,1
"D03KT",454,282,"1200x900",800,0,600,400,"False",109,246,464,218,218,1
"D03KT",455,149,"1200x900",600,2,600,400,"False",890,289,515,226,226,0
"D03KT",456,454,"1200x900",1000,0,600,400,"False",78,687,428,-259,259,1
"D03KT",457,474,"1200x900",1000,0,600,400,"False",85,339,422,83,83,1
"D03KT",458,564,"1200x900",1000,1,600,400,"False",215,264,334,70,70,0
"D03KT",459,472,"1200x900",1000,0,600,400,"False",77,685,318,-367,367,1
"D03KT",460,8,"1200x900",600,0,600,400,"False",156,679,406,-273,273,0
"D03KT",461,197,"1200x900",600,2,600,400,"False",903,212,417,205,205,0
"D03KT",462,551,"1200x900",1000,1,600,400,"False",146,445,346,-99,99,1
"D03KT",463,529,"1200x900",1000,1,600,400,"False",267,412,323,-89,89,1
"D03KT",464,370,"1200x900",800,2,600,400,"False",874,336,480,144,144,0
"D03KT",465,188,"1200x900",600,2,600,400,"False",900,195,397,202,202,0
"D03KT",466,256,"1200x900",800,0,600,400,"False",192,656,381,-275,275,1
"D03KT",467,14,"1200x900",600,0,600,400,"False",399,224,430,206,206,1
"D03KT",468,338,"1200x900",800,1,600,400,"False",813,253,449,196,196,1
"D03KT",469,550,"1200x900",1000,1,600,400,"False",301,459,307,-152,152,0
"D03KT",470,531,"1200x900",1000,1,600,400,"False",233,362,263,-99,99,0
"D03KT",471,566,"1200x900",1000,1,600,400,"False",378,472,405,-67,67,1
"D03KT",472,88,"1200x900",600,1,600,400,"True",186,554,497,-57,57,0
"D03KT",473,77,"1200x900",600,1,600,400,"True",780,525,572,47,47,0
"D03KT",474,632,"1200x900",1000,2,600,400,"False",984,227,333,106,106,0
"D03KT",475,7,"1200x900",600,0,600,400,"False",431,654,426,-228,228,1
"D03KT",476,496,"1200x900",1000,0,600,400,"False",70,639,512,-127,127,1
"D03KT",477,182,"1200x900",600,2,600,400,"False",933,389,317,-72,72,0
"D03KT",478,436,"1200x900",1000,0,600,400,"False",82,617,396,-221,221,1
"D03KT",479,442,"1200x900",1000,0,600,400,"False",87,183,283,100,100,1
"D03KT",480,380,"1200x900",800,2,600,400,"False",942,228,381,153,153,0
"D03KT",481,277,"1200x900",800,0,600,400,"False",140,310,166,-144,144,1
"D03KT",482,58,"1200x900",600,0,600,400,"False",353,655,422,-233,233,1
"D03KT",483,189,"1200x900",600,2,600,400,"False",881,397,291,-106,106,0
"D03KT",484,312,"1200x900",800,1,600,400,"True",238,683,608,-75,75,0
"D03KT",485,506,"1200x900",1000,1,600,400,"True",559,567,593,26,26,1
"D03KT",486,507,"1200x900",1000,1,600,400,"False",608,583,287,-296,296,1
"D03KT",487,445,"1200x900",1000,0,600,400,"False",78,302,427,125,125,1
"D03KT",488,69,"1200x900",600,0,600,400,"True",322,268,229,-39,39,0
"D03KT",489,578,"1200x900",1000,2,600,400,"True",966,276,221,-55,55,0
"D03KT",490,89,"1200x900",600,1,600,400,"True",917,366,366,0,0,1
"D03KT",491,348,"1200x900",800,1,600,400,"True",764,294,351,57,57,0
"D03KT",492,115,"1200x900",600,1,600,400,"False",545,307,509,202,202,0
"D03KT",493,456,"1200x900",1000,0,600,400,"False",91,257,354,97,97,1
"D03KT",494,540,"1200x900",1000,1,600,400,"False",389,568,397,-171,171,1
"D03KT",495,66,"1200x900",600,0,600,400,"False",155,673,584,-89,89,0
"D03KT",496,37,"1200x900",600,0,600,400,"True",258,403,356,-47,47,1
"D03KT",497,513,"1200x900",1000,1,600,400,"True",235,602,556,-46,46,0
"D03KT",498,329,"1200x900",800,1,600,400,"False",517,239,447,208,208,0
"D03KT",499,470,"1200x900",1000,0,600,400,"False",91,666,418,-248,248,1
"D03KT",500,343,"1200x900",800,1,600,400,"True",407,557,583,26,26,0
"D03KT",501,411,"1200x900",800,2,600,400,"False",805,361,488,127,127,0
"D03KT",502,382,"1200x900",800,2,600,400,"True",870,523,487,-36,36,0
"D03KT",503,463,"1200x900",1000,0,600,400,"False",115,693,427,-266,266,1
"D03KT",504,39,"1200x900",600,0,600,400,"True",210,609,645,36,36,0
"D03KT",505,336,"1200x900",800,1,600,400,"False",251,587,804,217,217,0
"D03KT",506,437,"1200x900",1000,0,600,400,"False",74,667,491,-176,176,1
"D03KT",507,4,"1200x900",600,0,600,400,"False",602,200,378,178,178,1
"D03KT",508,239,"1200x900",800,0,600,400,"False",114,231,352,121,121,1
"D03KT",509,648,"1200x900",1000,2,600,400,"True",557,394,476,82,82,0
"D03KT",510,53,"1200x900",600,0,600,400,"False",177,189,357,168,168,0
"D03KT",511,213,"1200x900",600,2,600,400,"False",822,275,538,263,263,0
"D03KT",512,33,"1200x900",600,0,600,400,"True",198,533,491,-42,42,1
"D03KT",513,266,"1200x900",800,0,600,400,"True",126,303,340,37,37,1
"D03KT",514,501,"1200x900",1000,0,600,400,"False",96,323,541,218,218,1
"D03KT",515,623,"1200x900",1000,2,600,400,"False",636,527,386,-141,141,0
"D03KT",516,439,"1200x900",1000,0,600,400,"False",110,229,397,168,168,1
"D03KT",517,187,"1200x900",600,2,600,400,"False",857,639,552,-87,87,0
"D03KT",518,249,"1200x900",800,0,600,400,"False",126,306,431,125,125,1
"D03KT",519,21,"1200x900",600,0,600,400,"False",314,383,455,72,72,1
"D03KT",520,477,"1200x900",1000,0,600,400,"False",88,640,326,-314,314,1
"D03KT",521,63,"1200x900",600,0,600,400,"True",311,188,175,-13,13,1
"D03KT",522,484,"1200x900",1000,0,600,400,"False",100,223,311,88,88,1
"D03KT",523,607,"1200x900",1000,2,600,400,"False",900,573,166,-407,407,1
"D03KT",524,111,"1200x900",600,1,600,400,"False",922,552,294,-258,258,1
"D03KT",525,393,"1200x900",800,2,600,400,"False",657,620,370,-250,250,0
"D03KT",526,430,"1200x900",800,2,600,400,"False",922,254,561,307,307,0
"D03KT",527,265,"1200x900",800,0,600,400,"False",229,353,440,87,87,1
"D03KT",528,603,"1200x900",1000,2,600,400,"False",693,280,460,180,180,0
"D03KT",529,562,"1200x900",1000,1,600,400,"True",347,540,540,0,0,0
"D03KT",530,152,"1200x900",600,2,600,400,"True",971,399,407,8,8,0
"D03KT",531,517,"1200x900",1000,1,600,400,"True",548,182,238,56,56,0
"D03KT",532,183,"1200x900",600,2,600,400,"False",927,289,400,111,111,0
"D03KT",533,347,"1200x900",800,1,600,400,"False",757,295,408,113,113,1
"D03KT",534,255,"1200x900",800,0,600,400,"False",93,709,463,-246,246,1
"D03KT",535,161,"1200x900",600,2,600,400,"False",939,553,418,-135,135,0
"D03KT",536,464,"1200x900",1000,0,600,400,"False",82,222,458,236,236,1
"D03KT",537,121,"1200x900",600,1,600,400,"False",884,364,226,-138,138,0
"D03KT",538,387,"1200x900",800,2,600,400,"True",990,444,482,38,38,0
"D03KT",539,120,"1200x900",600,1,600,400,"True",690,655,668,13,13,0
"D03KT",540,377,"1200x900",800,2,600,400,"False",683,388,536,148,148,0
"D03KT",541,231,"1200x900",800,0,600,400,"False",251,718,431,-287,287,1
"D03KT",542,166,"1200x900",600,2,600,400,"False",896,274,610,336,336,0
"D03KT",543,346,"1200x900",800,1,600,400,"False",269,635,711,76,76,0
"D03KT",544,151,"1200x900",600,2,600,400,"False",828,680,493,-187,187,0
"D03KT",545,554,"1200x900",1000,1,600,400,"False",79,309,437,128,128,1
"D03KT",546,326,"1200x900",800,1,600,400,"True",103,482,526,44,44,0
"D03KT",547,2,"1200x900",600,0,600,400,"False",159,323,445,122,122,0
"D03KT",548,483,"1200x900",1000,0,600,400,"False",93,191,394,203,203,1
"D03KT",549,192,"1200x900",600,2,600,400,"False",1064,320,662,342,342,0
"D03KT",550,449,"1200x900",1000,0,600,400,"False",105,683,287,-396,396,1
"D03KT",551,465,"1200x900",1000,0,600,400,"False",85,203,420,217,217,1
"D03KT",552,31,"1200x900",600,0,600,400,"True",365,338,341,3,3,1
"D03KT",553,272,"1200x900",800,0,600,400,"False",200,181,323,142,142,1
"D03KT",554,71,"1200x900",600,0,600,400,"True",219,248,280,32,32,0
"D03KT",555,337,"1200x900",800,1,600,400,"True",299,622,619,-3,3,0
"D03KT",556,214,"1200x900",600,2,600,400,"False",1046,305,538,233,233,0
"D03KT",557,342,"1200x900",800,1,600,400,"False",677,204,561,357,357,0
"D03KT",558,544,"1200x900",1000,1,600,400,"False",602,620,218,-402,402,0
"D03KT",559,262,"1200x900",800,0,600,400,"False",196,481,353,-128,128,1
"D03KT",560,601,"1200x900",1000,2,600,400,"False",735,697,444,-253,253,0
"D03KT",561,619,"1200x900",1000,2,600,400,"False",803,247,551,304,304,0
"D03KT",562,491,"1200x900",1000,0,600,400,"False",108,198,334,136,136,1
"D03KT",563,351,"1200x900",800,1,600,400,"False",122,581,795,214,214,0
"D03KT",564,414,"1200x900",800,2,600,400,"False",831,592,495,-97,97,0
"D03KT",565,128,"1200x900",600,1,600,400,"False",661,258,608,350,350,1
"D03KT",566,533,"1200x900",1000,1,600,400,"False",355,483,647,164,164,0
"D03KT",567,112,"1200x900",600,1,600,400,"True",681,490,572,82,82,0
"D03KT",568,9,"1200x900",600,0,600,400,"True",509,654,644,-10,10,1
"D03KT",569,143,"1200x900",600,1,600,400,"False",479,284,432,148,148,1
"D03KT",570,327,"1200x900",800,1,600,400,"False",152,339,520,181,181,0
"D03KT",571,575,"1200x900",1000,1,600,400,"False",272,693,494,-199,199,0
"D03KT",572,201,"1200x900",600,2,600,400,"True",1005,462,514,52,52,0
"D03KT",573,413,"1200x900",800,2,600,400,"True",849,506,559,53,53,0
"D03KT",574,590,"1200x900",1000,2,600,400,"False",636,278,525,247,247,0
"D03KT",575,420,"1200x900",800,2,600,400,"False",519,223,408,185,185,0
"D03KT",576,556,"1200x900",1000,1,600,400,"False",415,420,246,-174,174,0
"D03KT",577,97,"1200x900",600,1,600,400,"False",760,643,407,-236,236,1
"D03KT",578,300,"1200x900",800,1,600,400,"False",620,693,556,-137,137,0
"D03KT",579,644,"1200x900",1000,2,600,400,"True",495,486,485,-1,1,0
"D03KT",580,410,"1200x900",800,2,600,400,"True",916,477,448,-29,29,0
"D03KT",581,646,"1200x900",1000,2,600,400,"False",829,227,496,269,269,1
"D03KT",582,146,"1200x900",600,2,600,400,"False",989,492,415,-77,77,0
"D03KT",583,109,"1200x900",600,1,600,400,"False",691,589,658,69,69,0
"D03KT",584,25,"1200x900",600,0,600,400,"True",263,403,461,58,58,1
"D03KT",585,482,"1200x900",1000,0,600,400,"False",79,686,397,-289,289,1
"D03KT",586,137,"1200x900",600,1,600,400,"True",789,577,545,-32,32,0
"D03KT",587,541,"1200x900",1000,1,600,400,"True",339,478,472,-6,6,0
"D03KT",588,178,"1200x900",600,2,600,400,"False",1041,510,628,118,118,0
"D03KT",589,274,"1200x900",800,0,600,400,"True",146,497,502,5,5,1
"D03KT",590,310,"1200x900",800,1,600,400,"False",559,592,443,-149,149,0
"D03KT",591,55,"1200x900",600,0,600,400,"True",211,305,292,-13,13,1
"D03KT",592,557,"1200x900",1000,1,600,400,"True",677,505,521,16,16,1
"D03KT",593,175,"1200x900",600,2,600,400,"True",1028,432,463,31,31,0
"D03KT",594,598,"1200x900",1000,2,600,400,"True",706,559,549,-10,10,0
"D03KT",595,32,"1200x900",600,0,600,400,"False",152,563,458,-105,105,1
"D03KT",596,331,"1200x900",800,1,600,400,"False",240,620,452,-168,168,0
"D03KT",597,591,"1200x900",1000,2,600,400,"True",698,336,351,15,15,0
"D03KT",598,114,"1200x900",600,1,600,400,"False",183,697,408,-289,289,0
"D03KT",599,236,"1200x900",800,0,600,400,"True",162,350,332,-18,18,1
"D03KT",600,142,"1200x900",600,1,600,400,"False",286,474,379,-95,95,0
"D03KT",601,107,"1200x900",600,1,600,400,"False",878,678,320,-358,358,0
"D03KT",602,269,"1200x900",800,0,600,400,"True",160,295,346,51,51,1
"D03KT",603,226,"1200x900",800,0,600,400,"False",187,229,315,86,86,1
"D03KT",604,228,"1200x900",800,0,600,400,"False",174,687,563,-124,124,1
"D03KT",605,198,"1200x900",600,2,600,400,"True",976,500,461,-39,39,0
"D03KT",606,313,"1200x900",800,1,600,400,"False",588,421,531,110,110,0
"D03KT",607,169,"1200x900",600,2,600,400,"False",924,290,480,190,190,0
"D03KT",608,584,"1200x900",1000,2,600,400,"False",731,413,329,-84,84,0
"D03KT",609,118,"1200x900",600,1,600,400,"False",190,588,414,-174,174,0
"D03KT",610,452,"1200x900",1000,0,600,400,"False",97,273,478,205,205,1
"D03KT",611,618,"1200x900",1000,2,600,400,"False",276,671,425,-246,246,0
"D03KT",612,24,"1200x900",600,0,600,400,"False",430,538,400,-138,138,1
"D03KT",613,595,"1200x900",1000,2,600,400,"False",687,640,514,-126,126,0
"D03KT",614,293,"1200x900",800,1,600,400,"False",561,396,473,77,77,0
"D03KT",615,500,"1200x900",1000,0,600,400,"False",105,700,404,-296,296,1
"D03KT",616,221,"1200x900",800,0,600,400,"False",132,520,305,-215,215,1
"D03KT",617,568,"1200x900",1000,1,600,400,"False",286,475,699,224,224,1
"D03KT",618,162,"1200x900",600,2,600,400,"False",849,279,489,210,210,0
"D03KT",619,317,"1200x900",800,1,600,400,"False",185,564,822,258,258,0
"D03KT",620,106,"1200x900",600,1,600,400,"False",803,659,309,-350,350,1
"D03KT",621,405,"1200x900",800,2,600,400,"False",790,307,559,252,252,0
"D03KT",622,244,"1200x900",800,0,600,400,"False",194,203,113,-90,90,1
"D03KT",623,303,"1200x900",800,1,600,400,"False",241,431,240,-191,191,0
"D03KT",624,315,"1200x900",800,1,600,400,"True",105,211,190,-21,21,0
"D03KT",625,475,"1200x900",1000,0,600,400,"False",101,715,321,-394,394,1
"D03KT",626,141,"1200x900",600,1,600,400,"False",671,582,376,-206,206,0
"D03KT",627,350,"1200x900",800,1,600,400,"False",182,566,367,-199,199,0
"D03KT",628,26,"1200x900",600,0,600,400,"False",70,712,612,-100,100,0
"D03KT",629,485,"1200x900",1000,0,600,400,"False",121,694,482,-212,212,1
"D03KT",630,577,"1200x900",1000,2,600,400,"False",455,420,542,122,122,0
"D03KT",631,594,"1200x900",1000,2,600,400,"False",537,637,457,-180,180,0
"D03KT",632,521,"1200x900",1000,1,600,400,"False",111,303,531,228,228,1
"D03KT",633,502,"1200x900",1000,0,600,400,"False",111,639,474,-165,165,1
"D03KT",634,23,"1200x900",600,0,600,400,"True",308,463,523,60,60,1
"D03KT",635,579,"1200x900",1000,2,600,400,"False",803,394,453,59,59,0
"D03KT",636,633,"1200x900",1000,2,600,400,"False",564,253,396,143,143,0
"D03KT",637,621,"1200x900",1000,2,600,400,"True",540,478,450,-28,28,0
"D03KT",638,418,"1200x900",800,2,600,400,"True",754,507,475,-32,32,0
"D03KT",639,354,"1200x900",800,1,600,400,"False",118,236,171,-65,65,0
"D03KT",640,90,"1200x900",600,1,600,400,"False",560,474,68,-406,406,0
"D03KT",641,220,"1200x900",800,0,600,400,"True",108,699,651,-48,48,1
"D03KT",642,176,"1200x900",600,2,600,400,"False",1033,281,519,238,238,0
"D03KT",643,195,"1200x900",600,2,600,400,"False",942,249,414,165,165,0
"D03KT",644,67,"1200x900",600,0,600,400,"False",289,308,409,101,101,1
"D03KT",645,64,"1200x900",600,0,600,400,"False",102,339,492,153,153,0
"D03KT",646,361,"1200x900",800,2,600,400,"False",931,328,472,144,144,0
"D03KT",647,428,"1200x900",800,2,600,400,"False",732,665,545,-120,120,0
"D03KT",648,467,"1200x900",1000,0,600,400,"False",74,712,436,-276,276,1
"D04AY",1,103,"1200x900",600,1,600,400,"True",528,320,330,10,10,1
"D04AY",2,132,"1200x900",600,1,600,400,"False",333,185,311,126,126,0
"D04AY",3,189,"1200x900",600,2,600,400,"False",881,397,278,-119,119,0
"D04AY",4,182,"1200x900",600,2,600,400,"True",933,389,373,-16,16,0
"D04AY",5,245,"1200x900",800,0,600,400,"False",296,235,355,120,120,1
"D04AY",6,436,"1200x900",1000,0,600,400,"False",82,617,540,-77,77,1
"D04AY",7,311,"1200x900",800,1,600,400,"True",710,261,261,0,0,0
"D04AY",8,67,"1200x900",600,0,600,400,"True",289,308,289,-19,19,1
"D04AY",9,555,"1200x900",1000,1,600,400,"False",444,556,333,-223,223,0
"D04AY",10,150,"1200x900",600,2,600,400,"False",897,345,552,207,207,0
"D04AY",11,394,"1200x900",800,2,600,400,"False",847,292,407,115,115,0
"D04AY",12,255,"1200x900",800,0,600,400,"False",93,709,592,-117,117,1
"D04AY",13,557,"1200x900",1000,1,600,400,"False",677,505,779,274,274,1
"D04AY",14,548,"1200x900",1000,1,600,400,"False",103,278,352,74,74,0
"D04AY",15,75,"1200x900",600,1,600,400,"False",635,558,474,-84,84,0
"D04AY",16,186,"1200x900",600,2,600,400,"False",997,197,448,251,251,0
"D04AY",17,366,"1200x900",800,2,600,400,"False",931,464,386,-78,78,0
"D04AY",18,596,"1200x900",1000,2,600,400,"False",706,513,257,-256,256,0
"D04AY",19,99,"1200x900",600,1,600,400,"False",811,407,316,-91,91,0
"D04AY",20,501,"1200x900",1000,0,600,400,"True",96,323,260,-63,63,1
"D04AY",21,642,"1200x900",1000,2,600,400,"True",776,316,374,58,58,0
"D04AY",22,63,"1200x900",600,0,600,400,"True",311,188,218,30,30,1
"D04AY",23,353,"1200x900",800,1,600,400,"False",90,476,261,-215,215,0
"D04AY",24,291,"1200x900",800,1,600,400,"True",522,694,652,-42,42,0
"D04AY",25,214,"1200x900",600,2,600,400,"False",1046,305,474,169,169,0
"D04AY",26,158,"1200x900",600,2,600,400,"True",939,300,252,-48,48,0
"D04AY",27,396,"1200x900",800,2,600,400,"False",678,663,398,-265,265,0
"D04AY",28,305,"1200x900",800,1,600,400,"False",471,716,501,-215,215,0
"D04AY",29,433,"1200x900",1000,0,600,400,"True",76,222,258,36,36,1
"D04AY",30,469,"1200x900",1000,0,600,400,"False",73,227,296,69,69,1
"D04AY",31,81,"1200x900",600,1,600,400,"False",696,225,328,103,103,0
"D04AY",32,344,"1200x900",800,1,600,400,"True",589,408,359,-49,49,0
"D04AY",33,102,"1200x900",600,1,600,400,"False",861,603,394,-209,209,0
"D04AY",34,181,"1200x900",600,2,600,400,"False",1018,223,353,130,130,0
"D04AY",35,368,"1200x900",800,2,600,400,"False",778,515,233,-282,282,0
"D04AY",36,80,"1200x900",600,1,600,400,"False",616,423,613,190,190,1
"D04AY",37,61,"1200x900",600,0,600,400,"False",272,670,606,-64,64,1
"D04AY",38,500,"1200x900",1000,0,600,400,"False",105,700,574,-126,126,1
"D04AY",39,263,"1200x900",800,0,600,400,"True",82,396,363,-33,33,1
"D04AY",40,354,"1200x900",800,1,600,400,"False",118,236,553,317,317,0
"D04AY",41,372,"1200x900",800,2,600,400,"True",833,620,546,-74,74,0
"D04AY",42,13,"1200x900",600,0,600,400,"False",296,211,424,213,213,1
"D04AY",43,92,"1200x900",600,1,600,400,"False",624,605,484,-121,121,0
"D04AY",44,265,"1200x900",800,0,600,400,"False",229,353,427,74,74,1
"D04AY",45,451,"1200x900",1000,0,600,400,"False",110,702,512,-190,190,1
"D04AY",46,338,"1200x900",800,1,600,400,"False",813,253,495,242,242,1
"D04AY",47,611,"1200x900",1000,2,600,400,"False",414,511,653,142,142,0
"D04AY",48,333,"1200x900",800,1,600,400,"True",521,548,579,31,31,0
"D04AY",49,507,"1200x900",1000,1,600,400,"True",608,583,578,-5,5,1
"D04AY",50,429,"1200x900",800,2,600,400,"False",682,692,577,-115,115,0
"D04AY",51,113,"1200x900",600,1,600,400,"True",897,657,616,-41,41,0
"D04AY",52,566,"1200x900",1000,1,600,400,"False",378,472,124,-348,348,1
"D04AY",53,17,"1200x900",600,0,600,400,"False",402,496,389,-107,107,1
"D04AY",54,606,"1200x900",1000,2,600,400,"True",653,627,619,-8,8,0
"D04AY",55,162,"1200x900",600,2,600,400,"True",849,279,237,-42,42,0
"D04AY",56,335,"1200x900",800,1,600,400,"False",124,360,222,-138,138,0
"D04AY",57,544,"1200x900",1000,1,600,400,"False",602,620,487,-133,133,0
"D04AY",58,607,"1200x900",1000,2,600,400,"False",900,573,439,-134,134,1
"D04AY",59,284,"1200x900",800,0,600,400,"True",135,293,321,28,28,1
"D04AY",60,28,"1200x900",600,0,600,400,"True",336,410,349,-61,61,1
"D04AY",61,211,"1200x900",600,2,600,400,"False",986,407,244,-163,163,0
"D04AY",62,57,"1200x900",600,0,600,400,"True",354,508,487,-21,21,1
"D04AY",63,612,"1200x900",1000,2,600,400,"False",706,198,460,262,262,0
"D04AY",64,83,"1200x900",600,1,600,400,"False",763,568,439,-129,129,1
"D04AY",65,505,"1200x900",1000,1,600,400,"True",191,484,534,50,50,1
"D04AY",66,84,"1200x900",600,1,600,400,"False",144,184,318,134,134,0
"D04AY",67,45,"1200x900",600,0,600,400,"False",487,678,520,-158,158,1
"D04AY",68,76,"1200x900",600,1,600,400,"False",647,614,678,64,64,0
"D04AY",69,441,"1200x900",1000,0,600,400,"False",85,684,582,-102,102,1
"D04AY",70,493,"1200x900",1000,0,600,400,"False",80,582,485,-97,97,1
"D04AY",71,40,"1200x900",600,0,600,400,"True",143,513,511,-2,2,0
"D04AY",72,525,"1200x900",1000,1,600,400,"False",123,690,512,-178,178,0
"D04AY",74,454,"1200x900",1000,0,600,400,"False",78,687,522,-165,165,1
"D04AY",75,322,"1200x900",800,1,600,400,"False",703,206,504,298,298,1
"D04AY",76,532,"1200x900",1000,1,600,400,"False",215,207,493,286,286,0
"D04AY",77,401,"1200x900",800,2,600,400,"False",821,260,411,151,151,0
"D04AY",78,190,"1200x900",600,2,600,400,"True",977,238,268,30,30,0
"D04AY",79,184,"1200x900",600,2,600,400,"False",1067,441,494,53,53,0
"D04AY",80,336,"1200x900",800,1,600,400,"False",251,587,445,-142,142,0
"D04AY",81,538,"1200x900",1000,1,600,400,"False",308,457,533,76,76,1
"D04AY",84,117,"1200x900",600,1,600,400,"False",711,456,266,-190,190,0
"D04AY",85,144,"1200x900",600,1,600,400,"True",718,371,405,34,34,0
"D04AY",86,258,"1200x900",800,0,600,400,"False",126,664,479,-185,185,1
"D04AY",87,621,"1200x900",1000,2,600,400,"True",540,478,451,-27,27,0
"D04AY",88,554,"1200x900",1000,1,600,400,"True",79,309,316,7,7,1
"D04AY",89,232,"1200x900",800,0,600,400,"False",84,511,387,-124,124,1
"D04AY",90,246,"1200x900",800,0,600,400,"True",196,418,439,21,21,1
"D04AY",91,314,"1200x900",800,1,600,400,"False",277,616,524,-92,92,1
"D04AY",92,178,"1200x900",600,2,600,400,"False",1041,510,637,127,127,0
"D04AY",93,498,"1200x900",1000,0,600,400,"False",100,260,493,233,233,1
"D04AY",94,12,"1200x900",600,0,600,400,"False",365,336,452,116,116,1
"D04AY",95,641,"1200x900",1000,2,600,400,"False",897,272,482,210,210,0
"D04AY",96,22,"1200x900",600,0,600,400,"True",398,591,548,-43,43,1
"D04AY",97,290,"1200x900",800,1,600,400,"True",789,603,561,-42,42,0
"D04AY",98,490,"1200x900",1000,0,600,400,"False",114,183,365,182,182,1
"D04AY",99,166,"1200x900",600,2,600,400,"False",896,274,479,205,205,0
"D04AY",100,38,"1200x900",600,0,600,400,"True",120,628,684,56,56,1
"D04AY",101,615,"1200x900",1000,2,600,400,"False",736,634,377,-257,257,0
"D04AY",102,282,"1200x900",800,0,600,400,"False",109,246,329,83,83,1
"D04AY",103,622,"1200x900",1000,2,600,400,"False",307,683,296,-387,387,0
"D04AY",104,471,"1200x900",1000,0,600,400,"True",122,200,252,52,52,1
"D04AY",105,156,"1200x900",600,2,600,400,"False",913,197,678,481,481,0
"D04AY",106,384,"1200x900",800,2,600,400,"False",821,707,621,-86,86,0
"D04AY",107,278,"1200x900",800,0,600,400,"True",251,711,711,0,0,1
"D04AY",108,402,"1200x900",800,2,600,400,"False",878,234,708,474,474,0
"D04AY",109,66,"1200x900",600,0,600,400,"True",155,673,627,-46,46,0
"D04AY",110,542,"1200x900",1000,1,600,400,"False",304,401,726,325,325,0
"D04AY",111,640,"1200x900",1000,2,600,400,"False",361,334,680,346,346,0
"D04AY",112,95,"1200x900",600,1,600,400,"False",749,425,667,242,242,1
"D04AY",113,72,"1200x900",600,0,600,400,"True",158,537,522,-15,15,0
"D04AY",114,575,"1200x900",1000,1,600,400,"False",272,693,524,-169,169,0
"D04AY",116,599,"1200x900",1000,2,600,400,"False",316,570,455,-115,115,0
"D04AY",117,547,"1200x900",1000,1,600,400,"False",369,384,465,81,81,1
"D04AY",118,556,"1200x900",1000,1,600,400,"True",415,420,439,19,19,0
"D04AY",119,503,"1200x900",1000,0,600,400,"True",86,279,311,32,32,1
"D04AY",120,79,"1200x900",600,1,600,400,"True",731,289,310,21,21,0
"D04AY",122,410,"1200x900",800,2,600,400,"False",916,477,302,-175,175,0
"D04AY",123,168,"1200x900",600,2,600,400,"False",1001,439,320,-119,119,0
"D04AY",124,310,"1200x900",800,1,600,400,"False",559,592,366,-226,226,0
"D04AY",125,223,"1200x900",800,0,600,400,"True",179,191,202,11,11,1
"D04AY",126,215,"1200x900",600,2,600,400,"False",939,596,199,-397,397,0
"D04AY",127,323,"1200x900",800,1,600,400,"True",388,348,329,-19,19,0
"D04AY",128,256,"1200x900",800,0,600,400,"False",192,656,360,-296,296,1
"D04AY",129,136,"1200x900",600,1,600,400,"False",264,205,346,141,141,0
"D04AY",130,88,"1200x900",600,1,600,400,"False",186,554,352,-202,202,0
"D04AY",132,69,"1200x900",600,0,600,400,"True",322,268,309,41,41,0
"D04AY",133,549,"1200x900",1000,1,600,400,"True",657,366,312,-54,54,0
"D04AY",134,449,"1200x900",1000,0,600,400,"False",105,683,487,-196,196,1
"D04AY",135,513,"1200x900",1000,1,600,400,"False",235,602,292,-310,310,0
"D04AY",137,421,"1200x900",800,2,600,400,"True",898,394,421,27,27,0
"D04AY",138,266,"1200x900",800,0,600,400,"True",126,303,315,12,12,1
"D04AY",139,618,"1200x900",1000,2,600,400,"False",276,671,461,-210,210,0
"D04AY",140,375,"1200x900",800,2,600,400,"False",716,384,602,218,218,0
"D04AY",141,68,"1200x900",600,0,600,400,"True",165,367,365,-2,2,0
"D04AY",142,50,"1200x900",600,0,600,400,"False",75,582,455,-127,127,0
"D04AY",143,408,"1200x900",800,2,600,400,"False",758,567,480,-87,87,0
"D04AY",144,645,"1200x900",1000,2,600,400,"False",619,396,504,108,108,0
"D04AY",145,303,"1200x900",800,1,600,400,"True",241,431,507,76,76,0
"D04AY",146,506,"1200x900",1000,1,600,400,"False",559,567,418,-149,149,1
"D04AY",148,1,"1200x900",600,0,600,400,"True",136,502,438,-64,64,0
"D04AY",149,317,"1200x900",800,1,600,400,"False",185,564,668,104,104,0
"D04AY",150,142,"1200x900",600,1,600,400,"False",286,474,612,138,138,0
"D04AY",151,308,"1200x900",800,1,600,400,"False",437,425,508,83,83,0
"D04AY",152,346,"1200x900",800,1,600,400,"False",269,635,487,-148,148,0
"D04AY",153,634,"1200x900",1000,2,600,400,"False",735,313,586,273,273,0
"D04AY",154,297,"1200x900",800,1,600,400,"False",625,244,395,151,151,0
"D04AY",155,563,"1200x900",1000,1,600,400,"False",201,696,435,-261,261,0
"D04AY",156,39,"1200x900",600,0,600,400,"False",210,609,463,-146,146,0
"D04AY",157,11,"1200x900",600,0,600,400,"False",372,670,573,-97,97,1
"D04AY",158,360,"1200x900",800,1,600,400,"True",203,608,652,44,44,0
"D04AY",159,175,"1200x900",600,2,600,400,"False",1028,432,350,-82,82,0
"D04AY",160,313,"1200x900",800,1,600,400,"True",588,421,412,-9,9,0
"D04AY",161,595,"1200x900",1000,2,600,400,"False",687,640,514,-126,126,0
"D04AY",162,242,"1200x900",800,0,600,400,"True",117,448,412,-36,36,1
"D04AY",163,174,"1200x900",600,2,600,400,"False",998,457,321,-136,136,0
"D04AY",164,110,"1200x900",600,1,600,400,"False",776,550,432,-118,118,1
"D04AY",165,143,"1200x900",600,1,600,400,"True",479,284,349,65,65,1
"D04AY",166,125,"1200x900",600,1,600,400,"False",750,531,350,-181,181,0
"D04AY",167,585,"1200x900",1000,2,600,400,"False",698,688,443,-245,245,1
"D04AY",168,129,"1200x900",600,1,600,400,"False",859,482,276,-206,206,1
"D04AY",169,293,"1200x900",800,1,600,400,"True",561,396,422,26,26,0
"D04AY",170,325,"1200x900",800,1,600,400,"False",105,394,704,310,310,0
"D04AY",171,285,"1200x900",800,0,600,400,"False",237,396,474,78,78,1
"D04AY",172,491,"1200x900",1000,0,600,400,"False",108,198,354,156,156,1
"D04AY",173,119,"1200x900",600,1,600,400,"False",168,563,324,-239,239,0
"D04AY",174,543,"1200x900",1000,1,600,400,"False",88,202,414,212,212,0
"D04AY",175,19,"1200x900",600,0,600,400,"False",286,686,568,-118,118,0
"D04AY",176,614,"1200x900",1000,2,600,400,"False",823,563,440,-123,123,0
"D04AY",177,320,"1200x900",800,1,600,400,"False",644,376,496,120,120,0
"D04AY",178,59,"1200x900",600,0,600,400,"True",391,692,669,-23,23,1
"D04AY",179,545,"1200x900",1000,1,600,400,"True",358,562,609,47,47,0
"D04AY",180,597,"1200x900",1000,2,600,400,"False",352,239,405,166,166,0
"D04AY",181,383,"1200x900",800,2,600,400,"False",855,407,492,85,85,0
"D04AY",182,149,"1200x900",600,2,600,400,"False",890,289,388,99,99,0
"D04AY",183,470,"1200x900",1000,0,600,400,"False",91,666,482,-184,184,1
"D04AY",184,296,"1200x900",800,1,600,400,"False",89,279,512,233,233,0
"D04AY",185,272,"1200x900",800,0,600,400,"False",200,181,353,172,172,1
"D04AY",186,33,"1200x900",600,0,600,400,"True",198,533,525,-8,8,1
"D04AY",187,60,"1200x900",600,0,600,400,"False",365,213,336,123,123,1
"D04AY",188,450,"1200x900",1000,0,600,400,"False",130,204,337,133,133,1
"D04AY",189,527,"1200x900",1000,1,600,400,"False",565,601,378,-223,223,0
"D04AY",190,43,"1200x900",600,0,600,400,"True",277,446,490,44,44,1
"D04AY",191,367,"1200x900",800,2,600,400,"True",613,464,491,27,27,0
"D04AY",192,603,"1200x900",1000,2,600,400,"False",693,280,474,194,194,0
"D04AY",193,345,"1200x900",800,1,600,400,"True",841,566,559,-7,7,1
"D04AY",194,420,"1200x900",800,2,600,400,"False",519,223,588,365,365,0
"D04AY",195,234,"1200x900",800,0,600,400,"True",72,344,374,30,30,1
"D04AY",196,393,"1200x900",800,2,600,400,"False",657,620,400,-220,220,0
"D04AY",197,90,"1200x900",600,1,600,400,"False",560,474,291,-183,183,0
"D04AY",198,299,"1200x900",800,1,600,400,"True",779,274,323,49,49,0
"D04AY",199,173,"1200x900",600,2,600,400,"False",948,693,423,-270,270,0
"D04AY",200,583,"1200x900",1000,2,600,400,"False",949,284,537,253,253,1
"D04AY",201,631,"1200x900",1000,2,600,400,"True",699,479,518,39,39,0
"D04AY",202,576,"1200x900",1000,1,600,400,"False",376,713,564,-149,149,0
"D04AY",203,594,"1200x900",1000,2,600,400,"False",537,637,701,64,64,0
"D04AY",204,588,"1200x900",1000,2,600,400,"False",585,350,675,325,325,0
"D04AY",205,294,"1200x900",800,1,600,400,"False",262,287,536,249,249,0
"D04AY",206,529,"1200x900",1000,1,600,400,"False",267,412,213,-199,199,1
"D04AY",207,448,"1200x900",1000,0,600,400,"False",107,641,364,-277,277,1
"D04AY",209,391,"1200x900",800,2,600,400,"False",895,521,452,-69,69,0
"D04AY",210,370,"1200x900",800,2,600,400,"True",874,336,358,22,22,0
"D04AY",211,560,"1200x900",1000,1,600,400,"False",516,693,457,-236,236,0
"D04AY",212,206,"1200x900",600,2,600,400,"False",975,223,376,153,153,0
"D04AY",213,54,"1200x900",600,0,600,400,"False",474,564,426,-138,138,1
"D04AY",214,179,"1200x900",600,2,600,400,"False",908,602,462,-140,140,0
"D04AY",215,326,"1200x900",800,1,600,400,"True",103,482,402,-80,80,0
"D04AY",216,438,"1200x900",1000,0,600,400,"False",77,713,496,-217,217,1
"D04AY",218,58,"1200x900",600,0,600,400,"False",353,655,519,-136,136,1
"D04AY",219,337,"1200x900",800,1,600,400,"True",299,622,565,-57,57,0
"D04AY",220,570,"1200x900",1000,1,600,400,"False",315,352,564,212,212,0
"D04AY",222,377,"1200x900",800,2,600,400,"False",683,388,551,163,163,0
"D04AY",223,464,"1200x900",1000,0,600,400,"False",82,222,452,230,230,1
"D04AY",224,32,"1200x900",600,0,600,400,"False",152,563,471,-92,92,1
"D04AY",225,286,"1200x900",800,0,600,400,"True",105,378,389,11,11,1
"D04AY",226,584,"1200x900",1000,2,600,400,"False",731,413,281,-132,132,0
"D04AY",227,455,"1200x900",1000,0,600,400,"False",107,718,436,-282,282,1
"D04AY",228,484,"1200x900",1000,0,600,400,"False",100,223,347,124,124,1
"D04AY",229,202,"1200x900",600,2,600,400,"False",966,460,333,-127,127,0
"D04AY",230,188,"1200x900",600,2,600,400,"False",900,195,498,303,303,0
"D04AY",231,153,"1200x900",600,2,600,400,"False",1037,601,477,-124,124,0
"D04AY",232,348,"1200x900",800,1,600,400,"False",764,294,399,105,105,0
"D04AY",233,127,"1200x900",600,1,600,400,"False",309,691,359,-332,332,0
"D04AY",234,468,"1200x900",1000,0,600,400,"False",121,219,343,124,124,1
"D04AY",235,389,"1200x900",800,2,600,400,"False",843,530,386,-144,144,0
"D04AY",236,123,"1200x900",600,1,600,400,"False",761,365,305,-60,60,1
"D04AY",237,100,"1200x900",600,1,600,400,"False",453,511,373,-138,138,0
"D04AY",238,519,"1200x900",1000,1,600,400,"False",319,565,359,-206,206,1
"D04AY",239,537,"1200x900",1000,1,600,400,"True",621,412,428,16,16,1
"D04AY",240,485,"1200x900",1000,0,600,400,"False",121,694,446,-248,248,1
"D04AY",242,198,"1200x900",600,2,600,400,"True",976,500,468,-32,32,0
"D04AY",243,93,"1200x900",600,1,600,400,"False",139,540,433,-107,107,0
"D04AY",244,298,"1200x900",800,1,600,400,"False",311,457,576,119,119,0
"D04AY",246,254,"1200x900",800,0,600,400,"True",136,583,558,-25,25,1
"D04AY",247,302,"1200x900",800,1,600,400,"False",479,467,552,85,85,1
"D04AY",248,281,"1200x900",800,0,600,400,"True",112,611,551,-60,60,1
"D04AY",249,6,"1200x900",600,0,600,400,"False",217,689,604,-85,85,1
"D04AY",250,44,"1200x900",600,0,600,400,"True",305,554,562,8,8,1
"D04AY",251,275,"1200x900",800,0,600,400,"True",120,594,557,-37,37,0
"D04AY",253,437,"1200x900",1000,0,600,400,"False",74,667,568,-99,99,1
"D04AY",254,605,"1200x900",1000,2,600,400,"False",493,665,569,-96,96,0
"D04AY",255,434,"1200x900",1000,0,600,400,"False",89,657,565,-92,92,1
"D04AY",256,411,"1200x900",800,2,600,400,"False",805,361,525,164,164,0
"D04AY",257,86,"1200x900",600,1,600,400,"True",692,388,441,53,53,1
"D04AY",258,456,"1200x900",1000,0,600,400,"False",91,257,410,153,153,1
"D04AY",259,289,"1200x900",800,1,600,400,"False",421,703,375,-328,328,1
"D04AY",260,157,"1200x900",600,2,600,400,"True",1016,323,328,5,5,0
"D04AY",261,474,"1200x900",1000,0,600,400,"True",85,339,289,-50,50,1
"D04AY",262,130,"1200x900",600,1,600,400,"True",741,428,395,-33,33,0
"D04AY",263,14,"1200x900",600,0,600,400,"False",399,224,338,114,114,1
"D04AY",264,648,"1200x900",1000,2,600,400,"True",557,394,393,-1,1,0
"D04AY",265,453,"1200x900",1000,0,600,400,"False",71,393,307,-86,86,1
"D04AY",266,613,"1200x900",1000,2,600,400,"True",690,374,324,-50,50,0
"D04AY",267,511,"1200x900",1000,1,600,400,"False",408,390,564,174,174,1
"D04AY",268,300,"1200x900",800,1,600,400,"False",620,693,385,-308,308,0
"D04AY",269,78,"1200x900",600,1,600,400,"False",885,684,445,-239,239,0
"D04AY",270,627,"1200x900",1000,2,600,400,"True",760,510,488,-22,22,0
"D04AY",271,533,"1200x900",1000,1,600,400,"True",355,483,474,-9,9,0
"D04AY",272,251,"1200x900",800,0,600,400,"False",88,352,462,110,110,1
"D04AY",273,387,"1200x900",800,2,600,400,"True",990,444,417,-27,27,0
"D04AY",274,390,"1200x900",800,2,600,400,"False",982,674,418,-256,256,1
"D04AY",276,620,"1200x900",1000,2,600,400,"False",832,649,460,-189,189,0
"D04AY",277,312,"1200x900",800,1,600,400,"False",238,683,300,-383,383,0
"D04AY",279,589,"1200x900",1000,2,600,400,"True",856,418,425,7,7,0
"D04AY",280,580,"1200x900",1000,2,600,400,"False",651,267,405,138,138,0
"D04AY",281,350,"1200x900",800,1,600,400,"False",182,566,415,-151,151,0
"D04AY",282,208,"1200x900",600,2,600,400,"False",946,399,475,76,76,0
"D04AY",283,249,"1200x900",800,0,600,400,"False",126,306,399,93,93,1
"D04AY",284,36,"1200x900",600,0,600,400,"True",128,346,348,2,2,1
"D04AY",285,518,"1200x900",1000,1,600,400,"False",583,717,415,-302,302,0
"D04AY",286,4,"1200x900",600,0,600,400,"False",602,200,373,173,173,1
"D04AY",287,340,"1200x900",800,1,600,400,"False",226,240,371,131,131,0
"D04AY",288,567,"1200x900",1000,1,600,400,"False",655,297,223,-74,74,1
"D04AY",289,230,"1200x900",800,0,600,400,"False",99,678,555,-123,123,1
"D04AY",290,185,"1200x900",600,2,600,400,"False",907,212,504,292,292,0
"D04AY",291,397,"1200x900",800,2,600,400,"False",817,692,483,-209,209,0
"D04AY",292,341,"1200x900",800,1,600,400,"False",735,632,491,-141,141,1
"D04AY",293,3,"1200x900",600,0,600,400,"True",298,443,461,18,18,1
"D04AY",294,355,"1200x900",800,1,600,400,"False",77,386,271,-115,115,0
"D04AY",295,638,"1200x900",1000,2,600,400,"True",385,198,267,69,69,0
"D04AY",296,330,"1200x900",800,1,600,400,"False",759,301,218,-83,83,1
"D04AY",297,486,"1200x900",1000,0,600,400,"True",102,676,619,-57,57,1
"D04AY",298,515,"1200x900",1000,1,600,400,"False",307,217,490,273,273,0
"D04AY",299,220,"1200x900",800,0,600,400,"False",108,699,626,-73,73,1
"D04AY",300,551,"1200x900",1000,1,600,400,"False",146,445,679,234,234,1
"D04AY",301,87,"1200x900",600,1,600,400,"False",231,604,494,-110,110,0
"D04AY",302,204,"1200x900",600,2,600,400,"False",1053,432,264,-168,168,0
"D04AY",303,48,"1200x900",600,0,600,400,"False",323,645,558,-87,87,1
"D04AY",304,20,"1200x900",600,0,600,400,"True",204,545,533,-12,12,1
"D04AY",305,16,"1200x900",600,0,600,400,"True",297,514,519,5,5,1
"D04AY",306,362,"1200x900",800,2,600,400,"False",819,338,516,178,178,0
"D04AY",308,381,"1200x900",800,2,600,400,"True",705,408,416,8,8,0
"D04AY",309,600,"1200x900",1000,2,600,400,"False",765,207,415,208,208,0
"D04AY",310,71,"1200x900",600,0,600,400,"False",219,248,382,134,134,0
"D04AY",311,329,"1200x900",800,1,600,400,"False",517,239,381,142,142,0
"D04AY",312,619,"1200x900",1000,2,600,400,"False",803,247,395,148,148,0
"D04AY",313,237,"1200x900",800,0,600,400,"False",204,481,372,-109,109,1
"D04AY",315,399,"1200x900",800,2,600,400,"False",603,602,494,-108,108,0
"D04AY",316,417,"1200x900",800,2,600,400,"False",750,280,596,316,316,0
"D04AY",317,280,"1200x900",800,0,600,400,"False",104,302,402,100,100,1
"D04AY",318,534,"1200x900",1000,1,600,400,"False",328,504,598,94,94,1
"D04AY",319,304,"1200x900",800,1,600,400,"False",667,605,486,-119,119,0
"D04AY",320,147,"1200x900",600,2,600,400,"False",942,418,333,-85,85,0
"D04AY",321,332,"1200x900",800,1,600,400,"False",260,699,502,-197,197,0
"D04AY",322,55,"1200x900",600,0,600,400,"True",211,305,319,14,14,1
"D04AY",323,378,"1200x900",800,2,600,400,"False",1018,708,259,-449,449,0
"D04AY",324,259,"1200x900",800,0,600,400,"True",156,180,202,22,22,1
"D04AY",325,165,"1200x900",600,2,600,400,"False",912,554,403,-151,151,0
"D04AY",326,231,"1200x900",800,0,600,400,"False",251,718,508,-210,210,1
"D04AY",327,633,"1200x900",1000,2,600,400,"False",564,253,478,225,225,0
"D04AY",328,582,"1200x900",1000,2,600,400,"True",554,347,321,-26,26,0
"D04AY",329,35,"1200x900",600,0,600,400,"False",366,555,405,-150,150,1
"D04AY",330,112,"1200x900",600,1,600,400,"False",681,490,362,-128,128,0
"D04AY",331,494,"1200x900",1000,0,600,400,"False",127,692,510,-182,182,1
"D04AY",332,508,"1200x900",1000,1,600,400,"True",596,485,484,-1,1,0
"D04AY",333,248,"1200x900",800,0,600,400,"True",94,240,231,-9,9,1
"D04AY",334,331,"1200x900",800,1,600,400,"True",240,620,554,-66,66,0
"D04AY",335,271,"1200x900",800,0,600,400,"True",74,360,403,43,43,1
"D04AY",336,523,"1200x900",1000,1,600,400,"True",339,318,362,44,44,0
"D04AY",337,252,"1200x900",800,0,600,400,"True",224,673,711,38,38,1
"D04AY",338,482,"1200x900",1000,0,600,400,"False",79,686,608,-78,78,1
"D04AY",340,25,"1200x900",600,0,600,400,"True",263,403,442,39,39,1
"D04AY",341,422,"1200x900",800,2,600,400,"False",712,558,675,117,117,0
"D04AY",342,439,"1200x900",1000,0,600,400,"False",110,229,447,218,218,1
"D04AY",343,295,"1200x900",800,1,600,400,"False",471,334,704,370,370,0
"D04AY",344,91,"1200x900",600,1,600,400,"True",417,630,594,-36,36,1
"D04AY",345,277,"1200x900",800,0,600,400,"False",140,310,487,177,177,1
"D04AY",346,94,"1200x900",600,1,600,400,"True",729,482,485,3,3,0
"D04AY",347,540,"1200x900",1000,1,600,400,"False",389,568,486,-82,82,1
"D04AY",348,395,"1200x900",800,2,600,400,"False",743,334,464,130,130,0
"D04AY",349,349,"1200x900",800,1,600,400,"False",402,665,437,-228,228,0
"D04AY",350,647,"1200x900",1000,2,600,400,"True",560,637,582,-55,55,0
"D04AY",351,446,"1200x900",1000,0,600,400,"False",72,298,402,104,104,1
"D04AY",352,201,"1200x900",600,2,600,400,"True",1005,462,415,-47,47,0
"D04AY",353,122,"1200x900",600,1,600,400,"False",817,709,494,-215,215,0
"D04AY",354,427,"1200x900",800,2,600,400,"True",812,380,407,27,27,0
"D04AY",355,347,"1200x900",800,1,600,400,"False",757,295,586,291,291,1
"D04AY",356,536,"1200x900",1000,1,600,400,"False",580,213,347,134,134,0
"D04AY",357,502,"1200x900",1000,0,600,400,"False",111,639,459,-180,180,1
"D04AY",359,478,"1200x900",1000,0,600,400,"False",79,672,482,-190,190,1
"D04AY",360,404,"1200x900",800,2,600,400,"False",842,396,315,-81,81,0
"D04AY",361,475,"1200x900",1000,0,600,400,"False",101,715,443,-272,272,1
"D04AY",362,635,"1200x900",1000,2,600,400,"True",833,402,375,-27,27,0
"D04AY",363,477,"1200x900",1000,0,600,400,"True",88,640,610,-30,30,1
"D04AY",364,203,"1200x900",600,2,600,400,"True",938,603,609,6,6,0
"D04AY",365,46,"1200x900",600,0,600,400,"True",193,355,382,27,27,1
"D04AY",366,229,"1200x900",800,0,600,400,"False",117,697,572,-125,125,1
"D04AY",367,31,"1200x900",600,0,600,400,"True",365,338,348,10,10,1
"D04AY",368,238,"1200x900",800,0,600,400,"True",162,283,273,-10,10,1
"D04AY",369,318,"1200x900",800,1,600,400,"False",788,534,396,-138,138,0
"D04AY",370,257,"1200x900",800,0,600,400,"True",97,219,279,60,60,1
"D04AY",371,499,"1200x900",1000,0,600,400,"True",93,271,264,-7,7,1
"D04AY",372,283,"1200x900",800,0,600,400,"True",90,264,229,-35,35,1
"D04AY",374,432,"1200x900",800,2,600,400,"False",792,380,240,-140,140,0
"D04AY",376,42,"1200x900",600,0,600,400,"False",233,479,386,-93,93,0
"D04AY",378,207,"1200x900",600,2,600,400,"False",838,235,497,262,262,0
"D04AY",379,244,"1200x900",800,0,600,400,"True",194,203,219,16,16,1
"D04AY",380,578,"1200x900",1000,2,600,400,"True",966,276,276,0,0,0
"D04AY",381,2,"1200x900",600,0,600,400,"True",159,323,286,-37,37,0
"D04AY",384,154,"1200x900",600,2,600,400,"False",941,454,336,-118,118,0
"D04AY",385,222,"1200x900",800,0,600,400,"True",152,206,259,53,53,1
"D04AY",386,221,"1200x900",800,0,600,400,"True",132,520,514,-6,6,1
"D04AY",387,268,"1200x900",800,0,600,400,"True",148,400,440,40,40,1
"D04AY",388,452,"1200x900",1000,0,600,400,"False",97,273,342,69,69,1
"D04AY",389,457,"1200x900",1000,0,600,400,"False",97,630,470,-160,160,1
"D04AY",390,531,"1200x900",1000,1,600,400,"False",233,362,457,95,95,0
"D04AY",391,151,"1200x900",600,2,600,400,"False",828,680,503,-177,177,0
"D04AY",392,546,"1200x900",1000,1,600,400,"False",305,374,501,127,127,0
"D04AY",393,64,"1200x900",600,0,600,400,"True",102,339,402,63,63,0
"D04AY",394,52,"1200x900",600,0,600,400,"True",171,188,231,43,43,0
"D04AY",395,34,"1200x900",600,0,600,400,"True",361,242,265,23,23,1
"D04AY",396,205,"1200x900",600,2,600,400,"False",1021,504,300,-204,204,0
"D04AY",397,418,"1200x900",800,2,600,400,"True",754,507,472,-35,35,0
"D04AY",398,233,"1200x900",800,0,600,400,"True",164,700,712,12,12,1
"D04AY",399,128,"1200x900",600,1,600,400,"True",661,258,302,44,44,1
"D04AY",400,400,"1200x900",800,2,600,400,"True",733,297,361,64,64,0
"D04AY",401,562,"1200x900",1000,1,600,400,"False",347,540,469,-71,71,0
"D04AY",402,352,"1200x900",800,1,600,400,"False",235,717,510,-207,207,0
"D04AY",403,343,"1200x900",800,1,600,400,"False",407,557,382,-175,175,0
"D04AY",404,261,"1200x900",800,0,600,400,"True",86,713,667,-46,46,1
"D04AY",405,487,"1200x900",1000,0,600,400,"True",78,670,649,-21,21,1
"D04AY",406,522,"1200x900",1000,1,600,400,"False",223,379,593,214,214,0
"D04AY",407,462,"1200x900",1000,0,600,400,"True",102,672,625,-47,47,1
"D04AY",408,269,"1200x900",800,0,600,400,"True",160,295,295,0,0,1
"D04AY",409,385,"1200x900",800,2,600,400,"True",740,456,491,35,35,0
"D04AY",410,608,"1200x900",1000,2,600,400,"False",742,250,464,214,214,0
"D04AY",411,324,"1200x900",800,1,600,400,"False",719,712,477,-235,235,1
"D04AY",412,458,"1200x900",1000,0,600,400,"True",78,624,602,-22,22,1
"D04AY",413,47,"1200x900",600,0,600,400,"True",303,499,556,57,57,1
"D04AY",414,617,"1200x900",1000,2,600,400,"False",294,180,495,315,315,0
"D04AY",415,250,"1200x900",800,0,600,400,"True",290,248,236,-12,12,1
"D04AY",416,279,"1200x900",800,0,600,400,"True",252,202,240,38,38,1
"D04AY",417,267,"1200x900",800,0,600,400,"True",145,665,661,-4,4,1
"D04AY",418,148,"1200x900",600,2,600,400,"True",907,330,423,93,93,0
"D04AY",419,625,"1200x900",1000,2,600,400,"False",279,228,468,240,240,0
"D04AY",420,193,"1200x900",600,2,600,400,"True",874,588,524,-64,64,0
"D04AY",421,307,"1200x900",800,1,600,400,"False",716,247,471,224,224,0
"D04AY",422,423,"1200x900",800,2,600,400,"True",1051,710,628,-82,82,1
"D04AY",423,21,"1200x900",600,0,600,400,"True",314,383,423,40,40,1
"D04AY",424,213,"1200x900",600,2,600,400,"True",822,275,335,60,60,0
"D04AY",425,137,"1200x900",600,1,600,400,"False",789,577,394,-183,183,0
"D04AY",426,489,"1200x900",1000,0,600,400,"True",88,604,615,11,11,1
"D04AY",427,414,"1200x900",800,2,600,400,"True",831,592,594,2,2,0
"D04AY",428,288,"1200x900",800,0,600,400,"True",180,547,535,-12,12,1
"D04AY",429,74,"1200x900",600,1,600,400,"True",115,358,423,65,65,0
"D04AY",430,177,"1200x900",600,2,600,400,"False",912,236,343,107,107,0
"D04AY",431,559,"1200x900",1000,1,600,400,"True",641,244,293,49,49,0
"D04AY",432,29,"1200x900",600,0,600,400,"True",385,533,515,-18,18,1
"D04AY",434,365,"1200x900",800,2,600,400,"False",1055,305,562,257,257,0
"D04AY",435,561,"1200x900",1000,1,600,400,"False",231,406,467,61,61,0
"D04AY",436,274,"1200x900",800,0,600,400,"True",146,497,457,-40,40,1
"D04AY",437,467,"1200x900",1000,0,600,400,"False",74,712,495,-217,217,1
"D04AY",438,526,"1200x900",1000,1,600,400,"False",497,710,546,-164,164,0
"D04AY",439,240,"1200x900",800,0,600,400,"True",330,656,601,-55,55,1
"D04AY",441,466,"1200x900",1000,0,600,400,"False",82,205,316,111,111,1
"D04AY",442,97,"1200x900",600,1,600,400,"False",760,643,491,-152,152,1
"D04AY",443,51,"1200x900",600,0,600,400,"True",272,181,146,-35,35,1
"D04AY",444,116,"1200x900",600,1,600,400,"True",767,289,266,-23,23,0
"D04AY",445,217,"1200x900",800,0,600,400,"False",85,573,406,-167,167,1
"D04AY",446,371,"1200x900",800,2,600,400,"False",730,560,445,-115,115,0
"D04AY",447,510,"1200x900",1000,1,600,400,"False",486,338,161,-177,177,1
"D04AY",448,328,"1200x900",800,1,600,400,"False",104,649,277,-372,372,0
"D04AY",449,108,"1200x900",600,1,600,400,"True",830,239,300,61,61,0
"D04AY",450,247,"1200x900",800,0,600,400,"False",160,424,333,-91,91,1
"D04AY",451,465,"1200x900",1000,0,600,400,"True",85,203,264,61,61,1
"D04AY",452,361,"1200x900",800,2,600,400,"True",931,328,333,5,5,0
"D04AY",453,118,"1200x900",600,1,600,400,"False",190,588,245,-343,343,0
"D04AY",454,473,"1200x900",1000,0,600,400,"True",75,323,309,-14,14,1
"D04AY",455,504,"1200x900",1000,0,600,400,"True",107,699,666,-33,33,1
"D04AY",456,568,"1200x900",1000,1,600,400,"False",286,475,538,63,63,1
"D04AY",457,160,"1200x900",600,2,600,400,"True",863,606,566,-40,40,0
"D04AY",458,405,"1200x900",800,2,600,400,"False",790,307,517,210,210,0
"D04AY",459,23,"1200x900",600,0,600,400,"True",308,463,441,-22,22,1
"D04AY",460,5,"1200x900",600,0,600,400,"True",228,587,542,-45,45,0
"D04AY",461,426,"1200x900",800,2,600,400,"False",830,263,417,154,154,0
"D04AY",462,517,"1200x900",1000,1,600,400,"False",548,182,268,86,86,0
"D04AY",463,316,"1200x900",800,1,600,400,"False",362,319,404,85,85,0
"D04AY",464,106,"1200x900",600,1,600,400,"False",803,659,279,-380,380,1
"D04AY",465,416,"1200x900",800,2,600,400,"False",748,617,375,-242,242,0
"D04AY",466,406,"1200x900",800,2,600,400,"False",971,233,376,143,143,0
"D04AY",467,24,"1200x900",600,0,600,400,"True",430,538,477,-61,61,1
"D04AY",468,167,"1200x900",600,2,600,400,"False",956,241,394,153,153,0
"D04AY",469,239,"1200x900",800,0,600,400,"False",114,231,315,84,84,1
"D04AY",470,306,"1200x900",800,1,600,400,"False",164,524,316,-208,208,0
"D04AY",471,236,"1200x900",800,0,600,400,"True",162,350,285,-65,65,1
"D04AY",472,104,"1200x900",600,1,600,400,"False",448,584,299,-285,285,0
"D04AY",473,56,"1200x900",600,0,600,400,"False",148,491,345,-146,146,0
"D04AY",474,111,"1200x900",600,1,600,400,"False",922,552,346,-206,206,1
"D04AY",475,15,"1200x900",600,0,600,400,"True",473,352,372,20,20,1
"D04AY",476,77,"1200x900",600,1,600,400,"False",780,525,347,-178,178,0
"D04AY",477,161,"1200x900",600,2,600,400,"False",939,553,390,-163,163,0
"D04AY",478,37,"1200x900",600,0,600,400,"True",258,403,356,-47,47,1
"D04AY",480,412,"1200x900",800,2,600,400,"True",842,280,336,56,56,0
"D04AY",481,646,"1200x900",1000,2,600,400,"False",829,227,367,140,140,1
"D04AY",482,191,"1200x900",600,2,600,400,"False",962,396,296,-100,100,0
"D04AY",483,587,"1200x900",1000,2,600,400,"False",741,686,389,-297,297,0
"D04AY",484,216,"1200x900",600,2,600,400,"True",1029,286,359,73,73,0
"D04AY",485,27,"1200x900",600,0,600,400,"True",373,309,279,-30,30,1
"D04AY",486,472,"1200x900",1000,0,600,400,"False",77,685,551,-134,134,1
"D04AY",487,632,"1200x900",1000,2,600,400,"False",984,227,585,358,358,0
"D04AY",488,218,"1200x900",800,0,600,400,"False",106,397,491,94,94,1
"D04AY",489,440,"1200x900",1000,0,600,400,"False",71,237,444,207,207,1
"D04AY",490,327,"1200x900",800,1,600,400,"True",152,339,344,5,5,0
"D04AY",492,358,"1200x900",800,1,600,400,"False",263,635,305,-330,330,0
"D04AY",493,565,"1200x900",1000,1,600,400,"False",451,562,389,-173,173,0
"D04AY",494,552,"1200x900",1000,1,600,400,"False",255,412,300,-112,112,0
"D04AY",495,146,"1200x900",600,2,600,400,"False",989,492,293,-199,199,0
"D04AY",496,199,"1200x900",600,2,600,400,"True",992,467,524,57,57,0
"D04AY",497,241,"1200x900",800,0,600,400,"False",129,227,325,98,98,1
"D04AY",498,121,"1200x900",600,1,600,400,"True",884,364,392,28,28,0
"D04AY",499,564,"1200x900",1000,1,600,400,"False",215,264,380,116,116,0
"D04AY",500,379,"1200x900",800,2,600,400,"False",994,325,402,77,77,0
"D04AY",501,558,"1200x900",1000,1,600,400,"False",72,464,318,-146,146,1
"D04AY",502,643,"1200x900",1000,2,600,400,"True",740,325,348,23,23,0
"D04AY",504,591,"1200x900",1000,2,600,400,"True",698,336,325,-11,11,0
"D04AY",505,435,"1200x900",1000,0,600,400,"True",119,200,246,46,46,1
"D04AY",506,194,"1200x900",600,2,600,400,"False",896,236,419,183,183,0
"D04AY",507,73,"1200x900",600,1,600,400,"True",94,665,578,-87,87,0
"D04AY",508,107,"1200x900",600,1,600,400,"False",878,678,500,-178,178,0
"D04AY",509,460,"1200x900",1000,0,600,400,"False",155,189,346,157,157,1
"D04AY",510,334,"1200x900",800,1,600,400,"False",481,665,345,-320,320,0
"D04AY",511,644,"1200x900",1000,2,600,400,"True",495,486,502,16,16,0
"D04AY",512,183,"1200x900",600,2,600,400,"True",927,289,351,62,62,0
"D04AY",513,356,"1200x900",800,1,600,400,"False",123,484,380,-104,104,0
"D04AY",514,481,"1200x900",1000,0,600,400,"False",80,185,256,71,71,1
"D04AY",515,488,"1200x900",1000,0,600,400,"False",129,687,498,-189,189,1
"D04AY",516,528,"1200x900",1000,1,600,400,"False",839,227,529,302,302,1
"D04AY",517,321,"1200x900",800,1,600,400,"False",601,190,497,307,307,0
"D04AY",518,187,"1200x900",600,2,600,400,"False",857,639,446,-193,193,0
"D04AY",519,172,"1200x900",600,2,600,400,"True",912,444,425,-19,19,0
"D04AY",520,447,"1200x900",1000,0,600,400,"True",71,339,379,40,40,1
"D04AY",521,577,"1200x900",1000,2,600,400,"True",455,420,380,-40,40,0
"D04AY",522,70,"1200x900",600,0,600,400,"True",309,703,642,-61,61,1
"D04AY",523,309,"1200x900",800,1,600,400,"False",186,225,519,294,294,0
"D04AY",524,131,"1200x900",600,1,600,400,"True",531,367,366,-1,1,0
"D04AY",525,170,"1200x900",600,2,600,400,"False",996,468,296,-172,172,0
"D04AY",526,49,"1200x900",600,0,600,400,"True",109,380,368,-12,12,0
"D04AY",529,492,"1200x900",1000,0,600,400,"False",76,692,540,-152,152,1
"D04AY",530,476,"1200x900",1000,0,600,400,"False",76,359,472,113,113,1
"D04AY",531,226,"1200x900",800,0,600,400,"False",187,229,328,99,99,1
"D04AY",532,604,"1200x900",1000,2,600,400,"False",459,593,351,-242,242,0
"D04AY",533,509,"1200x900",1000,1,600,400,"True",509,434,411,-23,23,0
"D04AY",534,273,"1200x900",800,0,600,400,"True",180,309,312,3,3,1
"D04AY",535,270,"1200x900",800,0,600,400,"False",192,418,325,-93,93,1
"D04AY",536,359,"1200x900",800,1,600,400,"False",653,241,334,93,93,0
"D04AY",537,243,"1200x900",800,0,600,400,"True",114,332,350,18,18,1
"D04AY",539,235,"1200x900",800,0,600,400,"False",146,646,460,-186,186,1
"D04AY",540,610,"1200x900",1000,2,600,400,"False",702,293,386,93,93,0
"D04AY",541,388,"1200x900",800,2,600,400,"False",930,320,488,168,168,0
"D04AY",542,227,"1200x900",800,0,600,400,"True",196,551,489,-62,62,1
"D04AY",543,339,"1200x900",800,1,600,400,"False",273,545,349,-196,196,1
"D04AY",544,571,"1200x900",1000,1,600,400,"False",239,522,416,-106,106,1
"D04AY",545,141,"1200x900",600,1,600,400,"False",671,582,495,-87,87,0
"D04AY",546,114,"1200x900",600,1,600,400,"False",183,697,544,-153,153,0
"D04AY",547,553,"1200x900",1000,1,600,400,"False",116,712,370,-342,342,0
"D04AY",548,109,"1200x900",600,1,600,400,"False",691,589,406,-183,183,0
"D04AY",549,133,"1200x900",600,1,600,400,"True",345,551,448,-103,103,0
"D04AY",550,195,"1200x900",600,2,600,400,"False",942,249,360,111,111,0
"D04AY",551,428,"1200x900",800,2,600,400,"False",732,665,433,-232,232,0
"D04AY",552,623,"1200x900",1000,2,600,400,"False",636,527,359,-168,168,0
"D04AY",553,593,"1200x900",1000,2,600,400,"False",246,719,571,-148,148,0
"D04AY",554,407,"1200x900",800,2,600,400,"True",989,340,435,95,95,0
"D04AY",555,164,"1200x900",600,2,600,400,"True",1051,268,272,4,4,0
"D04AY",556,126,"1200x900",600,1,600,400,"True",849,354,330,-24,24,0
"D04AY",557,209,"1200x900",600,2,600,400,"False",937,637,481,-156,156,0
"D04AY",558,176,"1200x900",600,2,600,400,"True",1033,281,229,-52,52,0
"D04AY",559,155,"1200x900",600,2,600,400,"True",940,269,311,42,42,0
"D04AY",560,516,"1200x900",1000,1,600,400,"False",440,559,465,-94,94,0
"D04AY",561,521,"1200x900",1000,1,600,400,"True",111,303,372,69,69,1
"D04AY",562,616,"1200x900",1000,2,600,400,"True",854,357,364,7,7,1
"D04AY",565,373,"1200x900",800,2,600,400,"True",694,326,363,37,37,0
"D04AY",566,569,"1200x900",1000,1,600,400,"False",494,720,358,-362,362,0
"D04AY",570,459,"1200x900",1000,0,600,400,"False",70,645,494,-151,151,1
"D04AY",571,572,"1200x900",1000,1,600,400,"False",302,260,401,141,141,0
"D04AY",572,496,"1200x900",1000,0,600,400,"False",70,639,443,-196,196,1
"D04AY",575,382,"1200x900",800,2,600,400,"False",870,523,331,-192,192,0
"D04AY",576,276,"1200x900",800,0,600,400,"False",281,217,315,98,98,1
"D04AY",577,196,"1200x900",600,2,600,400,"False",1030,397,242,-155,155,0
"D04AY",578,514,"1200x900",1000,1,600,400,"False",539,690,382,-308,308,0
"D04AY",579,180,"1200x900",600,2,600,400,"True",929,270,348,78,78,0
"D04AY",580,512,"1200x900",1000,1,600,400,"True",139,261,308,47,47,0
"D04AY",581,152,"1200x900",600,2,600,400,"False",971,399,276,-123,123,0
"D04AY",582,210,"1200x900",600,2,600,400,"False",835,506,241,-265,265,0
"D04AY",583,579,"1200x900",1000,2,600,400,"True",803,394,312,-82,82,0
"D04AY",584,10,"1200x900",600,0,600,400,"False",400,499,400,-99,99,1
"D04AY",585,219,"1200x900",800,0,600,400,"False",202,502,427,-75,75,1
"D04AY",586,197,"1200x900",600,2,600,400,"True",903,212,252,40,40,0
"D04AY",587,480,"1200x900",1000,0,600,400,"False",100,231,309,78,78,1
"D04AY",588,431,"1200x900",800,2,600,400,"True",694,382,341,-41,41,0
"D04AY",589,292,"1200x900",800,1,600,400,"False",88,565,303,-262,262,0
"D04AY",590,145,"1200x900",600,2,600,400,"False",1004,630,352,-278,278,0
"D04AY",591,444,"1200x900",1000,0,600,400,"False",101,714,425,-289,289,1
"D04AY",592,315,"1200x900",800,1,600,400,"False",105,211,396,185,185,0
"D04AY",593,403,"1200x900",800,2,600,400,"False",625,704,444,-260,260,0
"D04AY",594,636,"1200x900",1000,2,600,400,"False",575,583,482,-101,101,0
"D04AY",595,18,"1200x900",600,0,600,400,"False",400,318,434,116,116,1
"D04AY",596,424,"1200x900",800,2,600,400,"False",903,545,288,-257,257,0
"D04AY",597,639,"1200x900",1000,2,600,400,"True",504,456,415,-41,41,0
"D04AY",598,386,"1200x900",800,2,600,400,"True",774,301,314,13,13,0
"D04AY",599,581,"1200x900",1000,2,600,400,"True",310,357,383,26,26,0
"D04AY",600,574,"1200x900",1000,1,600,400,"False",614,194,347,153,153,0
"D04AY",601,228,"1200x900",800,0,600,400,"False",174,687,576,-111,111,1
"D04AY",602,598,"1200x900",1000,2,600,400,"True",706,559,618,59,59,0
"D04AY",603,351,"1200x900",800,1,600,400,"True",122,581,571,-10,10,0
"D04AY",604,171,"1200x900",600,2,600,400,"False",909,200,445,245,245,0
"D04AY",605,159,"1200x900",600,2,600,400,"True",992,309,371,62,62,0
"D04AY",606,120,"1200x900",600,1,600,400,"False",690,655,367,-288,288,0
"D04AY",607,445,"1200x900",1000,0,600,400,"False",78,302,201,-101,101,1
"D04AY",608,425,"1200x900",800,2,600,400,"False",621,438,311,-127,127,0
"D04AY",609,409,"1200x900",800,2,600,400,"False",501,659,338,-321,321,0
"D04AY",610,342,"1200x900",800,1,600,400,"False",677,204,322,118,118,0
"D04AY",611,41,"1200x900",600,0,600,400,"True",370,452,394,-58,58,1
"D04AY",612,89,"1200x900",600,1,600,400,"False",917,366,473,107,107,1
"D04AY",613,301,"1200x900",800,1,600,400,"False",162,574,387,-187,187,0
"D04AY",614,442,"1200x900",1000,0,600,400,"False",87,183,312,129,129,1
"D04AY",615,363,"1200x900",800,2,600,400,"True",800,218,292,74,74,0
"D04AY",616,139,"1200x900",600,1,600,400,"False",192,695,291,-404,404,0
"D04AY",618,364,"1200x900",800,2,600,400,"False",1018,204,535,331,331,0
"D04AY",619,260,"1200x900",800,0,600,400,"True",103,525,490,-35,35,1
"D04AY",620,262,"1200x900",800,0,600,400,"True",196,481,480,-1,1,1
"D04AY",621,520,"1200x900",1000,1,600,400,"False",564,260,457,197,197,0
"D04AY",622,65,"1200x900",600,0,600,400,"False",442,645,501,-144,144,1
"D04AY",623,483,"1200x900",1000,0,600,400,"False",93,191,429,238,238,1
"D04AY",624,253,"1200x900",800,0,600,400,"False",177,424,330,-94,94,1
"D04AY",625,524,"1200x900",1000,1,600,400,"True",534,470,434,-36,36,0
"D04AY",626,539,"1200x900",1000,1,600,400,"True",510,383,439,56,56,0
"D04AY",627,30,"1200x900",600,0,600,400,"True",107,353,413,60,60,0
"D04AY",628,8,"1200x900",600,0,600,400,"False",156,679,428,-251,251,0
"D04AY",629,9,"1200x900",600,0,600,400,"False",509,654,497,-157,157,1
"D04AY",631,53,"1200x900",600,0,600,400,"False",177,189,370,181,181,0
"D04AY",632,200,"1200x900",600,2,600,400,"True",897,302,255,-47,47,0
"D04AY",633,138,"1200x900",600,1,600,400,"False",844,580,387,-193,193,1
"D04AY",635,624,"1200x900",1000,2,600,400,"False",693,501,372,-129,129,0
"D04AY",636,287,"1200x900",800,0,600,400,"True",120,567,509,-58,58,1
"D04AY",637,82,"1200x900",600,1,600,400,"False",108,213,436,223,223,0
"D04AY",638,461,"1200x900",1000,0,600,400,"False",95,711,530,-181,181,1
"D04AY",640,413,"1200x900",800,2,600,400,"True",849,506,550,44,44,0
"D04AY",641,264,"1200x900",800,0,600,400,"True",198,660,696,36,36,1
"D04AY",642,380,"1200x900",800,2,600,400,"False",942,228,332,104,104,0
"D04AY",643,115,"1200x900",600,1,600,400,"True",545,307,292,-15,15,0
"D04AY",644,26,"1200x900",600,0,600,400,"False",70,712,303,-409,409,0
"D04AY",645,479,"1200x900",1000,0,600,400,"False",74,705,461,-244,244,1
"D04AY",646,124,"1200x900",600,1,600,400,"True",345,467,428,-39,39,0
"D04AY",647,530,"1200x900",1000,1,600,400,"False",584,405,301,-104,104,1
"D04AY",648,609,"1200x900",1000,2,600,400,"False",697,627,309,-318,318,0
"D05MN",1,118,"1200x900",600,1,600,400,"False",190,588,699,111,111,0
"D05MN",2,14,"1200x900",600,0,600,400,"False",399,224,433,209,209,1
"D05MN",3,437,"1200x900",1000,0,600,400,"False",74,667,558,-109,109,1
"D05MN",4,413,"1200x900",800,2,600,400,"False",849,506,676,170,170,0
"D05MN",5,20,"1200x900",600,0,600,400,"True",204,545,555,10,10,1
"D05MN",6,472,"1200x900",1000,0,600,400,"False",77,685,447,-238,238,1
"D05MN",7,632,"1200x900",1000,2,600,400,"False",984,227,609,382,382,0
"D05MN",8,300,"1200x900",800,1,600,400,"False",620,693,563,-130,130,0
"D05MN",9,274,"1200x900",800,0,600,400,"True",146,497,469,-28,28,1
"D05MN",10,111,"1200x900",600,1,600,400,"False",922,552,473,-79,79,1
"D05MN",11,555,"1200x900",1000,1,600,400,"False",444,556,436,-120,120,0
"D05MN",12,525,"1200x900",1000,1,600,400,"False",123,690,382,-308,308,0
"D05MN",13,474,"1200x900",1000,0,600,400,"False",85,339,585,246,246,1
"D05MN",14,271,"1200x900",800,0,600,400,"True",74,360,412,52,52,1
"D05MN",15,480,"1200x900",1000,0,600,400,"False",100,231,380,149,149,1
"D05MN",16,240,"1200x900",800,0,600,400,"False",330,656,490,-166,166,1
"D05MN",17,375,"1200x900",800,2,600,400,"False",716,384,217,-167,167,0
"D05MN",18,481,"1200x900",1000,0,600,400,"False",80,185,354,169,169,1
"D05MN",19,183,"1200x900",600,2,600,400,"True",927,289,265,-24,24,0
"D05MN",20,223,"1200x900",800,0,600,400,"False",179,191,105,-86,86,1
"D05MN",21,39,"1200x900",600,0,600,400,"True",210,609,572,-37,37,0
"D05MN",22,273,"1200x900",800,0,600,400,"True",180,309,321,12,12,1
"D05MN",23,531,"1200x900",1000,1,600,400,"True",233,362,309,-53,53,0
"D05MN",24,265,"1200x900",800,0,600,400,"False",229,353,426,73,73,1
"D05MN",25,428,"1200x900",800,2,600,400,"False",732,665,425,-240,240,0
"D05MN",26,589,"1200x900",1000,2,600,400,"False",856,418,594,176,176,0
"D05MN",27,527,"1200x900",1000,1,600,400,"True",565,601,536,-65,65,0
"D05MN",28,364,"1200x900",800,2,600,400,"False",1018,204,539,335,335,0
"D05MN",29,153,"1200x900",600,2,600,400,"False",1037,601,665,64,64,0
"D05MN",30,189,"1200x900",600,2,600,400,"False",881,397,330,-67,67,0
"D05MN",32,630,"1200x900",1000,2,600,400,"True",754,559,524,-35,35,0
"D05MN",33,388,"1200x900",800,2,600,400,"False",930,320,511,191,191,0
"D05MN",34,78,"1200x900",600,1,600,400,"False",885,684,491,-193,193,0
"D05MN",35,247,"1200x900",800,0,600,400,"False",160,424,525,101,101,1
"D05MN",36,119,"1200x900",600,1,600,400,"False",168,563,460,-103,103,0
"D05MN",37,327,"1200x900",800,1,600,400,"False",152,339,447,108,108,0
"D05MN",38,409,"1200x900",800,2,600,400,"False",501,659,448,-211,211,0
"D05MN",39,577,"1200x900",1000,2,600,400,"True",455,420,412,-8,8,0
"D05MN",40,40,"1200x900",600,0,600,400,"True",143,513,490,-23,23,0
"D05MN",41,214,"1200x900",600,2,600,400,"False",1046,305,487,182,182,0
"D05MN",42,208,"1200x900",600,2,600,400,"True",946,399,445,46,46,0
"D05MN",43,482,"1200x900",1000,0,600,400,"False",79,686,476,-210,210,1
"D05MN",44,279,"1200x900",800,0,600,400,"False",252,202,451,249,249,1
"D05MN",45,102,"1200x900",600,1,600,400,"False",861,603,430,-173,173,0
"D05MN",46,459,"1200x900",1000,0,600,400,"False",70,645,491,-154,154,1
"D05MN",47,517,"1200x900",1000,1,600,400,"False",548,182,542,360,360,0
"D05MN",48,601,"1200x900",1000,2,600,400,"False",735,697,296,-401,401,0
"D05MN",49,225,"1200x900",800,0,600,400,"True",178,423,360,-63,63,1
"D05MN",50,593,"1200x900",1000,2,600,400,"False",246,719,240,-479,479,0
"D05MN",51,113,"1200x900",600,1,600,400,"True",897,657,682,25,25,0
"D05MN",52,391,"1200x900",800,2,600,400,"False",895,521,457,-64,64,0
"D05MN",53,455,"1200x900",1000,0,600,400,"False",107,718,483,-235,235,1
"D05MN",54,378,"1200x900",800,2,600,400,"False",1018,708,568,-140,140,0
"D05MN",55,529,"1200x900",1000,1,600,400,"True",267,412,431,19,19,1
"D05MN",56,168,"1200x900",600,2,600,400,"True",1001,439,385,-54,54,0
"D05MN",57,494,"1200x900",1000,0,600,400,"False",127,692,558,-134,134,1
"D05MN",58,405,"1200x900",800,2,600,400,"False",790,307,386,79,79,0
"D05MN",59,642,"1200x900",1000,2,600,400,"True",776,316,330,14,14,0
"D05MN",60,63,"1200x900",600,0,600,400,"True",311,188,193,5,5,1
"D05MN",61,48,"1200x900",600,0,600,400,"False",323,645,532,-113,113,1
"D05MN",62,89,"1200x900",600,1,600,400,"False",917,366,452,86,86,1
"D05MN",63,361,"1200x900",800,2,600,400,"True",931,328,360,32,32,0
"D05MN",64,217,"1200x900",800,0,600,400,"False",85,573,460,-113,113,1
"D05MN",65,626,"1200x900",1000,2,600,400,"True",329,449,489,40,40,0
"D05MN",66,75,"1200x900",600,1,600,400,"True",635,558,490,-68,68,0
"D05MN",67,37,"1200x900",600,0,600,400,"True",258,403,397,-6,6,1
"D05MN",68,270,"1200x900",800,0,600,400,"True",192,418,471,53,53,1
"D05MN",69,218,"1200x900",800,0,600,400,"True",106,397,453,56,56,1
"D05MN",70,423,"1200x900",800,2,600,400,"False",1051,710,435,-275,275,1
"D05MN",71,246,"1200x900",800,0,600,400,"True",196,418,476,58,58,1
"D05MN",72,548,"1200x900",1000,1,600,400,"False",103,278,378,100,100,0
"D05MN",73,288,"1200x900",800,0,600,400,"True",180,547,501,-46,46,1
"D05MN",74,345,"1200x900",800,1,600,400,"False",841,566,644,78,78,1
"D05MN",75,439,"1200x900",1000,0,600,400,"False",110,229,396,167,167,1
"D05MN",76,328,"1200x900",800,1,600,400,"False",104,649,228,-421,421,0
"D05MN",77,9,"1200x900",600,0,600,400,"False",509,654,585,-69,69,1
"D05MN",78,390,"1200x900",800,2,600,400,"False",982,674,730,56,56,1
"D05MN",79,220,"1200x900",800,0,600,400,"True",108,699,654,-45,45,1
"D05MN",80,621,"1200x900",1000,2,600,400,"False",540,478,698,220,220,0
"D05MN",81,68,"1200x900",600,0,600,400,"True",165,367,333,-34,34,0
"D05MN",82,236,"1200x900",800,0,600,400,"True",162,350,309,-41,41,1
"D05MN",83,640,"1200x900",1000,2,600,400,"False",361,334,443,109,109,0
"D05MN",84,95,"1200x900",600,1,600,400,"True",749,425,439,14,14,1
"D05MN",85,452,"1200x900",1000,0,600,400,"False",97,273,429,156,156,1
"D05MN",86,243,"1200x900",800,0,600,400,"True",114,332,352,20,20,1
"D05MN",87,11,"1200x900",600,0,600,400,"False",372,670,548,-122,122,1
"D05MN",88,615,"1200x900",1000,2,600,400,"True",736,634,678,44,44,0
"D05MN",89,487,"1200x900",1000,0,600,400,"False",78,670,604,-66,66,1
"D05MN",90,293,"1200x900",800,1,600,400,"False",561,396,514,118,118,0
"D05MN",91,422,"1200x900",800,2,600,400,"True",712,558,572,14,14,0
"D05MN",93,221,"1200x900",800,0,600,400,"True",132,520,506,-14,14,1
"D05MN",95,360,"1200x900",800,1,600,400,"False",203,608,519,-89,89,0
"D05MN",96,421,"1200x900",800,2,600,400,"False",898,394,508,114,114,0
"D05MN",97,543,"1200x900",1000,1,600,400,"False",88,202,446,244,244,0
"D05MN",98,641,"1200x900",1000,2,600,400,"False",897,272,443,171,171,0
"D05MN",99,516,"1200x900",1000,1,600,400,"False",440,559,403,-156,156,0
"D05MN",100,594,"1200x900",1000,2,600,400,"False",537,637,490,-147,147,0
"D05MN",101,276,"1200x900",800,0,600,400,"False",281,217,354,137,137,1
"D05MN",102,268,"1200x900",800,0,600,400,"True",148,400,377,-23,23,1
"D05MN",103,357,"1200x900",800,1,600,400,"False",109,594,400,-194,194,0
"D05MN",104,387,"1200x900",800,2,600,400,"False",990,444,281,-163,163,0
"D05MN",105,191,"1200x900",600,2,600,400,"False",962,396,253,-143,143,0
"D05MN",106,81,"1200x900",600,1,600,400,"True",696,225,283,58,58,0
"D05MN",107,257,"1200x900",800,0,600,400,"True",97,219,185,-34,34,1
"D05MN",108,314,"1200x900",800,1,600,400,"False",277,616,353,-263,263,1
"D05MN",109,202,"1200x900",600,2,600,400,"False",966,460,340,-120,120,0
"D05MN",110,448,"1200x900",1000,0,600,400,"False",107,641,502,-139,139,1
"D05MN",111,343,"1200x900",800,1,600,400,"False",407,557,470,-87,87,0
"D05MN",112,241,"1200x900",800,0,600,400,"True",129,227,247,20,20,1
"D05MN",113,275,"1200x900",800,0,600,400,"False",120,594,409,-185,185,0
"D05MN",114,83,"1200x900",600,1,600,400,"False",763,568,425,-143,143,1
"D05MN",115,30,"1200x900",600,0,600,400,"True",107,353,380,27,27,0
"D05MN",116,310,"1200x900",800,1,600,400,"False",559,592,346,-246,246,0
"D05MN",117,134,"1200x900",600,1,600,400,"False",300,188,130,-58,58,0
"D05MN",118,45,"1200x900",600,0,600,400,"False",487,678,570,-108,108,1
"D05MN",119,400,"1200x900",800,2,600,400,"False",733,297,430,133,133,0
"D05MN",120,227,"1200x900",800,0,600,400,"True",196,551,557,6,6,1
"D05MN",121,433,"1200x900",1000,0,600,400,"False",76,222,372,150,150,1
"D05MN",122,156,"1200x900",600,2,600,400,"False",913,197,348,151,151,0
"D05MN",123,547,"1200x900",1000,1,600,400,"False",369,384,528,144,144,1
"D05MN",124,181,"1200x900",600,2,600,400,"False",1018,223,349,126,126,0
"D05MN",125,70,"1200x900",600,0,600,400,"True",309,703,711,8,8,1
"D05MN",126,258,"1200x900",800,0,600,400,"True",126,664,671,7,7,1
"D05MN",127,404,"1200x900",800,2,600,400,"False",842,396,595,199,199,0
"D05MN",128,77,"1200x900",600,1,600,400,"True",780,525,455,-70,70,0
"D05MN",129,363,"1200x900",800,2,600,400,"False",800,218,421,203,203,0
"D05MN",130,82,"1200x900",600,1,600,400,"False",108,213,67,-146,146,0
"D05MN",131,98,"1200x900",600,1,600,400,"True",625,530,517,-13,13,0
"D05MN",132,468,"1200x900",1000,0,600,400,"False",121,219,426,207,207,1
"D05MN",133,54,"1200x900",600,0,600,400,"True",474,564,522,-42,42,1
"D05MN",134,449,"1200x900",1000,0,600,400,"False",105,683,567,-116,116,1
"D05MN",135,416,"1200x900",800,2,600,400,"False",748,617,397,-220,220,0
"D05MN",136,586,"1200x900",1000,2,600,400,"False",802,262,368,106,106,0
"D05MN",137,451,"1200x900",1000,0,600,400,"False",110,702,488,-214,214,1
"D05MN",138,329,"1200x900",800,1,600,400,"False",517,239,436,197,197,0
"D05MN",139,57,"1200x900",600,0,600,400,"True",354,508,543,35,35,1
"D05MN",140,556,"1200x900",1000,1,600,400,"False",415,420,577,157,157,0
"D05MN",141,434,"1200x900",1000,0,600,400,"False",89,657,417,-240,240,1
"D05MN",142,528,"1200x900",1000,1,600,400,"False",839,227,520,293,293,1
"D05MN",143,306,"1200x900",800,1,600,400,"True",164,524,459,-65,65,0
"D05MN",144,635,"1200x900",1000,2,600,400,"False",833,402,180,-222,222,0
"D05MN",145,613,"1200x900",1000,2,600,400,"True",690,374,431,57,57,0
"D05MN",146,87,"1200x900",600,1,600,400,"False",231,604,444,-160,160,0
"D05MN",147,5,"1200x900",600,0,600,400,"True",228,587,532,-55,55,0
"D05MN",148,582,"1200x900",1000,2,600,400,"False",554,347,445,98,98,0
"D05MN",149,490,"1200x900",1000,0,600,400,"False",114,183,272,89,89,1
"D05MN",150,394,"1200x900",800,2,600,400,"True",847,292,343,51,51,0
"D05MN",151,121,"1200x900",600,1,600,400,"True",884,364,310,-54,54,0
"D05MN",152,199,"1200x900",600,2,600,400,"False",992,467,375,-92,92,0
"D05MN",153,464,"1200x900",1000,0,600,400,"False",82,222,326,104,104,1
"D05MN",154,457,"1200x900",1000,0,600,400,"False",97,630,412,-218,218,1
"D05MN",155,309,"1200x900",800,1,600,400,"True",186,225,268,43,43,0
"D05MN",156,442,"1200x900",1000,0,600,400,"False",87,183,259,76,76,1
"D05MN",157,344,"1200x900",800,1,600,400,"False",589,408,261,-147,147,0
"D05MN",158,22,"1200x900",600,0,600,400,"False",398,591,480,-111,111,1
"D05MN",159,441,"1200x900",1000,0,600,400,"False",85,684,516,-168,168,1
"D05MN",160,530,"1200x900",1000,1,600,400,"False",584,405,528,123,123,1
"D05MN",161,187,"1200x900",600,2,600,400,"False",857,639,516,-123,123,0
"D05MN",162,498,"1200x900",1000,0,600,400,"False",100,260,458,198,198,1
"D05MN",163,484,"1200x900",1000,0,600,400,"False",100,223,493,270,270,1
"D05MN",164,123,"1200x900",600,1,600,400,"True",761,365,452,87,87,1
"D05MN",165,352,"1200x900",800,1,600,400,"False",235,717,469,-248,248,0
"D05MN",166,349,"1200x900",800,1,600,400,"False",402,665,439,-226,226,0
"D05MN",167,131,"1200x900",600,1,600,400,"True",531,367,408,41,41,0
"D05MN",168,509,"1200x900",1000,1,600,400,"False",509,434,526,92,92,0
"D05MN",169,566,"1200x900",1000,1,600,400,"True",378,472,504,32,32,1
"D05MN",171,256,"1200x900",800,0,600,400,"True",192,656,614,-42,42,1
"D05MN",172,56,"1200x900",600,0,600,400,"False",148,491,578,87,87,0
"D05MN",173,186,"1200x900",600,2,600,400,"False",997,197,496,299,299,0
"D05MN",174,148,"1200x900",600,2,600,400,"False",907,330,501,171,171,0
"D05MN",175,554,"1200x900",1000,1,600,400,"False",79,309,227,-82,82,1
"D05MN",176,47,"1200x900",600,0,600,400,"False",303,499,348,-151,151,1
"D05MN",177,297,"1200x900",800,1,600,400,"True",625,244,266,22,22,0
"D05MN",178,412,"1200x900",800,2,600,400,"True",842,280,361,81,81,0
"D05MN",179,161,"1200x900",600,2,600,400,"False",939,553,363,-190,190,0
"D05MN",180,470,"1200x900",1000,0,600,400,"False",91,666,488,-178,178,1
"D05MN",181,267,"1200x900",800,0,600,400,"True",145,665,609,-56,56,1
"D05MN",182,295,"1200x900",800,1,600,400,"False",471,334,523,189,189,0
"D05MN",183,272,"1200x900",800,0,600,400,"False",200,181,410,229,229,1
"D05MN",184,456,"1200x900",1000,0,600,400,"False",91,257,399,142,142,1
"D05MN",185,420,"1200x900",800,2,600,400,"True",519,223,294,71,71,0
"D05MN",186,648,"1200x900",1000,2,600,400,"True",557,394,374,-20,20,0
"D05MN",187,212,"1200x900",600,2,600,400,"False",841,206,364,158,158,0
"D05MN",188,510,"1200x900",1000,1,600,400,"True",486,338,332,-6,6,1
"D05MN",189,597,"1200x900",1000,2,600,400,"True",352,239,234,-5,5,0
"D05MN",190,206,"1200x900",600,2,600,400,"True",975,223,226,3,3,0
"D05MN",191,333,"1200x900",800,1,600,400,"False",521,548,424,-124,124,0
"D05MN",192,233,"1200x900",800,0,600,400,"True",164,700,701,1,1,1
"D05MN",193,99,"1200x900",600,1,600,400,"True",811,407,366,-41,41,0
"D05MN",194,332,"1200x900",800,1,600,400,"False",260,699,479,-220,220,0
"D05MN",195,188,"1200x900",600,2,600,400,"False",900,195,462,267,267,0
"D05MN",196,278,"1200x900",800,0,600,400,"False",251,711,636,-75,75,1
"D05MN",198,624,"1200x900",1000,2,600,400,"True",693,501,440,-61,61,0
"D05MN",199,76,"1200x900",600,1,600,400,"True",647,614,526,-88,88,0
"D05MN",200,248,"1200x900",800,0,600,400,"False",94,240,452,212,212,1
"D05MN",201,203,"1200x900",600,2,600,400,"True",938,603,525,-78,78,0
"D05MN",202,196,"1200x900",600,2,600,400,"False",1030,397,259,-138,138,0
"D05MN",203,424,"1200x900",800,2,600,400,"False",903,545,444,-101,101,0
"D05MN",204,415,"1200x900",800,2,600,400,"False",823,684,507,-177,177,0
"D05MN",205,515,"1200x900",1000,1,600,400,"False",307,217,387,170,170,0
"D05MN",206,115,"1200x900",600,1,600,400,"False",545,307,243,-64,64,0
"D05MN",207,483,"1200x900",1000,0,600,400,"False",93,191,313,122,122,1
"D05MN",208,124,"1200x900",600,1,600,400,"False",345,467,392,-75,75,0
"D05MN",209,585,"1200x900",1000,2,600,400,"False",698,688,456,-232,232,1
"D05MN",210,27,"1200x900",600,0,600,400,"True",373,309,365,56,56,1
"D05MN",211,128,"1200x900",600,1,600,400,"True",661,258,264,6,6,1
"D05MN",212,290,"1200x900",800,1,600,400,"False",789,603,380,-223,223,0
"D05MN",213,219,"1200x900",800,0,600,400,"True",202,502,529,27,27,1
"D05MN",214,49,"1200x900",600,0,600,400,"False",109,380,466,86,86,0
"D05MN",215,163,"1200x900",600,2,600,400,"True",1046,665,585,-80,80,0
"D05MN",216,617,"1200x900",1000,2,600,400,"True",294,180,200,20,20,0
"D05MN",217,43,"1200x900",600,0,600,400,"False",277,446,254,-192,192,1
"D05MN",218,323,"1200x900",800,1,600,400,"True",388,348,334,-14,14,0
"D05MN",219,606,"1200x900",1000,2,600,400,"False",653,627,707,80,80,0
"D05MN",220,317,"1200x900",800,1,600,400,"True",185,564,527,-37,37,0
"D05MN",221,321,"1200x900",800,1,600,400,"False",601,190,344,154,154,0
"D05MN",222,340,"1200x900",800,1,600,400,"False",226,240,409,169,169,0
"D05MN",223,579,"1200x900",1000,2,600,400,"False",803,394,720,326,326,0
"D05MN",224,605,"1200x900",1000,2,600,400,"True",493,665,598,-67,67,0
"D05MN",225,322,"1200x900",800,1,600,400,"False",703,206,456,250,250,1
"D05MN",226,234,"1200x900",800,0,600,400,"True",72,344,348,4,4,1
"D05MN",227,24,"1200x900",600,0,600,400,"False",430,538,447,-91,91,1
"D05MN",228,170,"1200x900",600,2,600,400,"False",996,468,299,-169,169,0
"D05MN",229,376,"1200x900",800,2,600,400,"False",788,275,142,-133,133,0
"D05MN",230,564,"1200x900",1000,1,600,400,"True",215,264,314,50,50,0
"D05MN",231,112,"1200x900",600,1,600,400,"True",681,490,451,-39,39,0
"D05MN",232,346,"1200x900",800,1,600,400,"True",269,635,550,-85,85,0
"D05MN",233,575,"1200x900",1000,1,600,400,"True",272,693,664,-29,29,0
"D05MN",234,341,"1200x900",800,1,600,400,"False",735,632,543,-89,89,1
"D05MN",235,235,"1200x900",800,0,600,400,"False",146,646,524,-122,122,1
"D05MN",236,563,"1200x900",1000,1,600,400,"True",201,696,760,64,64,0
"D05MN",237,224,"1200x900",800,0,600,400,"False",161,474,613,139,139,1
"D05MN",238,462,"1200x900",1000,0,600,400,"False",102,672,491,-181,181,1
"D05MN",239,315,"1200x900",800,1,600,400,"False",105,211,458,247,247,0
"D05MN",240,62,"1200x900",600,0,600,400,"True",345,346,384,38,38,1
"D05MN",241,167,"1200x900",600,2,600,400,"False",956,241,366,125,125,0
"D05MN",242,646,"1200x900",1000,2,600,400,"False",829,227,379,152,152,1
"D05MN",243,591,"1200x900",1000,2,600,400,"False",698,336,252,-84,84,0
"D05MN",244,544,"1200x900",1000,1,600,400,"False",602,620,423,-197,197,0
"D05MN",245,519,"1200x900",1000,1,600,400,"False",319,565,473,-92,92,1
"D05MN",246,209,"1200x900",600,2,600,400,"False",937,637,500,-137,137,0
"D05MN",247,104,"1200x900",600,1,600,400,"True",448,584,553,-31,31,0
"D05MN",248,301,"1200x900",800,1,600,400,"False",162,574,484,-90,90,0
"D05MN",249,108,"1200x900",600,1,600,400,"True",830,239,295,56,56,0
"D05MN",250,647,"1200x900",1000,2,600,400,"False",560,637,788,151,151,0
"D05MN",251,417,"1200x900",800,2,600,400,"False",750,280,659,379,379,0
"D05MN",252,160,"1200x900",600,2,600,400,"False",863,606,494,-112,112,0
"D05MN",253,425,"1200x900",800,2,600,400,"True",621,438,456,18,18,0
"D05MN",254,595,"1200x900",1000,2,600,400,"False",687,640,282,-358,358,0
"D05MN",255,393,"1200x900",800,2,600,400,"False",657,620,699,79,79,0
"D05MN",256,371,"1200x900",800,2,600,400,"False",730,560,677,117,117,0
"D05MN",257,397,"1200x900",800,2,600,400,"False",817,692,604,-88,88,0
"D05MN",258,351,"1200x900",800,1,600,400,"True",122,581,640,59,59,0
"D05MN",259,463,"1200x900",1000,0,600,400,"False",115,693,582,-111,111,1
"D05MN",260,604,"1200x900",1000,2,600,400,"True",459,593,554,-39,39,0
"D05MN",261,450,"1200x900",1000,0,600,400,"False",130,204,390,186,186,1
"D05MN",262,431,"1200x900",800,2,600,400,"True",694,382,353,-29,29,0
"D05MN",263,201,"1200x900",600,2,600,400,"False",1005,462,268,-194,194,0
"D05MN",264,195,"1200x900",600,2,600,400,"False",942,249,194,-55,55,0
"D05MN",265,584,"1200x900",1000,2,600,400,"False",731,413,340,-73,73,0
"D05MN",266,440,"1200x900",1000,0,600,400,"False",71,237,386,149,149,1
"D05MN",268,353,"1200x900",800,1,600,400,"True",90,476,530,54,54,0
"D05MN",269,475,"1200x900",1000,0,600,400,"False",101,715,516,-199,199,1
"D05MN",270,120,"1200x900",600,1,600,400,"False",690,655,499,-156,156,0
"D05MN",271,4,"1200x900",600,0,600,400,"False",602,200,404,204,204,1
"D05MN",272,331,"1200x900",800,1,600,400,"False",240,620,296,-324,324,0
"D05MN",273,319,"1200x900",800,1,600,400,"False",494,587,484,-103,103,1
"D05MN",274,15,"1200x900",600,0,600,400,"False",473,352,470,118,118,1
"D05MN",275,467,"1200x900",1000,0,600,400,"False",74,712,469,-243,243,1
"D05MN",276,536,"1200x900",1000,1,600,400,"False",580,213,324,111,111,0
"D05MN",277,132,"1200x900",600,1,600,400,"True",333,185,290,105,105,0
"D05MN",278,629,"1200x900",1000,2,600,400,"True",681,257,259,2,2,0
"D05MN",279,426,"1200x900",800,2,600,400,"True",830,263,242,-21,21,0
"D05MN",281,237,"1200x900",800,0,600,400,"True",204,481,431,-50,50,1
"D05MN",282,285,"1200x900",800,0,600,400,"True",237,396,437,41,41,1
"D05MN",285,366,"1200x900",800,2,600,400,"True",931,464,421,-43,43,0
"D05MN",286,520,"1200x900",1000,1,600,400,"True",564,260,265,5,5,0
"D05MN",287,84,"1200x900",600,1,600,400,"True",144,184,261,77,77,0
"D05MN",288,298,"1200x900",800,1,600,400,"False",311,457,290,-167,167,0
"D05MN",289,110,"1200x900",600,1,600,400,"True",776,550,453,-97,97,1
"D05MN",290,173,"1200x900",600,2,600,400,"True",948,693,632,-61,61,0
"D05MN",291,184,"1200x900",600,2,600,400,"False",1067,441,741,300,300,0
"D05MN",292,342,"1200x900",800,1,600,400,"False",677,204,480,276,276,0
"D05MN",293,216,"1200x900",600,2,600,400,"False",1029,286,208,-78,78,0
"D05MN",294,602,"1200x900",1000,2,600,400,"True",865,452,414,-38,38,0
"D05MN",295,429,"1200x900",800,2,600,400,"False",682,692,353,-339,339,0
"D05MN",296,155,"1200x900",600,2,600,400,"True",940,269,350,81,81,0
"D05MN",297,414,"1200x900",800,2,600,400,"False",831,592,332,-260,260,0
"D05MN",298,12,"1200x900",600,0,600,400,"False",365,336,420,84,84,1
"D05MN",299,13,"1200x900",600,0,600,400,"False",296,211,343,132,132,1
"D05MN",300,573,"1200x900",1000,1,600,400,"False",486,615,468,-147,147,0
"D05MN",301,100,"1200x900",600,1,600,400,"False",453,511,325,-186,186,0
"D05MN",302,427,"1200x900",800,2,600,400,"False",812,380,233,-147,147,0
"D05MN",303,204,"1200x900",600,2,600,400,"False",1053,432,207,-225,225,0
"D05MN",304,114,"1200x900",600,1,600,400,"False",183,697,337,-360,360,0
"D05MN",305,205,"1200x900",600,2,600,400,"False",1021,504,685,181,181,0
"D05MN",306,193,"1200x900",600,2,600,400,"False",874,588,737,149,149,0
"D05MN",307,598,"1200x900",1000,2,600,400,"True",706,559,571,12,12,0
"D05MN",308,477,"1200x900",1000,0,600,400,"False",88,640,549,-91,91,1
"D05MN",310,292,"1200x900",800,1,600,400,"True",88,565,534,-31,31,0
"D05MN",311,262,"1200x900",800,0,600,400,"True",196,481,452,-29,29,1
"D05MN",312,370,"1200x900",800,2,600,400,"True",874,336,390,54,54,0
"D05MN",313,488,"1200x900",1000,0,600,400,"False",129,687,453,-234,234,1
"D05MN",314,64,"1200x900",600,0,600,400,"False",102,339,420,81,81,0
"D05MN",315,436,"1200x900",1000,0,600,400,"False",82,617,456,-161,161,1
"D05MN",316,347,"1200x900",800,1,600,400,"True",757,295,332,37,37,1
"D05MN",317,507,"1200x900",1000,1,600,400,"False",608,583,445,-138,138,1
"D05MN",318,559,"1200x900",1000,1,600,400,"True",641,244,211,-33,33,0
"D05MN",319,614,"1200x900",1000,2,600,400,"False",823,563,387,-176,176,0
"D05MN",320,337,"1200x900",800,1,600,400,"False",299,622,327,-295,295,0
"D05MN",321,336,"1200x900",800,1,600,400,"True",251,587,569,-18,18,0
"D05MN",322,523,"1200x900",1000,1,600,400,"False",339,318,463,145,145,0
"D05MN",323,568,"1200x900",1000,1,600,400,"True",286,475,446,-29,29,1
"D05MN",324,6,"1200x900",600,0,600,400,"False",217,689,550,-139,139,1
"D05MN",325,495,"1200x900",1000,0,600,400,"False",93,692,485,-207,207,1
"D05MN",326,116,"1200x900",600,1,600,400,"True",767,289,402,113,113,0
"D05MN",327,101,"1200x900",600,1,600,400,"False",541,656,485,-171,171,0
"D05MN",328,79,"1200x900",600,1,600,400,"False",731,289,506,217,217,0
"D05MN",329,10,"1200x900",600,0,600,400,"False",400,499,424,-75,75,1
"D05MN",330,146,"1200x900",600,2,600,400,"False",989,492,379,-113,113,0
"D05MN",331,335,"1200x900",800,1,600,400,"False",124,360,419,59,59,0
"D05MN",332,645,"1200x900",1000,2,600,400,"True",619,396,349,-47,47,0
"D05MN",333,117,"1200x900",600,1,600,400,"False",711,456,402,-54,54,0
"D05MN",334,145,"1200x900",600,2,600,400,"False",1004,630,486,-144,144,0
"D05MN",335,305,"1200x900",800,1,600,400,"False",471,716,409,-307,307,0
"D05MN",336,492,"1200x900",1000,0,600,400,"False",76,692,450,-242,242,1
"D05MN",337,526,"1200x900",1000,1,600,400,"True",497,710,741,31,31,0
"D05MN",338,592,"1200x900",1000,2,600,400,"False",492,392,226,-166,166,0
"D05MN",339,381,"1200x900",800,2,600,400,"False",705,408,296,-112,112,0
"D05MN",340,284,"1200x900",800,0,600,400,"True",135,293,338,45,45,1
"D05MN",341,324,"1200x900",800,1,600,400,"False",719,712,299,-413,413,1
"D05MN",342,447,"1200x900",1000,0,600,400,"False",71,339,541,202,202,1
"D05MN",343,28,"1200x900",600,0,600,400,"True",336,410,430,20,20,1
"D05MN",344,143,"1200x900",600,1,600,400,"False",479,284,391,107,107,1
"D05MN",345,165,"1200x900",600,2,600,400,"False",912,554,352,-202,202,0
"D05MN",346,107,"1200x900",600,1,600,400,"False",878,678,445,-233,233,0
"D05MN",347,385,"1200x900",800,2,600,400,"True",740,456,459,3,3,0
"D05MN",348,503,"1200x900",1000,0,600,400,"False",86,279,452,173,173,1
"D05MN",349,294,"1200x900",800,1,600,400,"False",262,287,437,150,150,0
"D05MN",350,402,"1200x900",800,2,600,400,"False",878,234,322,88,88,0
"D05MN",351,410,"1200x900",800,2,600,400,"False",916,477,318,-159,159,0
"D05MN",352,198,"1200x900",600,2,600,400,"True",976,500,508,8,8,0
"D05MN",353,628,"1200x900",1000,2,600,400,"True",768,410,412,2,2,0
"D05MN",354,261,"1200x900",800,0,600,400,"True",86,713,687,-26,26,1
"D05MN",355,616,"1200x900",1000,2,600,400,"True",854,357,501,144,144,1
"D05MN",356,308,"1200x900",800,1,600,400,"False",437,425,540,115,115,0
"D05MN",357,634,"1200x900",1000,2,600,400,"False",735,313,504,191,191,0
"D05MN",358,303,"1200x900",800,1,600,400,"True",241,431,406,-25,25,0
"D05MN",359,511,"1200x900",1000,1,600,400,"False",408,390,471,81,81,1
"D05MN",360,250,"1200x900",800,0,600,400,"False",290,248,411,163,163,1
"D05MN",361,86,"1200x900",600,1,600,400,"True",692,388,377,-11,11,1
"D05MN",362,465,"1200x900",1000,0,600,400,"False",85,203,286,83,83,1
"D05MN",363,580,"1200x900",1000,2,600,400,"False",651,267,426,159,159,0
"D05MN",364,280,"1200x900",800,0,600,400,"True",104,302,289,-13,13,1
"D05MN",365,326,"1200x900",800,1,600,400,"False",103,482,384,-98,98,0
"D05MN",366,69,"1200x900",600,0,600,400,"True",322,268,258,-10,10,0
"D05MN",367,230,"1200x900",800,0,600,400,"False",99,678,519,-159,159,1
"D05MN",368,588,"1200x900",1000,2,600,400,"True",585,350,293,-57,57,0
"D05MN",369,137,"1200x900",600,1,600,400,"False",789,577,485,-92,92,0
"D05MN",370,282,"1200x900",800,0,600,400,"False",109,246,362,116,116,1
"D05MN",371,238,"1200x900",800,0,600,400,"True",162,283,287,4,4,1
"D05MN",372,164,"1200x900",600,2,600,400,"True",1051,268,217,-51,51,0
"D05MN",373,96,"1200x900",600,1,600,400,"True",433,458,470,12,12,0
"D05MN",374,623,"1200x900",1000,2,600,400,"False",636,527,281,-246,246,0
"D05MN",375,130,"1200x900",600,1,600,400,"True",741,428,384,-44,44,0
"D05MN",376,596,"1200x900",1000,2,600,400,"False",706,513,315,-198,198,0
"D05MN",377,88,"1200x900",600,1,600,400,"True",186,554,542,-12,12,0
"D05MN",378,190,"1200x900",600,2,600,400,"True",977,238,281,43,43,0
"D05MN",379,296,"1200x900",800,1,600,400,"False",89,279,183,-96,96,0
"D05MN",380,177,"1200x900",600,2,600,400,"False",912,236,154,-82,82,0
"D05MN",381,207,"1200x900",600,2,600,400,"False",838,235,174,-61,61,0
"D05MN",382,643,"1200x900",1000,2,600,400,"False",740,325,251,-74,74,0
"D05MN",383,600,"1200x900",1000,2,600,400,"False",765,207,295,88,88,0
"D05MN",384,192,"1200x900",600,2,600,400,"False",1064,320,506,186,186,0
"D05MN",385,610,"1200x900",1000,2,600,400,"True",702,293,253,-40,40,0
"D05MN",386,7,"1200x900",600,0,600,400,"False",431,654,400,-254,254,1
"D05MN",387,185,"1200x900",600,2,600,400,"False",907,212,307,95,95,0
"D05MN",388,194,"1200x900",600,2,600,400,"True",896,236,224,-12,12,0
"D05MN",389,565,"1200x900",1000,1,600,400,"True",451,562,615,53,53,0
"D05MN",390,558,"1200x900",1000,1,600,400,"False",72,464,375,-89,89,1
"D05MN",391,91,"1200x900",600,1,600,400,"False",417,630,494,-136,136,1
"D05MN",392,287,"1200x900",800,0,600,400,"False",120,567,440,-127,127,1
"D05MN",393,242,"1200x900",800,0,600,400,"True",117,448,383,-65,65,1
"D05MN",394,435,"1200x900",1000,0,600,400,"False",119,200,321,121,121,1
"D05MN",395,408,"1200x900",800,2,600,400,"False",758,567,391,-176,176,0
"D05MN",396,179,"1200x900",600,2,600,400,"False",908,602,483,-119,119,0
"D05MN",397,466,"1200x900",1000,0,600,400,"False",82,205,389,184,184,1
"D05MN",398,359,"1200x900",800,1,600,400,"False",653,241,353,112,112,0
"D05MN",399,252,"1200x900",800,0,600,400,"False",224,673,520,-153,153,1
"D05MN",400,493,"1200x900",1000,0,600,400,"False",80,582,421,-161,161,1
"D05MN",401,373,"1200x900",800,2,600,400,"False",694,326,490,164,164,0
"D05MN",402,44,"1200x900",600,0,600,400,"True",305,554,499,-55,55,1
"D05MN",403,144,"1200x900",600,1,600,400,"True",718,371,320,-51,51,0
"D05MN",404,61,"1200x900",600,0,600,400,"False",272,670,555,-115,115,1
"D05MN",405,497,"1200x900",1000,0,600,400,"False",106,696,424,-272,272,1
"D05MN",406,151,"1200x900",600,2,600,400,"True",828,680,601,-79,79,0
"D05MN",407,152,"1200x900",600,2,600,400,"True",971,399,369,-30,30,0
"D05MN",408,542,"1200x900",1000,1,600,400,"False",304,401,256,-145,145,0
"D05MN",409,485,"1200x900",1000,0,600,400,"False",121,694,432,-262,262,1
"D05MN",410,514,"1200x900",1000,1,600,400,"False",539,690,402,-288,288,0
"D05MN",411,355,"1200x900",800,1,600,400,"False",77,386,631,245,245,0
"D05MN",412,304,"1200x900",800,1,600,400,"False",667,605,197,-408,408,0
"D05MN",413,254,"1200x900",800,0,600,400,"False",136,583,423,-160,160,1
"D05MN",414,289,"1200x900",800,1,600,400,"False",421,703,415,-288,288,1
"D05MN",415,19,"1200x900",600,0,600,400,"False",286,686,567,-119,119,0
"D05MN",416,418,"1200x900",800,2,600,400,"False",754,507,408,-99,99,0
"D05MN",417,396,"1200x900",800,2,600,400,"False",678,663,515,-148,148,0
"D05MN",418,499,"1200x900",1000,0,600,400,"False",93,271,449,178,178,1
"D05MN",419,259,"1200x900",800,0,600,400,"False",156,180,349,169,169,1
"D05MN",420,226,"1200x900",800,0,600,400,"False",187,229,298,69,69,1
"D05MN",421,318,"1200x900",800,1,600,400,"False",788,534,748,214,214,0
"D05MN",422,453,"1200x900",1000,0,600,400,"False",71,393,623,230,230,1
"D05MN",423,620,"1200x900",1000,2,600,400,"False",832,649,264,-385,385,0
"D05MN",424,72,"1200x900",600,0,600,400,"True",158,537,522,-15,15,0
"D05MN",425,508,"1200x900",1000,1,600,400,"True",596,485,478,-7,7,0
"D05MN",426,93,"1200x900",600,1,600,400,"True",139,540,559,19,19,0
"D05MN",427,583,"1200x900",1000,2,600,400,"False",949,284,509,225,225,1
"D05MN",428,260,"1200x900",800,0,600,400,"True",103,525,503,-22,22,1
"D05MN",429,41,"1200x900",600,0,600,400,"True",370,452,428,-24,24,1
"D05MN",430,34,"1200x900",600,0,600,400,"True",361,242,175,-67,67,1
"D05MN",431,133,"1200x900",600,1,600,400,"False",345,551,686,135,135,0
"D05MN",432,32,"1200x900",600,0,600,400,"False",152,563,450,-113,113,1
"D05MN",433,312,"1200x900",800,1,600,400,"False",238,683,569,-114,114,0
"D05MN",434,17,"1200x900",600,0,600,400,"False",402,496,431,-65,65,1
"D05MN",435,460,"1200x900",1000,0,600,400,"False",155,189,424,235,235,1
"D05MN",436,469,"1200x900",1000,0,600,400,"False",73,227,352,125,125,1
"D05MN",437,354,"1200x900",800,1,600,400,"True",118,236,286,50,50,0
"D05MN",438,384,"1200x900",800,2,600,400,"False",821,707,519,-188,188,0
"D05MN",439,486,"1200x900",1000,0,600,400,"False",102,676,442,-234,234,1
"D05MN",440,445,"1200x900",1000,0,600,400,"True",78,302,331,29,29,1
"D05MN",441,535,"1200x900",1000,1,600,400,"True",372,410,437,27,27,0
"D05MN",442,35,"1200x900",600,0,600,400,"True",366,555,548,-7,7,1
"D05MN",443,33,"1200x900",600,0,600,400,"True",198,533,518,-15,15,1
"D05MN",444,16,"1200x900",600,0,600,400,"True",297,514,535,21,21,1
"D05MN",445,150,"1200x900",600,2,600,400,"True",897,345,414,69,69,0
"D05MN",446,73,"1200x900",600,1,600,400,"True",94,665,642,-23,23,0
"D05MN",447,311,"1200x900",800,1,600,400,"False",710,261,702,441,441,0
"D05MN",448,286,"1200x900",800,0,600,400,"True",105,378,434,56,56,1
"D05MN",449,403,"1200x900",800,2,600,400,"False",625,704,525,-179,179,0
"D05MN",450,307,"1200x900",800,1,600,400,"True",716,247,315,68,68,0
"D05MN",451,618,"1200x900",1000,2,600,400,"False",276,671,784,113,113,0
"D05MN",452,571,"1200x900",1000,1,600,400,"False",239,522,631,109,109,1
"D05MN",453,518,"1200x900",1000,1,600,400,"False",583,717,520,-197,197,0
"D05MN",454,222,"1200x900",800,0,600,400,"False",152,206,416,210,210,1
"D05MN",455,386,"1200x900",800,2,600,400,"True",774,301,298,-3,3,0
"D05MN",456,541,"1200x900",1000,1,600,400,"True",339,478,414,-64,64,0
"D05MN",457,473,"1200x900",1000,0,600,400,"False",75,323,391,68,68,1
"D05MN",458,545,"1200x900",1000,1,600,400,"True",358,562,496,-66,66,0
"D05MN",459,489,"1200x900",1000,0,600,400,"False",88,604,414,-190,190,1
"D05MN",460,159,"1200x900",600,2,600,400,"True",992,309,309,0,0,0
"D05MN",461,538,"1200x900",1000,1,600,400,"True",308,457,427,-30,30,1
"D05MN",462,574,"1200x900",1000,1,600,400,"False",614,194,356,162,162,0
"D05MN",463,395,"1200x900",800,2,600,400,"True",743,334,326,-8,8,0
"D05MN",464,552,"1200x900",1000,1,600,400,"True",255,412,355,-57,57,0
"D05MN",465,562,"1200x900",1000,1,600,400,"False",347,540,626,86,86,0
"D05MN",466,380,"1200x900",800,2,600,400,"True",942,228,243,15,15,0
"D05MN",467,633,"1200x900",1000,2,600,400,"False",564,253,613,360,360,0
"D05MN",468,67,"1200x900",600,0,600,400,"False",289,308,384,76,76,1
"D05MN",469,587,"1200x900",1000,2,600,400,"False",741,686,323,-363,363,0
"D05MN",470,50,"1200x900",600,0,600,400,"False",75,582,477,-105,105,0
"D05MN",471,491,"1200x900",1000,0,600,400,"False",108,198,388,190,190,1
"D05MN",472,29,"1200x900",600,0,600,400,"True",385,533,551,18,18,1
"D05MN",473,419,"1200x900",800,2,600,400,"True",769,351,390,39,39,0
"D05MN",474,127,"1200x900",600,1,600,400,"True",309,691,624,-67,67,0
"D05MN",475,612,"1200x900",1000,2,600,400,"False",706,198,382,184,184,0
"D05MN",476,570,"1200x900",1000,1,600,400,"True",315,352,349,-3,3,0
"D05MN",477,608,"1200x900",1000,2,600,400,"False",742,250,358,108,108,0
"D05MN",478,539,"1200x900",1000,1,600,400,"True",510,383,331,-52,52,0
"D05MN",479,46,"1200x900",600,0,600,400,"True",193,355,318,-37,37,1
"D05MN",480,362,"1200x900",800,2,600,400,"False",819,338,478,140,140,0
"D05MN",481,264,"1200x900",800,0,600,400,"False",198,660,457,-203,203,1
"D05MN",482,245,"1200x900",800,0,600,400,"False",296,235,375,140,140,1
"D05MN",483,8,"1200x900",600,0,600,400,"True",156,679,626,-53,53,0
"D05MN",484,162,"1200x900",600,2,600,400,"True",849,279,313,34,34,0
"D05MN",485,229,"1200x900",800,0,600,400,"True",117,697,669,-28,28,1
"D05MN",486,90,"1200x900",600,1,600,400,"False",560,474,183,-291,291,0
"D05MN",487,638,"1200x900",1000,2,600,400,"True",385,198,275,77,77,0
"D05MN",488,401,"1200x900",800,2,600,400,"False",821,260,196,-64,64,0
"D05MN",489,31,"1200x900",600,0,600,400,"True",365,338,285,-53,53,1
"D05MN",490,512,"1200x900",1000,1,600,400,"False",139,261,535,274,274,0
"D05MN",491,636,"1200x900",1000,2,600,400,"False",575,583,468,-115,115,0
"D05MN",492,213,"1200x900",600,2,600,400,"True",822,275,291,16,16,0
"D05MN",493,644,"1200x900",1000,2,600,400,"False",495,486,338,-148,148,0
"D05MN",494,97,"1200x900",600,1,600,400,"True",760,643,645,2,2,1
"D05MN",495,135,"1200x900",600,1,600,400,"True",759,569,605,36,36,0
"D05MN",496,266,"1200x900",800,0,600,400,"False",126,303,504,201,201,1
"D05MN",497,338,"1200x900",800,1,600,400,"False",813,253,430,177,177,1
"D05MN",498,106,"1200x900",600,1,600,400,"False",803,659,399,-260,260,1
"D05MN",499,367,"1200x900",800,2,600,400,"True",613,464,388,-76,76,0
"D05MN",500,540,"1200x900",1000,1,600,400,"False",389,568,340,-228,228,1
"D05MN",501,533,"1200x900",1000,1,600,400,"False",355,483,552,69,69,0
"D05MN",502,200,"1200x900",600,2,600,400,"True",897,302,255,-47,47,0
"D05MN",503,174,"1200x900",600,2,600,400,"False",998,457,282,-175,175,0
"D05MN",504,325,"1200x900",800,1,600,400,"True",105,394,341,-53,53,0
"D05MN",505,59,"1200x900",600,0,600,400,"True",391,692,695,3,3,1
"D05MN",506,139,"1200x900",600,1,600,400,"True",192,695,675,-20,20,0
"D05MN",507,169,"1200x900",600,2,600,400,"True",924,290,370,80,80,0
"D05MN",508,283,"1200x900",800,0,600,400,"True",90,264,282,18,18,1
"D05MN",509,211,"1200x900",600,2,600,400,"False",986,407,241,-166,166,0
"D05MN",510,458,"1200x900",1000,0,600,400,"False",78,624,335,-289,289,1
"D05MN",511,501,"1200x900",1000,0,600,400,"True",96,323,352,29,29,1
"D05MN",512,578,"1200x900",1000,2,600,400,"False",966,276,428,152,152,0
"D05MN",513,55,"1200x900",600,0,600,400,"True",211,305,303,-2,2,1
"D05MN",514,277,"1200x900",800,0,600,400,"True",140,310,287,-23,23,1
"D05MN",515,479,"1200x900",1000,0,600,400,"False",74,705,386,-319,319,1
"D05MN",516,619,"1200x900",1000,2,600,400,"False",803,247,374,127,127,0
"D05MN",517,383,"1200x900",800,2,600,400,"True",855,407,464,57,57,0
"D05MN",518,182,"1200x900",600,2,600,400,"False",933,389,308,-81,81,0
"D05MN",519,581,"1200x900",1000,2,600,400,"True",310,357,372,15,15,0
"D05MN",520,228,"1200x900",800,0,600,400,"False",174,687,580,-107,107,1
"D05MN",521,210,"1200x900",600,2,600,400,"False",835,506,628,122,122,0
"D05MN",522,546,"1200x900",1000,1,600,400,"True",305,374,384,10,10,0
"D05MN",523,532,"1200x900",1000,1,600,400,"False",215,207,287,80,80,0
"D05MN",524,369,"1200x900",800,2,600,400,"True",903,594,578,-16,16,0
"D05MN",525,244,"1200x900",800,0,600,400,"True",194,203,176,-27,27,1
"D05MN",526,231,"1200x900",800,0,600,400,"False",251,718,409,-309,309,1
"D05MN",527,513,"1200x900",1000,1,600,400,"False",235,602,221,-381,381,0
"D05MN",528,166,"1200x900",600,2,600,400,"False",896,274,191,-83,83,0
"D05MN",529,18,"1200x900",600,0,600,400,"True",400,318,362,44,44,1
"D05MN",530,500,"1200x900",1000,0,600,400,"False",105,700,409,-291,291,1
"D05MN",531,504,"1200x900",1000,0,600,400,"False",107,699,438,-261,261,1
"D05MN",532,372,"1200x900",800,2,600,400,"False",833,620,486,-134,134,0
"D05MN",533,549,"1200x900",1000,1,600,400,"True",657,366,389,23,23,0
"D05MN",534,599,"1200x900",1000,2,600,400,"False",316,570,443,-127,127,0
"D05MN",535,521,"1200x900",1000,1,600,400,"False",111,303,384,81,81,1
"D05MN",536,569,"1200x900",1000,1,600,400,"False",494,720,313,-407,407,0
"D05MN",537,590,"1200x900",1000,2,600,400,"False",636,278,365,87,87,0
"D05MN",538,537,"1200x900",1000,1,600,400,"False",621,412,476,64,64,1
"D05MN",539,627,"1200x900",1000,2,600,400,"True",760,510,459,-51,51,0
"D05MN",540,215,"1200x900",600,2,600,400,"False",939,596,462,-134,134,0
"D05MN",541,51,"1200x900",600,0,600,400,"True",272,181,190,9,9,1
"D05MN",542,172,"1200x900",600,2,600,400,"False",912,444,134,-310,310,0
"D05MN",543,171,"1200x900",600,2,600,400,"True",909,200,199,-1,1,0
"D05MN",544,52,"1200x900",600,0,600,400,"True",171,188,188,0,0,0
"D05MN",545,53,"1200x900",600,0,600,400,"True",177,189,187,-2,2,0
"D05MN",546,1,"1200x900",600,0,600,400,"True",136,502,436,-66,66,0
"D05MN",547,253,"1200x900",800,0,600,400,"True",177,424,421,-3,3,1
"D05MN",548,122,"1200x900",600,1,600,400,"False",817,709,608,-101,101,0
"D05MN",549,251,"1200x900",800,0,600,400,"False",88,352,546,194,194,1
"D05MN",550,175,"1200x900",600,2,600,400,"False",1028,432,306,-126,126,0
"D05MN",551,147,"1200x900",600,2,600,400,"False",942,418,301,-117,117,0
"D05MN",552,524,"1200x900",1000,1,600,400,"True",534,470,441,-29,29,0
"D05MN",553,58,"1200x900",600,0,600,400,"False",353,655,514,-141,141,1
"D05MN",554,80,"1200x900",600,1,600,400,"False",616,423,495,72,72,1
"D05MN",555,576,"1200x900",1000,1,600,400,"True",376,713,751,38,38,0
"D05MN",556,476,"1200x900",1000,0,600,400,"False",76,359,600,241,241,1
"D05MN",557,232,"1200x900",800,0,600,400,"False",84,511,437,-74,74,1
"D05MN",558,330,"1200x900",800,1,600,400,"False",759,301,222,-79,79,1
"D05MN",559,334,"1200x900",800,1,600,400,"True",481,665,667,2,2,0
"D05MN",560,313,"1200x900",800,1,600,400,"False",588,421,541,120,120,0
"D05MN",561,454,"1200x900",1000,0,600,400,"False",78,687,584,-103,103,1
"D05MN",562,522,"1200x900",1000,1,600,400,"False",223,379,576,197,197,0
"D05MN",563,461,"1200x900",1000,0,600,400,"False",95,711,544,-167,167,1
"D05MN",564,138,"1200x900",600,1,600,400,"True",844,580,626,46,46,1
"D05MN",565,609,"1200x900",1000,2,600,400,"False",697,627,521,-106,106,0
"D05MN",566,348,"1200x900",800,1,600,400,"False",764,294,381,87,87,0
"D05MN",567,141,"1200x900",600,1,600,400,"True",671,582,632,50,50,0
"D05MN",568,176,"1200x900",600,2,600,400,"True",1033,281,287,6,6,0
"D05MN",569,65,"1200x900",600,0,600,400,"False",442,645,473,-172,172,1
"D05MN",570,142,"1200x900",600,1,600,400,"True",286,474,522,48,48,0
"D05MN",571,178,"1200x900",600,2,600,400,"False",1041,510,613,103,103,0
"D05MN",572,38,"1200x900",600,0,600,400,"True",120,628,579,-49,49,1
"D05MN",573,71,"1200x900",600,0,600,400,"False",219,248,169,-79,79,0
"D05MN",574,158,"1200x900",600,2,600,400,"False",939,300,223,-77,77,0
"D05MN",575,356,"1200x900",800,1,600,400,"True",123,484,485,1,1,0
"D05MN",576,567,"1200x900",1000,1,600,400,"False",655,297,216,-81,81,1
"D05MN",577,506,"1200x900",1000,1,600,400,"False",559,567,265,-302,302,1
"D05MN",578,180,"1200x900",600,2,600,400,"False",929,270,195,-75,75,0
"D05MN",579,263,"1200x900",800,0,600,400,"False",82,396,277,-119,119,1
"D05MN",580,36,"1200x900",600,0,600,400,"False",128,346,247,-99,99,1
"D05MN",581,392,"1200x900",800,2,600,400,"False",1031,618,387,-231,231,0
"D05MN",582,430,"1200x900",800,2,600,400,"True",922,254,325,71,71,0
"D05MN",583,25,"1200x900",600,0,600,400,"True",263,403,369,-34,34,1
"D05MN",584,92,"1200x900",600,1,600,400,"False",624,605,232,-373,373,0
"D05MN",585,561,"1200x900",1000,1,600,400,"True",231,406,411,5,5,0
"D05MN",586,291,"1200x900",800,1,600,400,"False",522,694,480,-214,214,0
"D05MN",587,358,"1200x900",800,1,600,400,"False",263,635,291,-344,344,0
"D05MN",588,631,"1200x900",1000,2,600,400,"False",699,479,747,268,268,0
"D05MN",589,407,"1200x900",800,2,600,400,"False",989,340,228,-112,112,0
"D05MN",590,446,"1200x900",1000,0,600,400,"True",72,298,285,-13,13,1
"D05MN",591,399,"1200x900",800,2,600,400,"False",603,602,332,-270,270,0
"D05MN",592,622,"1200x900",1000,2,600,400,"False",307,683,535,-148,148,0
"D05MN",593,269,"1200x900",800,0,600,400,"False",160,295,376,81,81,1
"D05MN",594,377,"1200x900",800,2,600,400,"False",683,388,267,-121,121,0
"D05MN",595,639,"1200x900",1000,2,600,400,"False",504,456,565,109,109,0
"D05MN",596,23,"1200x900",600,0,600,400,"True",308,463,515,52,52,1
"D05MN",597,103,"1200x900",600,1,600,400,"False",528,320,244,-76,76,1
"D05MN",598,611,"1200x900",1000,2,600,400,"False",414,511,276,-235,235,0
"D05MN",599,320,"1200x900",800,1,600,400,"True",644,376,434,58,58,0
"D05MN",600,478,"1200x900",1000,0,600,400,"False",79,672,402,-270,270,1
"D05MN",601,281,"1200x900",800,0,600,400,"False",112,611,481,-130,130,1
"D05MN",602,382,"1200x900",800,2,600,400,"False",870,523,260,-263,263,0
"D05MN",603,398,"1200x900",800,2,600,400,"False",944,698,446,-252,252,0
"D05MN",604,85,"1200x900",600,1,600,400,"False",434,347,490,143,143,0
"D05MN",605,60,"1200x900",600,0,600,400,"False",365,213,350,137,137,1
"D05MN",606,66,"1200x900",600,0,600,400,"True",155,673,661,-12,12,0
"D05MN",607,129,"1200x900",600,1,600,400,"False",859,482,237,-245,245,1
"D05MN",608,197,"1200x900",600,2,600,400,"False",903,212,305,93,93,0
"D05MN",609,136,"1200x900",600,1,600,400,"True",264,205,219,14,14,0
"D05MN",610,550,"1200x900",1000,1,600,400,"False",301,459,301,-158,158,0
"D05MN",611,249,"1200x900",800,0,600,400,"False",126,306,434,128,128,1
"D05MN",612,21,"1200x900",600,0,600,400,"True",314,383,415,32,32,1
"D05MN",613,637,"1200x900",1000,2,600,400,"False",750,460,591,131,131,0
"D05MN",614,534,"1200x900",1000,1,600,400,"False",328,504,579,75,75,1
"D05MN",615,157,"1200x900",600,2,600,400,"True",1016,323,384,61,61,0
"D05MN",616,607,"1200x900",1000,2,600,400,"False",900,573,764,191,191,1
"D05MN",617,502,"1200x900",1000,0,600,400,"False",111,639,501,-138,138,1
"D05MN",618,302,"1200x900",800,1,600,400,"False",479,467,557,90,90,1
"D05MN",619,406,"1200x900",800,2,600,400,"False",971,233,485,252,252,0
"D05MN",620,368,"1200x900",800,2,600,400,"False",778,515,420,-95,95,0
"D05MN",621,339,"1200x900",800,1,600,400,"True",273,545,505,-40,40,1
"D05MN",622,471,"1200x900",1000,0,600,400,"False",122,200,436,236,236,1
"D05MN",623,374,"1200x900",800,2,600,400,"False",755,450,369,-81,81,0
"D05MN",624,572,"1200x900",1000,1,600,400,"False",302,260,414,154,154,0
"D05MN",625,603,"1200x900",1000,2,600,400,"True",693,280,301,21,21,0
"D05MN",626,125,"1200x900",600,1,600,400,"False",750,531,433,-98,98,0
"D05MN",627,389,"1200x900",800,2,600,400,"False",843,530,345,-185,185,0
"D05MN",628,379,"1200x900",800,2,600,400,"False",994,325,494,169,169,0
"D05MN",629,553,"1200x900",1000,1,600,400,"False",116,712,315,-397,397,0
"D05MN",630,126,"1200x900",600,1,600,400,"True",849,354,299,-55,55,0
"D05MN",631,551,"1200x900",1000,1,600,400,"False",146,445,319,-126,126,1
"D05MN",632,444,"1200x900",1000,0,600,400,"False",101,714,418,-296,296,1
"D05MN",633,350,"1200x900",800,1,600,400,"True",182,566,520,-46,46,0
"D05MN",634,496,"1200x900",1000,0,600,400,"False",70,639,434,-205,205,1
"D05MN",635,94,"1200x900",600,1,600,400,"False",729,482,341,-141,141,0
"D05MN",636,255,"1200x900",800,0,600,400,"False",93,709,515,-194,194,1
"D05MN",637,505,"1200x900",1000,1,600,400,"True",191,484,486,2,2,1
"D05MN",638,3,"1200x900",600,0,600,400,"False",298,443,337,-106,106,1
"D05MN",639,299,"1200x900",800,1,600,400,"True",779,274,217,-57,57,0
"D05MN",640,105,"1200x900",600,1,600,400,"False",527,440,246,-194,194,0
"D05MN",641,74,"1200x900",600,1,600,400,"False",115,358,184,-174,174,0
"D05MN",642,625,"1200x900",1000,2,600,400,"False",279,228,416,188,188,0
"D05MN",643,432,"1200x900",800,2,600,400,"True",792,380,337,-43,43,0
"D05MN",644,239,"1200x900",800,0,600,400,"True",114,231,252,21,21,1
"D05MN",645,560,"1200x900",1000,1,600,400,"False",516,693,480,-213,213,0
"D05MN",646,154,"1200x900",600,2,600,400,"False",941,454,231,-223,223,0
"D05MN",647,109,"1200x900",600,1,600,400,"True",691,589,529,-60,60,0
"D05MN",648,438,"1200x900",1000,0,600,400,"False",77,713,518,-195,195,1
"D06SC",1,1,"1200x900",600,0,600,400,"True",136,502,487,-15,15,0
"D06SC",2,259,"1200x900",800,0,600,400,"False",156,180,248,68,68,1
"D06SC",3,167,"1200x900",600,2,600,400,"False",956,241,507,266,266,0
"D06SC",4,400,"1200x900",800,2,600,400,"False",733,297,68,-229,229,0
"D06SC",5,11,"1200x900",600,0,600,400,"True",372,670,639,-31,31,1
"D06SC",6,27,"1200x900",600,0,600,400,"True",373,309,295,-14,14,1
"D06SC",7,424,"1200x900",800,2,600,400,"True",903,545,572,27,27,0
"D06SC",8,529,"1200x900",1000,1,600,400,"False",267,412,344,-68,68,1
"D06SC",9,321,"1200x900",800,1,600,400,"True",601,190,140,-50,50,0
"D06SC",10,110,"1200x900",600,1,600,400,"True",776,550,602,52,52,1
"D06SC",11,374,"1200x900",800,2,600,400,"False",755,450,358,-92,92,0
"D06SC",12,312,"1200x900",800,1,600,400,"False",238,683,456,-227,227,0
"D06SC",13,492,"1200x900",1000,0,600,400,"False",76,692,610,-82,82,1
"D06SC",14,474,"1200x900",1000,0,600,400,"False",85,339,481,142,142,1
"D06SC",15,379,"1200x900",800,2,600,400,"False",994,325,408,83,83,0
"D06SC",16,93,"1200x900",600,1,600,400,"True",139,540,482,-58,58,0
"D06SC",17,580,"1200x900",1000,2,600,400,"False",651,267,395,128,128,0
"D06SC",18,466,"1200x900",1000,0,600,400,"True",82,205,155,-50,50,1
"D06SC",19,244,"1200x900",800,0,600,400,"True",194,203,149,-54,54,1
"D06SC",20,475,"1200x900",1000,0,600,400,"False",101,715,600,-115,115,1
"D06SC",21,30,"1200x900",600,0,600,400,"True",107,353,332,-21,21,0
"D06SC",22,620,"1200x900",1000,2,600,400,"False",832,649,593,-56,56,0
"D06SC",23,497,"1200x900",1000,0,600,400,"False",106,696,548,-148,148,1
"D06SC",24,326,"1200x900",800,1,600,400,"False",103,482,295,-187,187,0
"D06SC",25,516,"1200x900",1000,1,600,400,"True",440,559,568,9,9,0
"D06SC",26,535,"1200x900",1000,1,600,400,"False",372,410,310,-100,100,0
"D06SC",27,344,"1200x900",800,1,600,400,"False",589,408,210,-198,198,0
"D06SC",28,457,"1200x900",1000,0,600,400,"False",97,630,456,-174,174,1
"D06SC",29,633,"1200x900",1000,2,600,400,"False",564,253,474,221,221,0
"D06SC",30,317,"1200x900",800,1,600,400,"False",185,564,620,56,56,0
"D06SC",31,560,"1200x900",1000,1,600,400,"False",516,693,602,-91,91,0
"D06SC",32,571,"1200x900",1000,1,600,400,"False",239,522,367,-155,155,1
"D06SC",33,130,"1200x900",600,1,600,400,"False",741,428,540,112,112,0
"D06SC",34,408,"1200x900",800,2,600,400,"True",758,567,512,-55,55,0
"D06SC",35,126,"1200x900",600,1,600,400,"False",849,354,486,132,132,0
"D06SC",36,585,"1200x900",1000,2,600,400,"True",698,688,646,-42,42,1
"D06SC",37,225,"1200x900",800,0,600,400,"True",178,423,436,13,13,1
"D06SC",38,339,"1200x900",800,1,600,400,"True",273,545,494,-51,51,1
"D06SC",39,234,"1200x900",800,0,600,400,"True",72,344,324,-20,20,1
"D06SC",40,611,"1200x900",1000,2,600,400,"False",414,511,657,146,146,0
"D06SC",41,20,"1200x900",600,0,600,400,"False",204,545,435,-110,110,1
"D06SC",42,307,"1200x900",800,1,600,400,"False",716,247,409,162,162,0
"D06SC",43,626,"1200x900",1000,2,600,400,"False",329,449,623,174,174,0
"D06SC",44,232,"1200x900",800,0,600,400,"True",84,511,489,-22,22,1
"D06SC",45,603,"1200x900",1000,2,600,400,"False",693,280,50,-230,230,0
"D06SC",46,387,"1200x900",800,2,600,400,"False",990,444,560,116,116,0
"D06SC",47,372,"1200x900",800,2,600,400,"False",833,620,378,-242,242,0
"D06SC",48,34,"1200x900",600,0,600,400,"True",361,242,187,-55,55,1
"D06SC",49,285,"1200x900",800,0,600,400,"False",237,396,499,103,103,1
"D06SC",50,621,"1200x900",1000,2,600,400,"True",540,478,494,16,16,0
"D06SC",51,243,"1200x900",800,0,600,400,"True",114,332,376,44,44,1
"D06SC",52,147,"1200x900",600,2,600,400,"False",942,418,229,-189,189,0
"D06SC",53,160,"1200x900",600,2,600,400,"False",863,606,437,-169,169,0
"D06SC",56,428,"1200x900",800,2,600,400,"False",732,665,355,-310,310,0
"D06SC",57,199,"1200x900",600,2,600,400,"True",992,467,467,0,0,0
"D06SC",58,429,"1200x900",800,2,600,400,"False",682,692,468,-224,224,0
"D06SC",59,547,"1200x900",1000,1,600,400,"False",369,384,562,178,178,1
"D06SC",60,601,"1200x900",1000,2,600,400,"False",735,697,604,-93,93,0
"D06SC",61,449,"1200x900",1000,0,600,400,"False",105,683,578,-105,105,1
"D06SC",62,109,"1200x900",600,1,600,400,"False",691,589,317,-272,272,0
"D06SC",63,54,"1200x900",600,0,600,400,"True",474,564,506,-58,58,1
"D06SC",64,450,"1200x900",1000,0,600,400,"False",130,204,345,141,141,1
"D06SC",65,9,"1200x900",600,0,600,400,"False",509,654,490,-164,164,1
"D06SC",66,169,"1200x900",600,2,600,400,"True",924,290,370,80,80,0
"D06SC",67,187,"1200x900",600,2,600,400,"False",857,639,373,-266,266,0
"D06SC",68,402,"1200x900",800,2,600,400,"False",878,234,338,104,104,0
"D06SC",69,230,"1200x900",800,0,600,400,"True",99,678,636,-42,42,1
"D06SC",70,389,"1200x900",800,2,600,400,"False",843,530,288,-242,242,0
"D06SC",71,490,"1200x900",1000,0,600,400,"True",114,183,239,56,56,1
"D06SC",72,451,"1200x900",1000,0,600,400,"False",110,702,512,-190,190,1
"D06SC",73,488,"1200x900",1000,0,600,400,"False",129,687,548,-139,139,1
"D06SC",74,552,"1200x900",1000,1,600,400,"True",255,412,379,-33,33,0
"D06SC",75,261,"1200x900",800,0,600,400,"True",86,713,722,9,9,1
"D06SC",76,534,"1200x900",1000,1,600,400,"True",328,504,503,-1,1,1
"D06SC",77,325,"1200x900",800,1,600,400,"False",105,394,623,229,229,0
"D06SC",78,149,"1200x900",600,2,600,400,"True",890,289,344,55,55,0
"D06SC",79,348,"1200x900",800,1,600,400,"False",764,294,415,121,121,0
"D06SC",80,23,"1200x900",600,0,600,400,"True",308,463,417,-46,46,1
"D06SC",81,368,"1200x900",800,2,600,400,"True",778,515,460,-55,55,0
"D06SC",82,80,"1200x900",600,1,600,400,"True",616,423,461,38,38,1
"D06SC",83,287,"1200x900",800,0,600,400,"True",120,567,506,-61,61,1
"D06SC",84,42,"1200x900",600,0,600,400,"True",233,479,448,-31,31,0
"D06SC",85,179,"1200x900",600,2,600,400,"False",908,602,449,-153,153,0
"D06SC",86,441,"1200x900",1000,0,600,400,"False",85,684,607,-77,77,1
"D06SC",88,505,"1200x900",1000,1,600,400,"False",191,484,718,234,234,1
"D06SC",89,290,"1200x900",800,1,600,400,"True",789,603,653,50,50,0
"D06SC",90,444,"1200x900",1000,0,600,400,"True",101,714,714,0,0,1
"D06SC",91,592,"1200x900",1000,2,600,400,"True",492,392,368,-24,24,0
"D06SC",92,188,"1200x900",600,2,600,400,"False",900,195,512,317,317,0
"D06SC",93,499,"1200x900",1000,0,600,400,"False",93,271,461,190,190,1
"D06SC",94,79,"1200x900",600,1,600,400,"True",731,289,246,-43,43,0
"D06SC",95,305,"1200x900",800,1,600,400,"False",471,716,511,-205,205,0
"D06SC",97,249,"1200x900",800,0,600,400,"True",126,306,302,-4,4,1
"D06SC",99,386,"1200x900",800,2,600,400,"True",774,301,359,58,58,0
"D06SC",100,595,"1200x900",1000,2,600,400,"False",687,640,431,-209,209,0
"D06SC",101,81,"1200x900",600,1,600,400,"True",696,225,264,39,39,0
"D06SC",102,262,"1200x900",800,0,600,400,"True",196,481,418,-63,63,1
"D06SC",103,4,"1200x900",600,0,600,400,"False",602,200,306,106,106,1
"D06SC",105,407,"1200x900",800,2,600,400,"False",989,340,460,120,120,0
"D06SC",106,410,"1200x900",800,2,600,400,"False",916,477,397,-80,80,0
"D06SC",107,202,"1200x900",600,2,600,400,"False",966,460,138,-322,322,0
"D06SC",108,278,"1200x900",800,0,600,400,"True",251,711,707,-4,4,1
"D06SC",109,527,"1200x900",1000,1,600,400,"True",565,601,569,-32,32,0
"D06SC",110,542,"1200x900",1000,1,600,400,"False",304,401,519,118,118,0
"D06SC",112,10,"1200x900",600,0,600,400,"True",400,499,448,-51,51,1
"D06SC",113,302,"1200x900",800,1,600,400,"False",479,467,288,-179,179,1
"D06SC",114,161,"1200x900",600,2,600,400,"True",939,553,467,-86,86,0
"D06SC",115,132,"1200x900",600,1,600,400,"True",333,185,225,40,40,0
"D06SC",116,531,"1200x900",1000,1,600,400,"False",233,362,450,88,88,0
"D06SC",117,32,"1200x900",600,0,600,400,"False",152,563,379,-184,184,1
"D06SC",118,190,"1200x900",600,2,600,400,"False",977,238,462,224,224,0
"D06SC",119,280,"1200x900",800,0,600,400,"True",104,302,237,-65,65,1
"D06SC",120,127,"1200x900",600,1,600,400,"False",309,691,450,-241,241,0
"D06SC",121,587,"1200x900",1000,2,600,400,"False",741,686,474,-212,212,0
"D06SC",122,293,"1200x900",800,1,600,400,"False",561,396,470,74,74,0
"D06SC",123,46,"1200x900",600,0,600,400,"True",193,355,409,54,54,1
"D06SC",124,591,"1200x900",1000,2,600,400,"True",698,336,375,39,39,0
"D06SC",125,638,"1200x900",1000,2,600,400,"True",385,198,156,-42,42,0
"D06SC",126,561,"1200x900",1000,1,600,400,"True",231,406,450,44,44,0
"D06SC",127,286,"1200x900",800,0,600,400,"True",105,378,395,17,17,1
"D06SC",128,486,"1200x900",1000,0,600,400,"False",102,676,523,-153,153,1
"D06SC",129,388,"1200x900",800,2,600,400,"False",930,320,524,204,204,0
"D06SC",130,359,"1200x900",800,1,600,400,"True",653,241,285,44,44,0
"D06SC",131,442,"1200x900",1000,0,600,400,"False",87,183,292,109,109,1
"D06SC",132,461,"1200x900",1000,0,600,400,"True",95,711,704,-7,7,1
"D06SC",133,353,"1200x900",800,1,600,400,"True",90,476,474,-2,2,0
"D06SC",134,541,"1200x900",1000,1,600,400,"True",339,478,487,9,9,0
"D06SC",135,328,"1200x900",800,1,600,400,"False",104,649,478,-171,171,0
"D06SC",136,41,"1200x900",600,0,600,400,"True",370,452,465,13,13,1
"D06SC",137,469,"1200x900",1000,0,600,400,"True",73,227,287,60,60,1
"D06SC",138,395,"1200x900",800,2,600,400,"False",743,334,92,-242,242,0
"D06SC",139,581,"1200x900",1000,2,600,400,"False",310,357,258,-99,99,0
"D06SC",140,551,"1200x900",1000,1,600,400,"False",146,445,559,114,114,1
"D06SC",141,250,"1200x900",800,0,600,400,"False",290,248,405,157,157,1
"D06SC",142,318,"1200x900",800,1,600,400,"False",788,534,386,-148,148,0
"D06SC",143,289,"1200x900",800,1,600,400,"False",421,703,467,-236,236,1
"D06SC",144,647,"1200x900",1000,2,600,400,"False",560,637,438,-199,199,0
"D06SC",145,498,"1200x900",1000,0,600,400,"False",100,260,399,139,139,1
"D06SC",146,298,"1200x900",800,1,600,400,"True",311,457,432,-25,25,0
"D06SC",147,175,"1200x900",600,2,600,400,"True",1028,432,488,56,56,0
"D06SC",148,139,"1200x900",600,1,600,400,"True",192,695,632,-63,63,0
"D06SC",149,119,"1200x900",600,1,600,400,"True",168,563,612,49,49,0
"D06SC",150,238,"1200x900",800,0,600,400,"False",162,283,431,148,148,1
"D06SC",151,173,"1200x900",600,2,600,400,"False",948,693,539,-154,154,0
"D06SC",152,73,"1200x900",600,1,600,400,"False",94,665,551,-114,114,0
"D06SC",153,208,"1200x900",600,2,600,400,"False",946,399,550,151,151,0
"D06SC",155,213,"1200x900",600,2,600,400,"False",822,275,111,-164,164,0
"D06SC",156,44,"1200x900",600,0,600,400,"True",305,554,530,-24,24,1
"D06SC",157,522,"1200x900",1000,1,600,400,"False",223,379,480,101,101,0
"D06SC",158,485,"1200x900",1000,0,600,400,"False",121,694,621,-73,73,1
"D06SC",160,539,"1200x900",1000,1,600,400,"False",510,383,576,193,193,0
"D06SC",161,567,"1200x900",1000,1,600,400,"True",655,297,264,-33,33,1
"D06SC",162,588,"1200x900",1000,2,600,400,"False",585,350,277,-73,73,0
"D06SC",163,530,"1200x900",1000,1,600,400,"False",584,405,282,-123,123,1
"D06SC",164,43,"1200x900",600,0,600,400,"False",277,446,324,-122,122,1
"D06SC",165,366,"1200x900",800,2,600,400,"False",931,464,181,-283,283,0
"D06SC",166,342,"1200x900",800,1,600,400,"False",677,204,301,97,97,0
"D06SC",167,59,"1200x900",600,0,600,400,"True",391,692,745,53,53,1
"D06SC",168,590,"1200x900",1000,2,600,400,"False",636,278,606,328,328,0
"D06SC",169,219,"1200x900",800,0,600,400,"True",202,502,545,43,43,1
"D06SC",170,377,"1200x900",800,2,600,400,"False",683,388,501,113,113,0
"D06SC",171,337,"1200x900",800,1,600,400,"True",299,622,529,-93,93,0
"D06SC",172,251,"1200x900",800,0,600,400,"False",88,352,462,110,110,1
"D06SC",173,57,"1200x900",600,0,600,400,"True",354,508,480,-28,28,1
"D06SC",174,288,"1200x900",800,0,600,400,"True",180,547,571,24,24,1
"D06SC",175,376,"1200x900",800,2,600,400,"False",788,275,202,-73,73,0
"D06SC",176,315,"1200x900",800,1,600,400,"False",105,211,325,114,114,0
"D06SC",177,121,"1200x900",600,1,600,400,"True",884,364,354,-10,10,0
"D06SC",178,454,"1200x900",1000,0,600,400,"True",78,687,692,5,5,1
"D06SC",179,71,"1200x900",600,0,600,400,"True",219,248,301,53,53,0
"D06SC",180,434,"1200x900",1000,0,600,400,"False",89,657,470,-187,187,1
"D06SC",181,157,"1200x900",600,2,600,400,"True",1016,323,335,12,12,0
"D06SC",182,196,"1200x900",600,2,600,400,"False",1030,397,231,-166,166,0
"D06SC",183,107,"1200x900",600,1,600,400,"True",878,678,633,-45,45,0
"D06SC",184,557,"1200x900",1000,1,600,400,"False",677,505,350,-155,155,1
"D06SC",185,599,"1200x900",1000,2,600,400,"False",316,570,391,-179,179,0
"D06SC",186,373,"1200x900",800,2,600,400,"True",694,326,296,-30,30,0
"D06SC",187,538,"1200x900",1000,1,600,400,"True",308,457,518,61,61,1
"D06SC",188,565,"1200x900",1000,1,600,400,"True",451,562,493,-69,69,0
"D06SC",189,579,"1200x900",1000,2,600,400,"True",803,394,303,-91,91,0
"D06SC",190,245,"1200x900",800,0,600,400,"False",296,235,471,236,236,1
"D06SC",191,405,"1200x900",800,2,600,400,"True",790,307,343,36,36,0
"D06SC",192,578,"1200x900",1000,2,600,400,"False",966,276,411,135,135,0
"D06SC",194,247,"1200x900",800,0,600,400,"False",160,424,536,112,112,1
"D06SC",195,440,"1200x900",1000,0,600,400,"False",71,237,384,147,147,1
"D06SC",196,116,"1200x900",600,1,600,400,"False",767,289,146,-143,143,0
"D06SC",197,415,"1200x900",800,2,600,400,"False",823,684,447,-237,237,0
"D06SC",198,222,"1200x900",800,0,600,400,"False",152,206,327,121,121,1
"D06SC",199,182,"1200x900",600,2,600,400,"True",933,389,440,51,51,0
"D06SC",200,381,"1200x900",800,2,600,400,"False",705,408,321,-87,87,0
"D06SC",201,641,"1200x900",1000,2,600,400,"True",897,272,292,20,20,0
"D06SC",202,570,"1200x900",1000,1,600,400,"True",315,352,370,18,18,0
"D06SC",203,358,"1200x900",800,1,600,400,"False",263,635,474,-161,161,0
"D06SC",204,140,"1200x900",600,1,600,400,"True",700,523,522,-1,1,0
"D06SC",205,99,"1200x900",600,1,600,400,"False",811,407,479,72,72,0
"D06SC",206,267,"1200x900",800,0,600,400,"True",145,665,637,-28,28,1
"D06SC",207,332,"1200x900",800,1,600,400,"False",260,699,498,-201,201,0
"D06SC",209,546,"1200x900",1000,1,600,400,"False",305,374,529,155,155,0
"D06SC",210,72,"1200x900",600,0,600,400,"True",158,537,512,-25,25,0
"D06SC",211,458,"1200x900",1000,0,600,400,"False",78,624,391,-233,233,1
"D06SC",212,15,"1200x900",600,0,600,400,"False",473,352,459,107,107,1
"D06SC",213,28,"1200x900",600,0,600,400,"True",336,410,441,31,31,1
"D06SC",214,648,"1200x900",1000,2,600,400,"True",557,394,442,48,48,0
"D06SC",215,564,"1200x900",1000,1,600,400,"False",215,264,522,258,258,0
"D06SC",216,562,"1200x900",1000,1,600,400,"True",347,540,523,-17,17,0
"D06SC",217,198,"1200x900",600,2,600,400,"True",976,500,454,-46,46,0
"D06SC",218,378,"1200x900",800,2,600,400,"False",1018,708,452,-256,256,0
"D06SC",219,237,"1200x900",800,0,600,400,"True",204,481,506,25,25,1
"D06SC",220,593,"1200x900",1000,2,600,400,"False",246,719,483,-236,236,0
"D06SC",221,484,"1200x900",1000,0,600,400,"False",100,223,308,85,85,1
"D06SC",222,123,"1200x900",600,1,600,400,"False",761,365,473,108,108,1
"D06SC",223,624,"1200x900",1000,2,600,400,"True",693,501,453,-48,48,0
"D06SC",224,172,"1200x900",600,2,600,400,"True",912,444,490,46,46,0
"D06SC",225,122,"1200x900",600,1,600,400,"False",817,709,504,-205,205,0
"D06SC",226,524,"1200x900",1000,1,600,400,"True",534,470,478,8,8,0
"D06SC",229,625,"1200x900",1000,2,600,400,"False",279,228,480,252,252,0
"D06SC",230,393,"1200x900",800,2,600,400,"False",657,620,428,-192,192,0
"D06SC",231,220,"1200x900",800,0,600,400,"True",108,699,650,-49,49,1
"D06SC",232,239,"1200x900",800,0,600,400,"False",114,231,357,126,126,1
"D06SC",233,331,"1200x900",800,1,600,400,"False",240,620,410,-210,210,0
"D06SC",234,35,"1200x900",600,0,600,400,"True",366,555,577,22,22,1
"D06SC",235,282,"1200x900",800,0,600,400,"False",109,246,402,156,156,1
"D06SC",236,413,"1200x900",800,2,600,400,"True",849,506,525,19,19,0
"D06SC",237,640,"1200x900",1000,2,600,400,"False",361,334,528,194,194,0
"D06SC",238,138,"1200x900",600,1,600,400,"True",844,580,582,2,2,1
"D06SC",239,525,"1200x900",1000,1,600,400,"True",123,690,686,-4,4,0
"D06SC",241,515,"1200x900",1000,1,600,400,"False",307,217,665,448,448,0
"D06SC",242,281,"1200x900",800,0,600,400,"True",112,611,600,-11,11,1
"D06SC",243,276,"1200x900",800,0,600,400,"False",281,217,298,81,81,1
"D06SC",244,577,"1200x900",1000,2,600,400,"True",455,420,425,5,5,0
"D06SC",245,323,"1200x900",800,1,600,400,"False",388,348,537,189,189,0
"D06SC",246,481,"1200x900",1000,0,600,400,"False",80,185,364,179,179,1
"D06SC",247,170,"1200x900",600,2,600,400,"False",996,468,308,-160,160,0
"D06SC",248,69,"1200x900",600,0,600,400,"False",322,268,360,92,92,0
"D06SC",249,543,"1200x900",1000,1,600,400,"False",88,202,481,279,279,0
"D06SC",250,447,"1200x900",1000,0,600,400,"True",71,339,263,-76,76,1
"D06SC",251,616,"1200x900",1000,2,600,400,"False",854,357,225,-132,132,1
"D06SC",252,394,"1200x900",800,2,600,400,"True",847,292,258,-34,34,0
"D06SC",253,468,"1200x900",1000,0,600,400,"False",121,219,372,153,153,1
"D06SC",254,569,"1200x900",1000,1,600,400,"False",494,720,528,-192,192,0
"D06SC",255,39,"1200x900",600,0,600,400,"True",210,609,628,19,19,0
"D06SC",256,66,"1200x900",600,0,600,400,"True",155,673,700,27,27,0
"D06SC",257,168,"1200x900",600,2,600,400,"False",1001,439,231,-208,208,0
"D06SC",258,508,"1200x900",1000,1,600,400,"True",596,485,456,-29,29,0
"D06SC",259,53,"1200x900",600,0,600,400,"False",177,189,352,163,163,0
"D06SC",260,254,"1200x900",800,0,600,400,"False",136,583,411,-172,172,1
"D06SC",261,156,"1200x900",600,2,600,400,"False",913,197,113,-84,84,0
"D06SC",262,409,"1200x900",800,2,600,400,"False",501,659,412,-247,247,0
"D06SC",263,528,"1200x900",1000,1,600,400,"False",839,227,738,511,511,1
"D06SC",264,313,"1200x900",800,1,600,400,"False",588,421,536,115,115,0
"D06SC",265,437,"1200x900",1000,0,600,400,"False",74,667,552,-115,115,1
"D06SC",266,144,"1200x900",600,1,600,400,"False",718,371,553,182,182,0
"D06SC",267,438,"1200x900",1000,0,600,400,"False",77,713,566,-147,147,1
"D06SC",268,575,"1200x900",1000,1,600,400,"False",272,693,584,-109,109,0
"D06SC",269,207,"1200x900",600,2,600,400,"False",838,235,451,216,216,0
"D06SC",270,18,"1200x900",600,0,600,400,"False",400,318,409,91,91,1
"D06SC",271,38,"1200x900",600,0,600,400,"False",120,628,481,-147,147,1
"D06SC",272,6,"1200x900",600,0,600,400,"False",217,689,550,-139,139,1
"D06SC",274,241,"1200x900",800,0,600,400,"False",129,227,453,226,226,1
"D06SC",275,459,"1200x900",1000,0,600,400,"False",70,645,484,-161,161,1
"D06SC",276,94,"1200x900",600,1,600,400,"True",729,482,429,-53,53,0
"D06SC",278,479,"1200x900",1000,0,600,400,"False",74,705,544,-161,161,1
"D06SC",279,518,"1200x900",1000,1,600,400,"False",583,717,553,-164,164,0
"D06SC",280,272,"1200x900",800,0,600,400,"False",200,181,310,129,129,1
"D06SC",281,216,"1200x900",600,2,600,400,"False",1029,286,437,151,151,0
"D06SC",282,217,"1200x900",800,0,600,400,"False",85,573,503,-70,70,1
"D06SC",283,425,"1200x900",800,2,600,400,"True",621,438,383,-55,55,0
"D06SC",284,260,"1200x900",800,0,600,400,"False",103,525,405,-120,120,1
"D06SC",285,155,"1200x900",600,2,600,400,"False",940,269,361,92,92,0
"D06SC",286,430,"1200x900",800,2,600,400,"False",922,254,405,151,151,0
"D06SC",287,231,"1200x900",800,0,600,400,"False",251,718,550,-168,168,1
"D06SC",288,555,"1200x900",1000,1,600,400,"True",444,556,557,1,1,0
"D06SC",289,572,"1200x900",1000,1,600,400,"False",302,260,475,215,215,0
"D06SC",290,319,"1200x900",800,1,600,400,"True",494,587,524,-63,63,1
"D06SC",291,619,"1200x900",1000,2,600,400,"False",803,247,505,258,258,0
"D06SC",293,40,"1200x900",600,0,600,400,"True",143,513,502,-11,11,0
"D06SC",294,174,"1200x900",600,2,600,400,"True",998,457,478,21,21,0
"D06SC",296,426,"1200x900",800,2,600,400,"False",830,263,195,-68,68,0
"D06SC",297,252,"1200x900",800,0,600,400,"False",224,673,407,-266,266,1
"D06SC",298,210,"1200x900",600,2,600,400,"True",835,506,538,32,32,0
"D06SC",299,84,"1200x900",600,1,600,400,"False",144,184,480,296,296,0
"D06SC",300,49,"1200x900",600,0,600,400,"True",109,380,396,16,16,0
"D06SC",301,148,"1200x900",600,2,600,400,"True",907,330,366,36,36,0
"D06SC",302,19,"1200x900",600,0,600,400,"False",286,686,547,-139,139,0
"D06SC",303,455,"1200x900",1000,0,600,400,"False",107,718,440,-278,278,1
"D06SC",304,55,"1200x900",600,0,600,400,"True",211,305,353,48,48,1
"D06SC",306,270,"1200x900",800,0,600,400,"True",192,418,471,53,53,1
"D06SC",308,504,"1200x900",1000,0,600,400,"False",107,699,514,-185,185,1
"D06SC",309,266,"1200x900",800,0,600,400,"False",126,303,426,123,123,1
"D06SC",310,329,"1200x900",800,1,600,400,"False",517,239,368,129,129,0
"D06SC",311,607,"1200x900",1000,2,600,400,"False",900,573,414,-159,159,1
"D06SC",312,275,"1200x900",800,0,600,400,"False",120,594,467,-127,127,0
"D06SC",313,496,"1200x900",1000,0,600,400,"False",70,639,509,-130,130,1
"D06SC",314,189,"1200x900",600,2,600,400,"False",881,397,274,-123,123,0
"D06SC",315,446,"1200x900",1000,0,600,400,"True",72,298,305,7,7,1
"D06SC",317,76,"1200x900",600,1,600,400,"False",647,614,484,-130,130,0
"D06SC",318,576,"1200x900",1000,1,600,400,"False",376,713,578,-135,135,0
"D06SC",319,421,"1200x900",800,2,600,400,"True",898,394,475,81,81,0
"D06SC",320,194,"1200x900",600,2,600,400,"False",896,236,410,174,174,0
"D06SC",321,96,"1200x900",600,1,600,400,"False",433,458,516,58,58,0
"D06SC",322,559,"1200x900",1000,1,600,400,"False",641,244,436,192,192,0
"D06SC",323,422,"1200x900",800,2,600,400,"False",712,558,435,-123,123,0
"D06SC",324,22,"1200x900",600,0,600,400,"True",398,591,528,-63,63,1
"D06SC",325,117,"1200x900",600,1,600,400,"False",711,456,357,-99,99,0
"D06SC",326,309,"1200x900",800,1,600,400,"False",186,225,455,230,230,0
"D06SC",327,186,"1200x900",600,2,600,400,"False",997,197,393,196,196,0
"D06SC",328,380,"1200x900",800,2,600,400,"True",942,228,256,28,28,0
"D06SC",329,355,"1200x900",800,1,600,400,"False",77,386,540,154,154,0
"D06SC",330,296,"1200x900",800,1,600,400,"True",89,279,233,-46,46,0
"D06SC",331,153,"1200x900",600,2,600,400,"False",1037,601,392,-209,209,0
"D06SC",332,8,"1200x900",600,0,600,400,"True",156,679,646,-33,33,0
"D06SC",333,483,"1200x900",1000,0,600,400,"False",93,191,389,198,198,1
"D06SC",334,517,"1200x900",1000,1,600,400,"False",548,182,360,178,178,0
"D06SC",336,473,"1200x900",1000,0,600,400,"False",75,323,509,186,186,1
"D06SC",337,510,"1200x900",1000,1,600,400,"False",486,338,259,-79,79,1
"D06SC",338,165,"1200x900",600,2,600,400,"True",912,554,547,-7,7,0
"D06SC",339,52,"1200x900",600,0,600,400,"False",171,188,266,78,78,0
"D06SC",340,183,"1200x900",600,2,600,400,"True",927,289,240,-49,49,0
"D06SC",341,403,"1200x900",800,2,600,400,"False",625,704,305,-399,399,0
"D06SC",342,284,"1200x900",800,0,600,400,"False",135,293,362,69,69,1
"D06SC",343,463,"1200x900",1000,0,600,400,"False",115,693,408,-285,285,1
"D06SC",344,13,"1200x900",600,0,600,400,"False",296,211,376,165,165,1
"D06SC",345,112,"1200x900",600,1,600,400,"False",681,490,378,-112,112,0
"D06SC",347,51,"1200x900",600,0,600,400,"False",272,181,255,74,74,1
"D06SC",348,596,"1200x900",1000,2,600,400,"False",706,513,332,-181,181,0
"D06SC",349,200,"1200x900",600,2,600,400,"True",897,302,377,75,75,0
"D06SC",350,125,"1200x900",600,1,600,400,"False",750,531,431,-100,100,0
"D06SC",351,294,"1200x900",800,1,600,400,"False",262,287,433,146,146,0
"D06SC",352,401,"1200x900",800,2,600,400,"True",821,260,334,74,74,0
"D06SC",353,295,"1200x900",800,1,600,400,"False",471,334,441,107,107,0
"D06SC",356,462,"1200x900",1000,0,600,400,"False",102,672,582,-90,90,1
"D06SC",357,124,"1200x900",600,1,600,400,"True",345,467,485,18,18,0
"D06SC",358,61,"1200x900",600,0,600,400,"True",272,670,672,2,2,1
"D06SC",359,101,"1200x900",600,1,600,400,"True",541,656,593,-63,63,0
"D06SC",360,211,"1200x900",600,2,600,400,"True",986,407,408,1,1,0
"D06SC",361,33,"1200x900",600,0,600,400,"True",198,533,493,-40,40,1
"D06SC",362,519,"1200x900",1000,1,600,400,"True",319,565,560,-5,5,1
"D06SC",363,136,"1200x900",600,1,600,400,"False",264,205,448,243,243,0
"D06SC",364,324,"1200x900",800,1,600,400,"False",719,712,414,-298,298,1
"D06SC",366,77,"1200x900",600,1,600,400,"False",780,525,408,-117,117,0
"D06SC",367,417,"1200x900",800,2,600,400,"False",750,280,455,175,175,0
"D06SC",368,335,"1200x900",800,1,600,400,"False",124,360,651,291,291,0
"D06SC",369,406,"1200x900",800,2,600,400,"False",971,233,375,142,142,0
"D06SC",370,360,"1200x900",800,1,600,400,"False",203,608,500,-108,108,0
"D06SC",371,397,"1200x900",800,2,600,400,"False",817,692,508,-184,184,0
"D06SC",372,29,"1200x900",600,0,600,400,"True",385,533,545,12,12,1
"D06SC",373,221,"1200x900",800,0,600,400,"True",132,520,460,-60,60,1
"D06SC",375,336,"1200x900",800,1,600,400,"False",251,587,498,-89,89,0
"D06SC",376,24,"1200x900",600,0,600,400,"False",430,538,453,-85,85,1
"D06SC",377,108,"1200x900",600,1,600,400,"False",830,239,496,257,257,0
"D06SC",378,89,"1200x900",600,1,600,400,"True",917,366,332,-34,34,1
"D06SC",379,47,"1200x900",600,0,600,400,"False",303,499,429,-70,70,1
"D06SC",380,433,"1200x900",1000,0,600,400,"False",76,222,457,235,235,1
"D06SC",381,164,"1200x900",600,2,600,400,"True",1051,268,386,118,118,0
"D06SC",382,404,"1200x900",800,2,600,400,"False",842,396,236,-160,160,0
"D06SC",383,512,"1200x900",1000,1,600,400,"False",139,261,495,234,234,0
"D06SC",384,303,"1200x900",800,1,600,400,"False",241,431,650,219,219,0
"D06SC",385,75,"1200x900",600,1,600,400,"True",635,558,548,-10,10,0
"D06SC",386,609,"1200x900",1000,2,600,400,"False",697,627,457,-170,170,0
"D06SC",387,154,"1200x900",600,2,600,400,"True",941,454,466,12,12,0
"D06SC",388,340,"1200x900",800,1,600,400,"False",226,240,493,253,253,0
"D06SC",389,21,"1200x900",600,0,600,400,"True",314,383,446,63,63,1
"D06SC",391,177,"1200x900",600,2,600,400,"False",912,236,373,137,137,0
"D06SC",392,384,"1200x900",800,2,600,400,"False",821,707,470,-237,237,0
"D06SC",393,493,"1200x900",1000,0,600,400,"True",80,582,639,57,57,1
"D06SC",394,48,"1200x900",600,0,600,400,"True",323,645,640,-5,5,1
"D06SC",395,3,"1200x900",600,0,600,400,"True",298,443,473,30,30,1
"D06SC",396,269,"1200x900",800,0,600,400,"False",160,295,377,82,82,1
"D06SC",397,501,"1200x900",1000,0,600,400,"False",96,323,533,210,210,1
"D06SC",398,476,"1200x900",1000,0,600,400,"False",76,359,590,231,231,1
"D06SC",399,390,"1200x900",800,2,600,400,"True",982,674,619,-55,55,1
"D06SC",400,137,"1200x900",600,1,600,400,"True",789,577,620,43,43,0
"D06SC",402,78,"1200x900",600,1,600,400,"True",885,684,639,-45,45,0
"D06SC",403,643,"1200x900",1000,2,600,400,"True",740,325,396,71,71,0
"D06SC",404,227,"1200x900",800,0,600,400,"True",196,551,607,56,56,1
"D06SC",405,334,"1200x900",800,1,600,400,"True",481,665,653,-12,12,0
"D06SC",407,131,"1200x900",600,1,600,400,"False",531,367,568,201,201,0
"D06SC",408,634,"1200x900",1000,2,600,400,"False",735,313,475,162,162,0
"D06SC",409,45,"1200x900",600,0,600,400,"True",487,678,619,-59,59,1
"D06SC",410,445,"1200x900",1000,0,600,400,"False",78,302,595,293,293,1
"D06SC",411,214,"1200x900",600,2,600,400,"False",1046,305,545,240,240,0
"D06SC",412,135,"1200x900",600,1,600,400,"True",759,569,544,-25,25,0
"D06SC",413,310,"1200x900",800,1,600,400,"True",559,592,614,22,22,0
"D06SC",414,277,"1200x900",800,0,600,400,"True",140,310,369,59,59,1
"D06SC",415,327,"1200x900",800,1,600,400,"False",152,339,504,165,165,0
"D06SC",417,568,"1200x900",1000,1,600,400,"False",286,475,362,-113,113,1
"D06SC",418,443,"1200x900",1000,0,600,400,"False",99,651,462,-189,189,1
"D06SC",420,563,"1200x900",1000,1,600,400,"False",201,696,579,-117,117,0
"D06SC",421,70,"1200x900",600,0,600,400,"True",309,703,687,-16,16,1
"D06SC",422,63,"1200x900",600,0,600,400,"True",311,188,255,67,67,1
"D06SC",423,300,"1200x900",800,1,600,400,"False",620,693,496,-197,197,0
"D06SC",425,646,"1200x900",1000,2,600,400,"False",829,227,511,284,284,1
"D06SC",426,163,"1200x900",600,2,600,400,"False",1046,665,463,-202,202,0
"D06SC",427,320,"1200x900",800,1,600,400,"True",644,376,410,34,34,0
"D06SC",429,17,"1200x900",600,0,600,400,"True",402,496,470,-26,26,1
"D06SC",430,129,"1200x900",600,1,600,400,"False",859,482,396,-86,86,1
"D06SC",431,90,"1200x900",600,1,600,400,"True",560,474,465,-9,9,0
"D06SC",432,65,"1200x900",600,0,600,400,"True",442,645,609,-36,36,1
"D06SC",433,618,"1200x900",1000,2,600,400,"True",276,671,601,-70,70,0
"D06SC",434,316,"1200x900",800,1,600,400,"False",362,319,408,89,89,0
"D06SC",435,628,"1200x900",1000,2,600,400,"True",768,410,429,19,19,0
"D06SC",436,82,"1200x900",600,1,600,400,"False",108,213,386,173,173,0
"D06SC",437,184,"1200x900",600,2,600,400,"True",1067,441,381,-60,60,0
"D06SC",440,509,"1200x900",1000,1,600,400,"True",509,434,438,4,4,0
"D06SC",441,205,"1200x900",600,2,600,400,"True",1021,504,490,-14,14,0
"D06SC",442,91,"1200x900",600,1,600,400,"False",417,630,480,-150,150,1
"D06SC",443,503,"1200x900",1000,0,600,400,"False",86,279,415,136,136,1
"D06SC",444,622,"1200x900",1000,2,600,400,"False",307,683,416,-267,267,0
"D06SC",445,279,"1200x900",800,0,600,400,"False",252,202,273,71,71,1
"D06SC",446,306,"1200x900",800,1,600,400,"True",164,524,558,34,34,0
"D06SC",447,494,"1200x900",1000,0,600,400,"False",127,692,611,-81,81,1
"D06SC",448,143,"1200x900",600,1,600,400,"False",479,284,390,106,106,1
"D06SC",449,58,"1200x900",600,0,600,400,"True",353,655,626,-29,29,1
"D06SC",450,311,"1200x900",800,1,600,400,"False",710,261,598,337,337,0
"D06SC",452,128,"1200x900",600,1,600,400,"False",661,258,572,314,314,1
"D06SC",453,85,"1200x900",600,1,600,400,"False",434,347,609,262,262,0
"D06SC",454,346,"1200x900",800,1,600,400,"False",269,635,449,-186,186,0
"D06SC",455,87,"1200x900",600,1,600,400,"True",231,604,592,-12,12,0
"D06SC",456,544,"1200x900",1000,1,600,400,"False",602,620,534,-86,86,0
"D06SC",457,615,"1200x900",1000,2,600,400,"True",736,634,690,56,56,0
"D06SC",458,502,"1200x900",1000,0,600,400,"False",111,639,482,-157,157,1
"D06SC",459,343,"1200x900",800,1,600,400,"False",407,557,500,-57,57,0
"D06SC",460,370,"1200x900",800,2,600,400,"False",874,336,204,-132,132,0
"D06SC",461,604,"1200x900",1000,2,600,400,"True",459,593,638,45,45,0
"D06SC",462,255,"1200x900",800,0,600,400,"True",93,709,760,51,51,1
"D06SC",463,632,"1200x900",1000,2,600,400,"False",984,227,609,382,382,0
"D06SC",464,283,"1200x900",800,0,600,400,"True",90,264,245,-19,19,1
"D06SC",465,375,"1200x900",800,2,600,400,"True",716,384,369,-15,15,0
"D06SC",466,586,"1200x900",1000,2,600,400,"False",802,262,566,304,304,0
"D06SC",467,103,"1200x900",600,1,600,400,"True",528,320,331,11,11,1
"D06SC",468,491,"1200x900",1000,0,600,400,"False",108,198,449,251,251,1
"D06SC",470,2,"1200x900",600,0,600,400,"False",159,323,418,95,95,0
"D06SC",471,100,"1200x900",600,1,600,400,"False",453,511,319,-192,192,0
"D06SC",472,7,"1200x900",600,0,600,400,"False",431,654,577,-77,77,1
"D06SC",473,115,"1200x900",600,1,600,400,"False",545,307,196,-111,111,0
"D06SC",474,364,"1200x900",800,2,600,400,"False",1018,204,415,211,211,0
"D06SC",475,113,"1200x900",600,1,600,400,"False",897,657,518,-139,139,0
"D06SC",476,195,"1200x900",600,2,600,400,"True",942,249,220,-29,29,0
"D06SC",477,197,"1200x900",600,2,600,400,"False",903,212,295,83,83,0
"D06SC",478,482,"1200x900",1000,0,600,400,"False",79,686,418,-268,268,1
"D06SC",479,299,"1200x900",800,1,600,400,"False",779,274,598,324,324,0
"D06SC",480,258,"1200x900",800,0,600,400,"False",126,664,517,-147,147,1
"D06SC",482,350,"1200x900",800,1,600,400,"True",182,566,543,-23,23,0
"D06SC",483,636,"1200x900",1000,2,600,400,"False",575,583,492,-91,91,0
"D06SC",484,349,"1200x900",800,1,600,400,"False",402,665,500,-165,165,0
"D06SC",486,477,"1200x900",1000,0,600,400,"False",88,640,515,-125,125,1
"D06SC",487,467,"1200x900",1000,0,600,400,"False",74,712,486,-226,226,1
"D06SC",488,97,"1200x900",600,1,600,400,"True",760,643,658,15,15,1
"D06SC",489,191,"1200x900",600,2,600,400,"False",962,396,262,-134,134,0
"D06SC",490,256,"1200x900",800,0,600,400,"False",192,656,733,77,77,1
"D06SC",491,92,"1200x900",600,1,600,400,"False",624,605,689,84,84,0
"D06SC",492,253,"1200x900",800,0,600,400,"False",177,424,574,150,150,1
"D06SC",493,549,"1200x900",1000,1,600,400,"False",657,366,585,219,219,0
"D06SC",494,411,"1200x900",800,2,600,400,"False",805,361,230,-131,131,0
"D06SC",495,193,"1200x900",600,2,600,400,"False",874,588,480,-108,108,0
"D06SC",497,330,"1200x900",800,1,600,400,"True",759,301,287,-14,14,1
"D06SC",498,203,"1200x900",600,2,600,400,"False",938,603,423,-180,180,0
"D06SC",499,159,"1200x900",600,2,600,400,"False",992,309,431,122,122,0
"D06SC",503,536,"1200x900",1000,1,600,400,"False",580,213,334,121,121,0
"D06SC",504,166,"1200x900",600,2,600,400,"False",896,274,396,122,122,0
"D06SC",505,487,"1200x900",1000,0,600,400,"True",78,670,623,-47,47,1
"D06SC",506,363,"1200x900",800,2,600,400,"False",800,218,330,112,112,0
"D06SC",507,554,"1200x900",1000,1,600,400,"False",79,309,208,-101,101,1
"D06SC",508,146,"1200x900",600,2,600,400,"False",989,492,263,-229,229,0
"D06SC",509,521,"1200x900",1000,1,600,400,"False",111,303,494,191,191,1
"D06SC",510,263,"1200x900",800,0,600,400,"True",82,396,325,-71,71,1
"D06SC",511,610,"1200x900",1000,2,600,400,"True",702,293,371,78,78,0
"D06SC",512,257,"1200x900",800,0,600,400,"False",97,219,315,96,96,1
"D06SC",513,495,"1200x900",1000,0,600,400,"True",93,692,731,39,39,1
"D06SC",514,419,"1200x900",800,2,600,400,"False",769,351,599,248,248,0
"D06SC",515,436,"1200x900",1000,0,600,400,"False",82,617,391,-226,226,1
"D06SC",516,25,"1200x900",600,0,600,400,"True",263,403,409,6,6,1
"D06SC",517,351,"1200x900",800,1,600,400,"False",122,581,444,-137,137,0
"D06SC",518,64,"1200x900",600,0,600,400,"False",102,339,407,68,68,0
"D06SC",519,60,"1200x900",600,0,600,400,"False",365,213,351,138,138,1
"D06SC",520,435,"1200x900",1000,0,600,400,"False",119,200,287,87,87,1
"D06SC",521,14,"1200x900",600,0,600,400,"False",399,224,319,95,95,1
"D06SC",522,532,"1200x900",1000,1,600,400,"False",215,207,320,113,113,0
"D06SC",523,606,"1200x900",1000,2,600,400,"True",653,627,552,-75,75,0
"D06SC",524,472,"1200x900",1000,0,600,400,"False",77,685,430,-255,255,1
"D06SC",525,627,"1200x900",1000,2,600,400,"True",760,510,467,-43,43,0
"D06SC",526,74,"1200x900",600,1,600,400,"False",115,358,290,-68,68,0
"D06SC",527,511,"1200x900",1000,1,600,400,"True",408,390,417,27,27,1
"D06SC",529,83,"1200x900",600,1,600,400,"False",763,568,467,-101,101,1
"D06SC",530,292,"1200x900",800,1,600,400,"False",88,565,474,-91,91,0
"D06SC",531,545,"1200x900",1000,1,600,400,"True",358,562,531,-31,31,0
"D06SC",532,489,"1200x900",1000,0,600,400,"False",88,604,473,-131,131,1
"D06SC",533,614,"1200x900",1000,2,600,400,"False",823,563,409,-154,154,0
"D06SC",534,178,"1200x900",600,2,600,400,"True",1041,510,497,-13,13,0
"D06SC",536,352,"1200x900",800,1,600,400,"False",235,717,525,-192,192,0
"D06SC",538,644,"1200x900",1000,2,600,400,"True",495,486,411,-75,75,0
"D06SC",539,460,"1200x900",1000,0,600,400,"False",155,189,405,216,216,1
"D06SC",540,36,"1200x900",600,0,600,400,"True",128,346,391,45,45,1
"D06SC",541,151,"1200x900",600,2,600,400,"False",828,680,477,-203,203,0
"D06SC",542,630,"1200x900",1000,2,600,400,"True",754,559,476,-83,83,0
"D06SC",543,574,"1200x900",1000,1,600,400,"False",614,194,360,166,166,0
"D06SC",544,105,"1200x900",600,1,600,400,"False",527,440,618,178,178,0
"D06SC",545,357,"1200x900",800,1,600,400,"True",109,594,558,-36,36,0
"D06SC",546,68,"1200x900",600,0,600,400,"True",165,367,421,54,54,0
"D06SC",547,573,"1200x900",1000,1,600,400,"False",486,615,509,-106,106,0
"D06SC",548,514,"1200x900",1000,1,600,400,"False",539,690,558,-132,132,0
"D06SC",549,566,"1200x900",1000,1,600,400,"False",378,472,403,-69,69,1
"D06SC",550,347,"1200x900",800,1,600,400,"False",757,295,539,244,244,1
"D06SC",551,452,"1200x900",1000,0,600,400,"False",97,273,515,242,242,1
"D06SC",552,62,"1200x900",600,0,600,400,"True",345,346,393,47,47,1
"D06SC",554,361,"1200x900",800,2,600,400,"True",931,328,292,-36,36,0
"D06SC",556,236,"1200x900",800,0,600,400,"True",162,350,347,-3,3,1
"D06SC",558,118,"1200x900",600,1,600,400,"True",190,588,588,0,0,0
"D06SC",559,56,"1200x900",600,0,600,400,"True",148,491,525,34,34,0
"D06SC",560,322,"1200x900",800,1,600,400,"False",703,206,545,339,339,1
"D06SC",561,98,"1200x900",600,1,600,400,"True",625,530,542,12,12,0
"D06SC",562,465,"1200x900",1000,0,600,400,"False",85,203,489,286,286,1
"D06SC",563,582,"1200x900",1000,2,600,400,"False",554,347,515,168,168,0
"D06SC",564,201,"1200x900",600,2,600,400,"True",1005,462,426,-36,36,0
"D06SC",565,229,"1200x900",800,0,600,400,"True",117,697,721,24,24,1
"D06SC",566,523,"1200x900",1000,1,600,400,"False",339,318,556,238,238,0
"D06SC",567,383,"1200x900",800,2,600,400,"False",855,407,555,148,148,0
"D06SC",568,642,"1200x900",1000,2,600,400,"False",776,316,418,102,102,0
"D06SC",569,37,"1200x900",600,0,600,400,"True",258,403,441,38,38,1
"D06SC",571,212,"1200x900",600,2,600,400,"True",841,206,263,57,57,0
"D06SC",572,418,"1200x900",800,2,600,400,"False",754,507,360,-147,147,0
"D06SC",573,134,"1200x900",600,1,600,400,"False",300,188,364,176,176,0
"D06SC",574,240,"1200x900",800,0,600,400,"True",330,656,711,55,55,1
"D06SC",575,427,"1200x900",800,2,600,400,"True",812,380,399,19,19,0
"D06SC",576,464,"1200x900",1000,0,600,400,"False",82,222,459,237,237,1
"D06SC",577,333,"1200x900",800,1,600,400,"True",521,548,606,58,58,0
"D06SC",578,594,"1200x900",1000,2,600,400,"False",537,637,529,-108,108,0
"D06SC",579,218,"1200x900",800,0,600,400,"False",106,397,533,136,136,1
"D06SC",580,558,"1200x900",1000,1,600,400,"False",72,464,660,196,196,1
"D06SC",581,354,"1200x900",800,1,600,400,"False",118,236,599,363,363,0
"D06SC",582,12,"1200x900",600,0,600,400,"True",365,336,382,46,46,1
"D06SC",583,268,"1200x900",800,0,600,400,"True",148,400,396,-4,4,1
"D06SC",585,141,"1200x900",600,1,600,400,"False",671,582,518,-64,64,0
"D06SC",586,271,"1200x900",800,0,600,400,"True",74,360,357,-3,3,1
"D06SC",587,453,"1200x900",1000,0,600,400,"False",71,393,512,119,119,1
"D06SC",588,291,"1200x900",800,1,600,400,"False",522,694,459,-235,235,0
"D06SC",589,341,"1200x900",800,1,600,400,"False",735,632,497,-135,135,1
"D06SC",590,158,"1200x900",600,2,600,400,"False",939,300,472,172,172,0
"D06SC",591,50,"1200x900",600,0,600,400,"True",75,582,546,-36,36,0
"D06SC",592,246,"1200x900",800,0,600,400,"False",196,418,509,91,91,1
"D06SC",594,506,"1200x900",1000,1,600,400,"False",559,567,306,-261,261,1
"D06SC",595,162,"1200x900",600,2,600,400,"False",849,279,204,-75,75,0
"D06SC",596,95,"1200x900",600,1,600,400,"False",749,425,531,106,106,1
"D06SC",597,301,"1200x900",800,1,600,400,"True",162,574,575,1,1,0
"D06SC",601,265,"1200x900",800,0,600,400,"False",229,353,471,118,118,1
"D06SC",602,142,"1200x900",600,1,600,400,"False",286,474,575,101,101,0
"D06SC",603,423,"1200x900",800,2,600,400,"False",1051,710,508,-202,202,1
"D06SC",604,500,"1200x900",1000,0,600,400,"False",105,700,626,-74,74,1
"D06SC",605,226,"1200x900",800,0,600,400,"True",187,229,229,0,0,1
"D06SC",606,553,"1200x900",1000,1,600,400,"False",116,712,370,-342,342,0
"D06SC",607,150,"1200x900",600,2,600,400,"True",897,345,371,26,26,0
"D06SC",608,537,"1200x900",1000,1,600,400,"True",621,412,417,5,5,1
"D06SC",609,602,"1200x900",1000,2,600,400,"True",865,452,449,-3,3,0
"D06SC",610,314,"1200x900",800,1,600,400,"False",277,616,410,-206,206,1
"D06SC",611,233,"1200x900",800,0,600,400,"True",164,700,762,62,62,1
"D06SC",612,639,"1200x900",1000,2,600,400,"False",504,456,625,169,169,0
"D06SC",613,471,"1200x900",1000,0,600,400,"False",122,200,563,363,363,1
"D06SC",614,248,"1200x900",800,0,600,400,"False",94,240,425,185,185,1
"D06SC",615,5,"1200x900",600,0,600,400,"False",228,587,485,-102,102,0
"D06SC",616,242,"1200x900",800,0,600,400,"True",117,448,400,-48,48,1
"D06SC",617,106,"1200x900",600,1,600,400,"False",803,659,484,-175,175,1
"D06SC",618,297,"1200x900",800,1,600,400,"False",625,244,324,80,80,0
"D06SC",619,470,"1200x900",1000,0,600,400,"False",91,666,459,-207,207,1
"D06SC",621,26,"1200x900",600,0,600,400,"False",70,712,643,-69,69,0
"D06SC",622,185,"1200x900",600,2,600,400,"True",907,212,221,9,9,0
"D06SC",623,478,"1200x900",1000,0,600,400,"False",79,672,555,-117,117,1
"D06SC",624,448,"1200x900",1000,0,600,400,"True",107,641,640,-1,1,1
"D06SC",625,171,"1200x900",600,2,600,400,"True",909,200,326,126,126,0
"D06SC",626,550,"1200x900",1000,1,600,400,"True",301,459,446,-13,13,0
"D06SC",627,223,"1200x900",800,0,600,400,"True",179,191,143,-48,48,1
"D06SC",628,215,"1200x900",600,2,600,400,"False",939,596,472,-124,124,0
"D06SC",629,67,"1200x900",600,0,600,400,"True",289,308,333,25,25,1
"D06SC",630,399,"1200x900",800,2,600,400,"False",603,602,518,-84,84,0
"D06SC",631,533,"1200x900",1000,1,600,400,"False",355,483,394,-89,89,0
"D06SC",632,513,"1200x900",1000,1,600,400,"False",235,602,353,-249,249,0
"D06SC",633,338,"1200x900",800,1,600,400,"False",813,253,439,186,186,1
"D06SC",635,345,"1200x900",800,1,600,400,"True",841,566,494,-72,72,1
"D06SC",636,583,"1200x900",1000,2,600,400,"False",949,284,457,173,173,1
"D06SC",637,224,"1200x900",800,0,600,400,"True",161,474,532,58,58,1
"D06SC",638,104,"1200x900",600,1,600,400,"True",448,584,525,-59,59,0
"D06SC",639,362,"1200x900",800,2,600,400,"False",819,338,469,131,131,0
"D06SC",640,456,"1200x900",1000,0,600,400,"False",91,257,389,132,132,1
"D06SC",641,304,"1200x900",800,1,600,400,"False",667,605,388,-217,217,0
"D06SC",642,111,"1200x900",600,1,600,400,"False",922,552,469,-83,83,1
"D06SC",643,228,"1200x900",800,0,600,400,"False",174,687,408,-279,279,1
"D06SC",644,631,"1200x900",1000,2,600,400,"True",699,479,448,-31,31,0
"D06SC",645,133,"1200x900",600,1,600,400,"False",345,551,441,-110,110,0
"D06SC",646,439,"1200x900",1000,0,600,400,"False",110,229,386,157,157,1
"D06SC",648,412,"1200x900",800,2,600,400,"False",842,280,198,-82,82,0
"D07NV",1,326,"1200x900",800,1,600,400,"True",103,482,440,-42,42,0
"D07NV",2,316,"1200x900",800,1,600,400,"False",362,319,511,192,192,0
"D07NV",3,269,"1200x900",800,0,600,400,"True",160,295,302,7,7,1
"D07NV",4,562,"1200x900",1000,1,600,400,"False",347,540,409,-131,131,0
"D07NV",5,243,"1200x900",800,0,600,400,"False",114,332,408,76,76,1
"D07NV",6,382,"1200x900",800,2,600,400,"False",870,523,50,-473,473,0
"D07NV",7,560,"1200x900",1000,1,600,400,"False",516,693,491,-202,202,0
"D07NV",8,462,"1200x900",1000,0,600,400,"True",102,672,636,-36,36,1
"D07NV",9,182,"1200x900",600,2,600,400,"False",933,389,307,-82,82,0
"D07NV",10,339,"1200x900",800,1,600,400,"False",273,545,373,-172,172,1
"D07NV",11,234,"1200x900",800,0,600,400,"True",72,344,367,23,23,1
"D07NV",12,301,"1200x900",800,1,600,400,"True",162,574,493,-81,81,0
"D07NV",13,148,"1200x900",600,2,600,400,"True",907,330,347,17,17,0
"D07NV",14,53,"1200x900",600,0,600,400,"False",177,189,259,70,70,0
"D07NV",15,455,"1200x900",1000,0,600,400,"False",107,718,605,-113,113,1
"D07NV",16,452,"1200x900",1000,0,600,400,"True",97,273,271,-2,2,1
"D07NV",17,525,"1200x900",1000,1,600,400,"True",123,690,634,-56,56,0
"D07NV",18,353,"1200x900",800,1,600,400,"True",90,476,396,-80,80,0
"D07NV",19,102,"1200x900",600,1,600,400,"True",861,603,593,-10,10,0
"D07NV",20,389,"1200x900",800,2,600,400,"True",843,530,591,61,61,0
"D07NV",21,549,"1200x900",1000,1,600,400,"False",657,366,613,247,247,0
"D07NV",22,291,"1200x900",800,1,600,400,"True",522,694,683,-11,11,0
"D07NV",23,385,"1200x900",800,2,600,400,"False",740,456,535,79,79,0
"D07NV",24,108,"1200x900",600,1,600,400,"False",830,239,613,374,374,0
"D07NV",25,121,"1200x900",600,1,600,400,"True",884,364,426,62,62,0
"D07NV",26,202,"1200x900",600,2,600,400,"False",966,460,391,-69,69,0
"D07NV",27,244,"1200x900",800,0,600,400,"False",194,203,102,-101,101,1
"D07NV",28,513,"1200x900",1000,1,600,400,"False",235,602,225,-377,377,0
"D07NV",29,185,"1200x900",600,2,600,400,"True",907,212,222,10,10,0
"D07NV",30,431,"1200x900",800,2,600,400,"False",694,382,548,166,166,0
"D07NV",31,406,"1200x900",800,2,600,400,"False",971,233,583,350,350,0
"D07NV",32,66,"1200x900",600,0,600,400,"True",155,673,608,-65,65,0
"D07NV",33,621,"1200x900",1000,2,600,400,"False",540,478,599,121,121,0
"D07NV",34,512,"1200x900",1000,1,600,400,"True",139,261,282,21,21,0
"D07NV",35,397,"1200x900",800,2,600,400,"False",817,692,422,-270,270,0
"D07NV",36,449,"1200x900",1000,0,600,400,"True",105,683,729,46,46,1
"D07NV",37,571,"1200x900",1000,1,600,400,"False",239,522,271,-251,251,1
"D07NV",38,540,"1200x900",1000,1,600,400,"False",389,568,287,-281,281,1
"D07NV",39,19,"1200x900",600,0,600,400,"True",286,686,683,-3,3,0
"D07NV",40,1,"1200x900",600,0,600,400,"True",136,502,536,34,34,0
"D07NV",41,383,"1200x900",800,2,600,400,"False",855,407,658,251,251,0
"D07NV",42,174,"1200x900",600,2,600,400,"True",998,457,470,13,13,0
"D07NV",43,56,"1200x900",600,0,600,400,"True",148,491,478,-13,13,0
"D07NV",44,319,"1200x900",800,1,600,400,"False",494,587,751,164,164,1
"D07NV",45,644,"1200x900",1000,2,600,400,"False",495,486,257,-229,229,0
"D07NV",46,469,"1200x900",1000,0,600,400,"True",73,227,275,48,48,1
"D07NV",47,624,"1200x900",1000,2,600,400,"True",693,501,519,18,18,0
"D07NV",49,613,"1200x900",1000,2,600,400,"False",690,374,541,167,167,0
"D07NV",50,445,"1200x900",1000,0,600,400,"True",78,302,289,-13,13,1
"D07NV",51,328,"1200x900",800,1,600,400,"False",104,649,364,-285,285,0
"D07NV",52,71,"1200x900",600,0,600,400,"True",219,248,246,-2,2,0
"D07NV",53,640,"1200x900",1000,2,600,400,"False",361,334,637,303,303,0
"D07NV",54,413,"1200x900",800,2,600,400,"True",849,506,527,21,21,0
"D07NV",55,425,"1200x900",800,2,600,400,"True",621,438,516,78,78,0
"D07NV",56,85,"1200x900",600,1,600,400,"False",434,347,515,168,168,0
"D07NV",57,604,"1200x900",1000,2,600,400,"True",459,593,586,-7,7,0
"D07NV",58,232,"1200x900",800,0,600,400,"True",84,511,466,-45,45,1
"D07NV",59,426,"1200x900",800,2,600,400,"False",830,263,559,296,296,0
"D07NV",60,14,"1200x900",600,0,600,400,"True",399,224,263,39,39,1
"D07NV",61,96,"1200x900",600,1,600,400,"True",433,458,470,12,12,0
"D07NV",62,141,"1200x900",600,1,600,400,"True",671,582,623,41,41,0
"D07NV",63,616,"1200x900",1000,2,600,400,"False",854,357,214,-143,143,1
"D07NV",64,27,"1200x900",600,0,600,400,"True",373,309,318,9,9,1
"D07NV",65,337,"1200x900",800,1,600,400,"False",299,622,300,-322,322,0
"D07NV",66,178,"1200x900",600,2,600,400,"True",1041,510,542,32,32,0
"D07NV",67,131,"1200x900",600,1,600,400,"False",531,367,483,116,116,0
"D07NV",68,189,"1200x900",600,2,600,400,"True",881,397,391,-6,6,0
"D07NV",69,450,"1200x900",1000,0,600,400,"True",130,204,237,33,33,1
"D07NV",70,116,"1200x900",600,1,600,400,"False",767,289,131,-158,158,0
"D07NV",71,395,"1200x900",800,2,600,400,"False",743,334,195,-139,139,0
"D07NV",72,89,"1200x900",600,1,600,400,"False",917,366,206,-160,160,1
"D07NV",73,639,"1200x900",1000,2,600,400,"False",504,456,315,-141,141,0
"D07NV",74,98,"1200x900",600,1,600,400,"True",625,530,476,-54,54,0
"D07NV",75,80,"1200x900",600,1,600,400,"True",616,423,412,-11,11,1
"D07NV",76,223,"1200x900",800,0,600,400,"True",179,191,137,-54,54,1
"D07NV",77,67,"1200x900",600,0,600,400,"False",289,308,166,-142,142,1
"D07NV",78,130,"1200x900",600,1,600,400,"False",741,428,340,-88,88,0
"D07NV",79,79,"1200x900",600,1,600,400,"True",731,289,263,-26,26,0
"D07NV",80,138,"1200x900",600,1,600,400,"False",844,580,686,106,106,1
"D07NV",81,49,"1200x900",600,0,600,400,"False",109,380,262,-118,118,0
"D07NV",82,335,"1200x900",800,1,600,400,"True",124,360,286,-74,74,0
"D07NV",83,51,"1200x900",600,0,600,400,"False",272,181,253,72,72,1
"D07NV",84,507,"1200x900",1000,1,600,400,"False",608,583,511,-72,72,1
"D07NV",85,293,"1200x900",800,1,600,400,"False",561,396,500,104,104,0
"D07NV",86,437,"1200x900",1000,0,600,400,"False",74,667,572,-95,95,1
"D07NV",87,280,"1200x900",800,0,600,400,"False",104,302,208,-94,94,1
"D07NV",88,331,"1200x900",800,1,600,400,"False",240,620,815,195,195,0
"D07NV",89,539,"1200x900",1000,1,600,400,"False",510,383,312,-71,71,0
"D07NV",90,265,"1200x900",800,0,600,400,"True",229,353,320,-33,33,1
"D07NV",91,152,"1200x900",600,2,600,400,"False",971,399,211,-188,188,0
"D07NV",92,333,"1200x900",800,1,600,400,"False",521,548,476,-72,72,0
"D07NV",93,504,"1200x900",1000,0,600,400,"False",107,699,572,-127,127,1
"D07NV",94,230,"1200x900",800,0,600,400,"True",99,678,683,5,5,1
"D07NV",95,104,"1200x900",600,1,600,400,"False",448,584,817,233,233,0
"D07NV",96,457,"1200x900",1000,0,600,400,"True",97,630,604,-26,26,1
"D07NV",97,21,"1200x900",600,0,600,400,"False",314,383,270,-113,113,1
"D07NV",98,231,"1200x900",800,0,600,400,"False",251,718,600,-118,118,1
"D07NV",99,615,"1200x900",1000,2,600,400,"False",736,634,735,101,101,0
"D07NV",100,254,"1200x900",800,0,600,400,"True",136,583,577,-6,6,1
"D07NV",101,407,"1200x900",800,2,600,400,"False",989,340,200,-140,140,0
"D07NV",102,61,"1200x900",600,0,600,400,"False",272,670,595,-75,75,1
"D07NV",103,632,"1200x900",1000,2,600,400,"False",984,227,706,479,479,0
"D07NV",104,2,"1200x900",600,0,600,400,"False",159,323,225,-98,98,0
"D07NV",105,229,"1200x900",800,0,600,400,"False",117,697,550,-147,147,1
"D07NV",106,547,"1200x900",1000,1,600,400,"True",369,384,454,70,70,1
"D07NV",107,81,"1200x900",600,1,600,400,"True",696,225,269,44,44,0
"D07NV",108,274,"1200x900",800,0,600,400,"True",146,497,490,-7,7,1
"D07NV",109,444,"1200x900",1000,0,600,400,"False",101,714,593,-121,121,1
"D07NV",110,213,"1200x900",600,2,600,400,"False",822,275,218,-57,57,0
"D07NV",111,410,"1200x900",800,2,600,400,"False",916,477,138,-339,339,0
"D07NV",112,460,"1200x900",1000,0,600,400,"False",155,189,303,114,114,1
"D07NV",113,252,"1200x900",800,0,600,400,"False",224,673,528,-145,145,1
"D07NV",114,508,"1200x900",1000,1,600,400,"True",596,485,471,-14,14,0
"D07NV",115,451,"1200x900",1000,0,600,400,"True",110,702,657,-45,45,1
"D07NV",116,590,"1200x900",1000,2,600,400,"False",636,278,148,-130,130,0
"D07NV",117,155,"1200x900",600,2,600,400,"False",940,269,181,-88,88,0
"D07NV",118,514,"1200x900",1000,1,600,400,"True",539,690,681,-9,9,0
"D07NV",119,551,"1200x900",1000,1,600,400,"False",146,445,282,-163,163,1
"D07NV",120,546,"1200x900",1000,1,600,400,"True",305,374,380,6,6,0
"D07NV",121,593,"1200x900",1000,2,600,400,"False",246,719,364,-355,355,0
"D07NV",122,321,"1200x900",800,1,600,400,"False",601,190,268,78,78,0
"D07NV",123,428,"1200x900",800,2,600,400,"False",732,665,350,-315,315,0
"D07NV",124,8,"1200x900",600,0,600,400,"True",156,679,653,-26,26,0
"D07NV",125,107,"1200x900",600,1,600,400,"True",878,678,724,46,46,0
"D07NV",126,486,"1200x900",1000,0,600,400,"False",102,676,565,-111,111,1
"D07NV",127,172,"1200x900",600,2,600,400,"False",912,444,604,160,160,0
"D07NV",128,579,"1200x900",1000,2,600,400,"False",803,394,729,335,335,0
"D07NV",129,322,"1200x900",800,1,600,400,"False",703,206,301,95,95,1
"D07NV",130,372,"1200x900",800,2,600,400,"False",833,620,484,-136,136,0
"D07NV",131,478,"1200x900",1000,0,600,400,"True",79,672,641,-31,31,1
"D07NV",132,34,"1200x900",600,0,600,400,"False",361,242,364,122,122,1
"D07NV",133,366,"1200x900",800,2,600,400,"False",931,464,151,-313,313,0
"D07NV",134,362,"1200x900",800,2,600,400,"False",819,338,478,140,140,0
"D07NV",135,574,"1200x900",1000,1,600,400,"False",614,194,262,68,68,0
"D07NV",136,511,"1200x900",1000,1,600,400,"False",408,390,506,116,116,1
"D07NV",137,149,"1200x900",600,2,600,400,"True",890,289,234,-55,55,0
"D07NV",138,485,"1200x900",1000,0,600,400,"True",121,694,641,-53,53,1
"D07NV",139,433,"1200x900",1000,0,600,400,"True",76,222,280,58,58,1
"D07NV",141,65,"1200x900",600,0,600,400,"True",442,645,608,-37,37,1
"D07NV",142,358,"1200x900",800,1,600,400,"False",263,635,218,-417,417,0
"D07NV",143,567,"1200x900",1000,1,600,400,"True",655,297,287,-10,10,1
"D07NV",144,420,"1200x900",800,2,600,400,"True",519,223,214,-9,9,0
"D07NV",145,418,"1200x900",800,2,600,400,"False",754,507,228,-279,279,0
"D07NV",146,314,"1200x900",800,1,600,400,"True",277,616,579,-37,37,1
"D07NV",147,275,"1200x900",800,0,600,400,"False",120,594,516,-78,78,0
"D07NV",148,575,"1200x900",1000,1,600,400,"False",272,693,587,-106,106,0
"D07NV",149,405,"1200x900",800,2,600,400,"False",790,307,578,271,271,0
"D07NV",150,416,"1200x900",800,2,600,400,"False",748,617,519,-98,98,0
"D07NV",151,467,"1200x900",1000,0,600,400,"True",74,712,709,-3,3,1
"D07NV",152,292,"1200x900",800,1,600,400,"False",88,565,850,285,285,0
"D07NV",153,325,"1200x900",800,1,600,400,"False",105,394,91,-303,303,0
"D07NV",154,330,"1200x900",800,1,600,400,"False",759,301,117,-184,184,1
"D07NV",155,122,"1200x900",600,1,600,400,"False",817,709,628,-81,81,0
"D07NV",156,15,"1200x900",600,0,600,400,"True",473,352,355,3,3,1
"D07NV",157,262,"1200x900",800,0,600,400,"False",196,481,602,121,121,1
"D07NV",158,64,"1200x900",600,0,600,400,"True",102,339,401,62,62,0
"D07NV",159,204,"1200x900",600,2,600,400,"True",1053,432,400,-32,32,0
"D07NV",161,522,"1200x900",1000,1,600,400,"False",223,379,850,471,471,0
"D07NV",162,442,"1200x900",1000,0,600,400,"False",87,183,285,102,102,1
"D07NV",163,260,"1200x900",800,0,600,400,"True",103,525,524,-1,1,1
"D07NV",164,423,"1200x900",800,2,600,400,"True",1051,710,611,-99,99,1
"D07NV",165,279,"1200x900",800,0,600,400,"False",252,202,314,112,112,1
"D07NV",166,356,"1200x900",800,1,600,400,"False",123,484,329,-155,155,0
"D07NV",167,496,"1200x900",1000,0,600,400,"True",70,639,634,-5,5,1
"D07NV",168,188,"1200x900",600,2,600,400,"False",900,195,501,306,306,0
"D07NV",169,112,"1200x900",600,1,600,400,"True",681,490,458,-32,32,0
"D07NV",170,160,"1200x900",600,2,600,400,"False",863,606,275,-331,331,0
"D07NV",171,610,"1200x900",1000,2,600,400,"True",702,293,333,40,40,0
"D07NV",172,552,"1200x900",1000,1,600,400,"True",255,412,342,-70,70,0
"D07NV",173,516,"1200x900",1000,1,600,400,"True",440,559,558,-1,1,0
"D07NV",174,197,"1200x900",600,2,600,400,"False",903,212,476,264,264,0
"D07NV",175,241,"1200x900",800,0,600,400,"True",129,227,283,56,56,1
"D07NV",176,497,"1200x900",1000,0,600,400,"True",106,696,634,-62,62,1
"D07NV",179,13,"1200x900",600,0,600,400,"True",296,211,223,12,12,1
"D07NV",180,250,"1200x900",800,0,600,400,"False",290,248,349,101,101,1
"D07NV",181,386,"1200x900",800,2,600,400,"False",774,301,233,-68,68,0
"D07NV",182,417,"1200x900",800,2,600,400,"True",750,280,318,38,38,0
"D07NV",183,162,"1200x900",600,2,600,400,"True",849,279,305,26,26,0
"D07NV",184,490,"1200x900",1000,0,600,400,"False",114,183,246,63,63,1
"D07NV",186,111,"1200x900",600,1,600,400,"True",922,552,513,-39,39,1
"D07NV",188,191,"1200x900",600,2,600,400,"True",962,396,388,-8,8,0
"D07NV",189,306,"1200x900",800,1,600,400,"False",164,524,387,-137,137,0
"D07NV",190,548,"1200x900",1000,1,600,400,"True",103,278,290,12,12,0
"D07NV",191,224,"1200x900",800,0,600,400,"True",161,474,504,30,30,1
"D07NV",192,183,"1200x900",600,2,600,400,"False",927,289,540,251,251,0
"D07NV",193,584,"1200x900",1000,2,600,400,"False",731,413,539,126,126,0
"D07NV",194,484,"1200x900",1000,0,600,400,"False",100,223,349,126,126,1
"D07NV",195,506,"1200x900",1000,1,600,400,"True",559,567,522,-45,45,1
"D07NV",196,281,"1200x900",800,0,600,400,"True",112,611,660,49,49,1
"D07NV",197,556,"1200x900",1000,1,600,400,"False",415,420,615,195,195,0
"D07NV",198,203,"1200x900",600,2,600,400,"False",938,603,315,-288,288,0
"D07NV",199,636,"1200x900",1000,2,600,400,"False",575,583,398,-185,185,0
"D07NV",200,582,"1200x900",1000,2,600,400,"False",554,347,536,189,189,0
"D07NV",201,625,"1200x900",1000,2,600,400,"False",279,228,484,256,256,0
"D07NV",202,212,"1200x900",600,2,600,400,"False",841,206,362,156,156,0
"D07NV",203,483,"1200x900",1000,0,600,400,"False",93,191,262,71,71,1
"D07NV",204,586,"1200x900",1000,2,600,400,"False",802,262,593,331,331,0
"D07NV",205,31,"1200x900",600,0,600,400,"True",365,338,373,35,35,1
"D07NV",206,11,"1200x900",600,0,600,400,"True",372,670,647,-23,23,1
"D07NV",207,125,"1200x900",600,1,600,400,"True",750,531,497,-34,34,0
"D07NV",208,477,"1200x900",1000,0,600,400,"True",88,640,652,12,12,1
"D07NV",209,221,"1200x900",800,0,600,400,"True",132,520,542,22,22,1
"D07NV",210,12,"1200x900",600,0,600,400,"True",365,336,306,-30,30,1
"D07NV",211,635,"1200x900",1000,2,600,400,"True",833,402,488,86,86,0
"D07NV",212,77,"1200x900",600,1,600,400,"False",780,525,387,-138,138,0
"D07NV",213,100,"1200x900",600,1,600,400,"False",453,511,285,-226,226,0
"D07NV",214,568,"1200x900",1000,1,600,400,"True",286,475,392,-83,83,1
"D07NV",215,470,"1200x900",1000,0,600,400,"True",91,666,664,-2,2,1
"D07NV",216,216,"1200x900",600,2,600,400,"True",1029,286,262,-24,24,0
"D07NV",217,642,"1200x900",1000,2,600,400,"False",776,316,454,138,138,0
"D07NV",218,294,"1200x900",800,1,600,400,"False",262,287,383,96,96,0
"D07NV",219,57,"1200x900",600,0,600,400,"True",354,508,461,-47,47,1
"D07NV",220,86,"1200x900",600,1,600,400,"True",692,388,380,-8,8,1
"D07NV",221,161,"1200x900",600,2,600,400,"True",939,553,480,-73,73,0
"D07NV",222,588,"1200x900",1000,2,600,400,"False",585,350,279,-71,71,0
"D07NV",223,355,"1200x900",800,1,600,400,"False",77,386,444,58,58,0
"D07NV",224,381,"1200x900",800,2,600,400,"True",705,408,421,13,13,0
"D07NV",225,585,"1200x900",1000,2,600,400,"True",698,688,600,-88,88,1
"D07NV",226,527,"1200x900",1000,1,600,400,"True",565,601,601,0,0,0
"D07NV",227,76,"1200x900",600,1,600,400,"False",647,614,671,57,57,0
"D07NV",228,70,"1200x900",600,0,600,400,"True",309,703,712,9,9,1
"D07NV",229,3,"1200x900",600,0,600,400,"True",298,443,426,-17,17,1
"D07NV",230,128,"1200x900",600,1,600,400,"True",661,258,223,-35,35,1
"D07NV",231,509,"1200x900",1000,1,600,400,"False",509,434,518,84,84,0
"D07NV",232,627,"1200x900",1000,2,600,400,"True",760,510,519,9,9,0
"D07NV",233,101,"1200x900",600,1,600,400,"True",541,656,595,-61,61,0
"D07NV",234,225,"1200x900",800,0,600,400,"False",178,423,555,132,132,1
"D07NV",235,84,"1200x900",600,1,600,400,"True",144,184,246,62,62,0
"D07NV",236,88,"1200x900",600,1,600,400,"False",186,554,415,-139,139,0
"D07NV",237,463,"1200x900",1000,0,600,400,"False",115,693,598,-95,95,1
"D07NV",238,394,"1200x900",800,2,600,400,"False",847,292,572,280,280,0
"D07NV",239,446,"1200x900",1000,0,600,400,"True",72,298,290,-8,8,1
"D07NV",240,503,"1200x900",1000,0,600,400,"False",86,279,455,176,176,1
"D07NV",241,487,"1200x900",1000,0,600,400,"True",78,670,627,-43,43,1
"D07NV",242,187,"1200x900",600,2,600,400,"True",857,639,628,-11,11,0
"D07NV",243,323,"1200x900",800,1,600,400,"False",388,348,678,330,330,0
"D07NV",244,476,"1200x900",1000,0,600,400,"True",76,359,380,21,21,1
"D07NV",245,378,"1200x900",800,2,600,400,"False",1018,708,280,-428,428,0
"D07NV",246,46,"1200x900",600,0,600,400,"True",193,355,338,-17,17,1
"D07NV",247,145,"1200x900",600,2,600,400,"True",1004,630,601,-29,29,0
"D07NV",248,554,"1200x900",1000,1,600,400,"False",79,309,167,-142,142,1
"D07NV",249,518,"1200x900",1000,1,600,400,"False",583,717,440,-277,277,0
"D07NV",250,350,"1200x900",800,1,600,400,"False",182,566,402,-164,164,0
"D07NV",251,611,"1200x900",1000,2,600,400,"True",414,511,464,-47,47,0
"D07NV",252,142,"1200x900",600,1,600,400,"True",286,474,441,-33,33,0
"D07NV",253,493,"1200x900",1000,0,600,400,"True",80,582,611,29,29,1
"D07NV",254,26,"1200x900",600,0,600,400,"False",70,712,643,-69,69,0
"D07NV",255,309,"1200x900",800,1,600,400,"False",186,225,496,271,271,0
"D07NV",256,304,"1200x900",800,1,600,400,"False",667,605,359,-246,246,0
"D07NV",257,36,"1200x900",600,0,600,400,"True",128,346,386,40,40,1
"D07NV",258,179,"1200x900",600,2,600,400,"True",908,602,530,-72,72,0
"D07NV",259,430,"1200x900",800,2,600,400,"True",922,254,301,47,47,0
"D07NV",261,4,"1200x900",600,0,600,400,"True",602,200,219,19,19,1
"D07NV",263,502,"1200x900",1000,0,600,400,"True",111,639,678,39,39,1
"D07NV",264,255,"1200x900",800,0,600,400,"False",93,709,627,-82,82,1
"D07NV",265,63,"1200x900",600,0,600,400,"True",311,188,199,11,11,1
"D07NV",266,140,"1200x900",600,1,600,400,"True",700,523,504,-19,19,0
"D07NV",267,150,"1200x900",600,2,600,400,"True",897,345,393,48,48,0
"D07NV",268,124,"1200x900",600,1,600,400,"False",345,467,298,-169,169,0
"D07NV",269,118,"1200x900",600,1,600,400,"True",190,588,556,-32,32,0
"D07NV",270,529,"1200x900",1000,1,600,400,"False",267,412,261,-151,151,1
"D07NV",271,628,"1200x900",1000,2,600,400,"False",768,410,241,-169,169,0
"D07NV",272,235,"1200x900",800,0,600,400,"False",146,646,503,-143,143,1
"D07NV",273,10,"1200x900",600,0,600,400,"True",400,499,553,54,54,1
"D07NV",274,253,"1200x900",800,0,600,400,"False",177,424,258,-166,166,1
"D07NV",275,365,"1200x900",800,2,600,400,"False",1055,305,577,272,272,0
"D07NV",276,429,"1200x900",800,2,600,400,"False",682,692,425,-267,267,0
"D07NV",277,368,"1200x900",800,2,600,400,"False",778,515,403,-112,112,0
"D07NV",278,210,"1200x900",600,2,600,400,"False",835,506,568,62,62,0
"D07NV",279,561,"1200x900",1000,1,600,400,"False",231,406,492,86,86,0
"D07NV",280,359,"1200x900",800,1,600,400,"False",653,241,423,182,182,0
"D07NV",281,648,"1200x900",1000,2,600,400,"False",557,394,146,-248,248,0
"D07NV",282,302,"1200x900",800,1,600,400,"True",479,467,491,24,24,1
"D07NV",283,246,"1200x900",800,0,600,400,"True",196,418,387,-31,31,1
"D07NV",284,647,"1200x900",1000,2,600,400,"False",560,637,701,64,64,0
"D07NV",285,608,"1200x900",1000,2,600,400,"False",742,250,510,260,260,0
"D07NV",286,236,"1200x900",800,0,600,400,"False",162,350,439,89,89,1
"D07NV",287,263,"1200x900",800,0,600,400,"False",82,396,485,89,89,1
"D07NV",288,411,"1200x900",800,2,600,400,"False",805,361,563,202,202,0
"D07NV",289,531,"1200x900",1000,1,600,400,"False",233,362,524,162,162,0
"D07NV",290,226,"1200x900",800,0,600,400,"False",187,229,334,105,105,1
"D07NV",291,74,"1200x900",600,1,600,400,"True",115,358,306,-52,52,0
"D07NV",292,361,"1200x900",800,2,600,400,"True",931,328,307,-21,21,0
"D07NV",293,633,"1200x900",1000,2,600,400,"False",564,253,640,387,387,0
"D07NV",294,129,"1200x900",600,1,600,400,"False",859,482,316,-166,166,1
"D07NV",295,612,"1200x900",1000,2,600,400,"False",706,198,134,-64,64,0
"D07NV",296,312,"1200x900",800,1,600,400,"False",238,683,557,-126,126,0
"D07NV",297,324,"1200x900",800,1,600,400,"False",719,712,386,-326,326,1
"D07NV",298,271,"1200x900",800,0,600,400,"True",74,360,401,41,41,1
"D07NV",299,180,"1200x900",600,2,600,400,"False",929,270,141,-129,129,0
"D07NV",300,92,"1200x900",600,1,600,400,"False",624,605,714,109,109,0
"D07NV",301,332,"1200x900",800,1,600,400,"True",260,699,743,44,44,0
"D07NV",302,427,"1200x900",800,2,600,400,"True",812,380,339,-41,41,0
"D07NV",303,380,"1200x900",800,2,600,400,"True",942,228,242,14,14,0
"D07NV",304,276,"1200x900",800,0,600,400,"False",281,217,345,128,128,1
"D07NV",305,144,"1200x900",600,1,600,400,"False",718,371,461,90,90,0
"D07NV",306,538,"1200x900",1000,1,600,400,"False",308,457,359,-98,98,1
"D07NV",307,240,"1200x900",800,0,600,400,"False",330,656,553,-103,103,1
"D07NV",308,364,"1200x900",800,2,600,400,"False",1018,204,675,471,471,0
"D07NV",309,299,"1200x900",800,1,600,400,"False",779,274,454,180,180,0
"D07NV",310,404,"1200x900",800,2,600,400,"False",842,396,762,366,366,0
"D07NV",311,576,"1200x900",1000,1,600,400,"True",376,713,773,60,60,0
"D07NV",312,605,"1200x900",1000,2,600,400,"False",493,665,769,104,104,0
"D07NV",313,113,"1200x900",600,1,600,400,"True",897,657,630,-27,27,0
"D07NV",314,379,"1200x900",800,2,600,400,"False",994,325,781,456,456,0
"D07NV",315,270,"1200x900",800,0,600,400,"False",192,418,561,143,143,1
"D07NV",316,184,"1200x900",600,2,600,400,"False",1067,441,566,125,125,0
"D07NV",317,48,"1200x900",600,0,600,400,"True",323,645,704,59,59,1
"D07NV",318,558,"1200x900",1000,1,600,400,"False",72,464,673,209,209,1
"D07NV",319,583,"1200x900",1000,2,600,400,"True",949,284,373,89,89,1
"D07NV",320,494,"1200x900",1000,0,600,400,"False",127,692,591,-101,101,1
"D07NV",325,308,"1200x900",800,1,600,400,"False",437,425,659,234,234,0
"D07NV",326,498,"1200x900",1000,0,600,400,"False",100,260,506,246,246,1
"D07NV",327,533,"1200x900",1000,1,600,400,"True",355,483,454,-29,29,0
"D07NV",328,78,"1200x900",600,1,600,400,"False",885,684,477,-207,207,0
"D07NV",329,342,"1200x900",800,1,600,400,"False",677,204,380,176,176,0
"D07NV",330,50,"1200x900",600,0,600,400,"True",75,582,602,20,20,0
"D07NV",331,471,"1200x900",1000,0,600,400,"False",122,200,393,193,193,1
"D07NV",332,38,"1200x900",600,0,600,400,"True",120,628,616,-12,12,1
"D07NV",333,133,"1200x900",600,1,600,400,"False",345,551,612,61,61,0
"D07NV",334,563,"1200x900",1000,1,600,400,"True",201,696,631,-65,65,0
"D07NV",335,18,"1200x900",600,0,600,400,"True",400,318,357,39,39,1
"D07NV",336,403,"1200x900",800,2,600,400,"False",625,704,463,-241,241,0
"D07NV",337,354,"1200x900",800,1,600,400,"False",118,236,474,238,238,0
"D07NV",338,402,"1200x900",800,2,600,400,"False",878,234,410,176,176,0
"D07NV",339,545,"1200x900",1000,1,600,400,"False",358,562,490,-72,72,0
"D07NV",340,41,"1200x900",600,0,600,400,"True",370,452,445,-7,7,1
"D07NV",341,7,"1200x900",600,0,600,400,"False",431,654,539,-115,115,1
"D07NV",342,58,"1200x900",600,0,600,400,"False",353,655,565,-90,90,1
"D07NV",343,505,"1200x900",1000,1,600,400,"False",191,484,667,183,183,1
"D07NV",344,157,"1200x900",600,2,600,400,"False",1016,323,579,256,256,0
"D07NV",345,454,"1200x900",1000,0,600,400,"False",78,687,611,-76,76,1
"D07NV",346,165,"1200x900",600,2,600,400,"False",912,554,657,103,103,0
"D07NV",347,239,"1200x900",800,0,600,400,"False",114,231,404,173,173,1
"D07NV",349,258,"1200x900",800,0,600,400,"True",126,664,724,60,60,1
"D07NV",350,227,"1200x900",800,0,600,400,"False",196,551,450,-101,101,1
"D07NV",351,602,"1200x900",1000,2,600,400,"True",865,452,449,-3,3,0
"D07NV",353,510,"1200x900",1000,1,600,400,"False",486,338,130,-208,208,1
"D07NV",354,29,"1200x900",600,0,600,400,"True",385,533,571,38,38,1
"D07NV",355,536,"1200x900",1000,1,600,400,"False",580,213,307,94,94,0
"D07NV",356,553,"1200x900",1000,1,600,400,"False",116,712,303,-409,409,0
"D07NV",357,136,"1200x900",600,1,600,400,"False",264,205,712,507,507,0
"D07NV",358,526,"1200x900",1000,1,600,400,"False",497,710,790,80,80,0
"D07NV",359,623,"1200x900",1000,2,600,400,"False",636,527,271,-256,256,0
"D07NV",360,388,"1200x900",800,2,600,400,"False",930,320,697,377,377,0
"D07NV",361,458,"1200x900",1000,0,600,400,"True",78,624,604,-20,20,1
"D07NV",362,491,"1200x900",1000,0,600,400,"False",108,198,281,83,83,1
"D07NV",363,305,"1200x900",800,1,600,400,"False",471,716,549,-167,167,0
"D07NV",364,167,"1200x900",600,2,600,400,"False",956,241,603,362,362,0
"D07NV",365,351,"1200x900",800,1,600,400,"False",122,581,280,-301,301,0
"D07NV",366,28,"1200x900",600,0,600,400,"False",336,410,543,133,133,1
"D07NV",367,256,"1200x900",800,0,600,400,"True",192,656,720,64,64,1
"D07NV",368,72,"1200x900",600,0,600,400,"True",158,537,497,-40,40,0
"D07NV",369,591,"1200x900",1000,2,600,400,"False",698,336,202,-134,134,0
"D07NV",370,474,"1200x900",1000,0,600,400,"False",85,339,496,157,157,1
"D07NV",371,566,"1200x900",1000,1,600,400,"False",378,472,79,-393,393,1
"D07NV",372,297,"1200x900",800,1,600,400,"True",625,244,231,-13,13,0
"D07NV",373,311,"1200x900",800,1,600,400,"True",710,261,293,32,32,0
"D07NV",374,488,"1200x900",1000,0,600,400,"True",129,687,651,-36,36,1
"D07NV",375,336,"1200x900",800,1,600,400,"False",251,587,441,-146,146,0
"D07NV",376,465,"1200x900",1000,0,600,400,"False",85,203,335,132,132,1
"D07NV",378,158,"1200x900",600,2,600,400,"False",939,300,129,-171,171,0
"D07NV",379,614,"1200x900",1000,2,600,400,"False",823,563,178,-385,385,0
"D07NV",380,6,"1200x900",600,0,600,400,"False",217,689,583,-106,106,1
"D07NV",381,199,"1200x900",600,2,600,400,"False",992,467,235,-232,232,0
"D07NV",382,519,"1200x900",1000,1,600,400,"False",319,565,850,285,285,1
"D07NV",383,630,"1200x900",1000,2,600,400,"True",754,559,602,43,43,0
"D07NV",384,62,"1200x900",600,0,600,400,"True",345,346,388,42,42,1
"D07NV",385,607,"1200x900",1000,2,600,400,"False",900,573,685,112,112,1
"D07NV",386,135,"1200x900",600,1,600,400,"True",759,569,635,66,66,0
"D07NV",387,447,"1200x900",1000,0,600,400,"True",71,339,402,63,63,1
"D07NV",390,273,"1200x900",800,0,600,400,"True",180,309,296,-13,13,1
"D07NV",391,272,"1200x900",800,0,600,400,"True",200,181,208,27,27,1
"D07NV",392,171,"1200x900",600,2,600,400,"True",909,200,207,7,7,0
"D07NV",393,114,"1200x900",600,1,600,400,"True",183,697,721,24,24,0
"D07NV",394,24,"1200x900",600,0,600,400,"True",430,538,508,-30,30,1
"D07NV",395,597,"1200x900",1000,2,600,400,"False",352,239,470,231,231,0
"D07NV",396,327,"1200x900",800,1,600,400,"True",152,339,337,-2,2,0
"D07NV",397,637,"1200x900",1000,2,600,400,"True",750,460,417,-43,43,0
"D07NV",398,370,"1200x900",800,2,600,400,"True",874,336,345,9,9,0
"D07NV",399,318,"1200x900",800,1,600,400,"False",788,534,653,119,119,0
"D07NV",400,313,"1200x900",800,1,600,400,"False",588,421,496,75,75,0
"D07NV",401,214,"1200x900",600,2,600,400,"True",1046,305,358,53,53,0
"D07NV",402,123,"1200x900",600,1,600,400,"True",761,365,356,-9,9,1
"D07NV",403,617,"1200x900",1000,2,600,400,"False",294,180,392,212,212,0
"D07NV",404,619,"1200x900",1000,2,600,400,"False",803,247,393,146,146,0
"D07NV",405,220,"1200x900",800,0,600,400,"True",108,699,649,-50,50,1
"D07NV",406,106,"1200x900",600,1,600,400,"True",803,659,648,-11,11,1
"D07NV",407,192,"1200x900",600,2,600,400,"False",1064,320,470,150,150,0
"D07NV",408,393,"1200x900",800,2,600,400,"False",657,620,200,-420,420,0
"D07NV",409,73,"1200x900",600,1,600,400,"False",94,665,815,150,150,0
"D07NV",410,495,"1200x900",1000,0,600,400,"True",93,692,692,0,0,1
"D07NV",411,134,"1200x900",600,1,600,400,"True",300,188,226,38,38,0
"D07NV",412,156,"1200x900",600,2,600,400,"False",913,197,552,355,355,0
"D07NV",413,287,"1200x900",800,0,600,400,"True",120,567,591,24,24,1
"D07NV",414,181,"1200x900",600,2,600,400,"True",1018,223,293,70,70,0
"D07NV",415,205,"1200x900",600,2,600,400,"True",1021,504,553,49,49,0
"D07NV",416,555,"1200x900",1000,1,600,400,"True",444,556,554,-2,2,0
"D07NV",417,277,"1200x900",800,0,600,400,"True",140,310,291,-19,19,1
"D07NV",419,601,"1200x900",1000,2,600,400,"False",735,697,497,-200,200,0
"D07NV",420,317,"1200x900",800,1,600,400,"False",185,564,811,247,247,0
"D07NV",421,564,"1200x900",1000,1,600,400,"True",215,264,293,29,29,0
"D07NV",422,132,"1200x900",600,1,600,400,"False",333,185,77,-108,108,0
"D07NV",423,638,"1200x900",1000,2,600,400,"True",385,198,245,47,47,0
"D07NV",425,626,"1200x900",1000,2,600,400,"False",329,449,546,97,97,0
"D07NV",426,110,"1200x900",600,1,600,400,"False",776,550,780,230,230,1
"D07NV",427,173,"1200x900",600,2,600,400,"False",948,693,515,-178,178,0
"D07NV",428,42,"1200x900",600,0,600,400,"False",233,479,378,-101,101,0
"D07NV",429,375,"1200x900",800,2,600,400,"False",716,384,605,221,221,0
"D07NV",430,95,"1200x900",600,1,600,400,"True",749,425,363,-62,62,1
"D07NV",431,338,"1200x900",800,1,600,400,"True",813,253,309,56,56,1
"D07NV",432,435,"1200x900",1000,0,600,400,"False",119,200,461,261,261,1
"D07NV",433,228,"1200x900",800,0,600,400,"False",174,687,581,-106,106,1
"D07NV",434,169,"1200x900",600,2,600,400,"False",924,290,437,147,147,0
"D07NV",435,396,"1200x900",800,2,600,400,"False",678,663,538,-125,125,0
"D07NV",436,589,"1200x900",1000,2,600,400,"False",856,418,562,144,144,0
"D07NV",437,103,"1200x900",600,1,600,400,"True",528,320,389,69,69,1
"D07NV",438,401,"1200x900",800,2,600,400,"False",821,260,371,111,111,0
"D07NV",439,473,"1200x900",1000,0,600,400,"True",75,323,354,31,31,1
"D07NV",440,334,"1200x900",800,1,600,400,"False",481,665,570,-95,95,0
"D07NV",441,537,"1200x900",1000,1,600,400,"True",621,412,415,3,3,1
"D07NV",443,249,"1200x900",800,0,600,400,"False",126,306,380,74,74,1
"D07NV",444,209,"1200x900",600,2,600,400,"False",937,637,378,-259,259,0
"D07NV",445,414,"1200x900",800,2,600,400,"True",831,592,599,7,7,0
"D07NV",446,466,"1200x900",1000,0,600,400,"False",82,205,352,147,147,1
"D07NV",447,596,"1200x900",1000,2,600,400,"True",706,513,495,-18,18,0
"D07NV",448,310,"1200x900",800,1,600,400,"False",559,592,307,-285,285,0
"D07NV",449,288,"1200x900",800,0,600,400,"False",180,547,463,-84,84,1
"D07NV",450,283,"1200x900",800,0,600,400,"False",90,264,194,-70,70,1
"D07NV",451,186,"1200x900",600,2,600,400,"True",997,197,204,7,7,0
"D07NV",452,307,"1200x900",800,1,600,400,"True",716,247,251,4,4,0
"D07NV",453,268,"1200x900",800,0,600,400,"True",148,400,358,-42,42,1
"D07NV",454,59,"1200x900",600,0,600,400,"True",391,692,626,-66,66,1
"D07NV",455,238,"1200x900",800,0,600,400,"True",162,283,344,61,61,1
"D07NV",456,115,"1200x900",600,1,600,400,"False",545,307,85,-222,222,0
"D07NV",457,641,"1200x900",1000,2,600,400,"False",897,272,675,403,403,0
"D07NV",458,40,"1200x900",600,0,600,400,"True",143,513,568,55,55,0
"D07NV",459,434,"1200x900",1000,0,600,400,"False",89,657,443,-214,214,1
"D07NV",460,251,"1200x900",800,0,600,400,"False",88,352,440,88,88,1
"D07NV",461,109,"1200x900",600,1,600,400,"False",691,589,486,-103,103,0
"D07NV",462,360,"1200x900",800,1,600,400,"False",203,608,775,167,167,0
"D07NV",463,569,"1200x900",1000,1,600,400,"False",494,720,292,-428,428,0
"D07NV",464,119,"1200x900",600,1,600,400,"True",168,563,621,58,58,0
"D07NV",465,193,"1200x900",600,2,600,400,"True",874,588,616,28,28,0
"D07NV",466,592,"1200x900",1000,2,600,400,"False",492,392,596,204,204,0
"D07NV",467,30,"1200x900",600,0,600,400,"True",107,353,377,24,24,0
"D07NV",468,341,"1200x900",800,1,600,400,"True",735,632,710,78,78,1
"D07NV",469,320,"1200x900",800,1,600,400,"False",644,376,571,195,195,0
"D07NV",470,176,"1200x900",600,2,600,400,"True",1033,281,295,14,14,0
"D07NV",471,33,"1200x900",600,0,600,400,"True",198,533,466,-67,67,1
"D07NV",472,448,"1200x900",1000,0,600,400,"True",107,641,694,53,53,1
"D07NV",473,532,"1200x900",1000,1,600,400,"False",215,207,432,225,225,0
"D07NV",474,544,"1200x900",1000,1,600,400,"False",602,620,528,-92,92,0
"D07NV",475,565,"1200x900",1000,1,600,400,"False",451,562,633,71,71,0
"D07NV",476,315,"1200x900",800,1,600,400,"False",105,211,125,-86,86,0
"D07NV",477,643,"1200x900",1000,2,600,400,"False",740,325,169,-156,156,0
"D07NV",478,194,"1200x900",600,2,600,400,"True",896,236,239,3,3,0
"D07NV",479,620,"1200x900",1000,2,600,400,"False",832,649,183,-466,466,0
"D07NV",480,82,"1200x900",600,1,600,400,"False",108,213,59,-154,154,0
"D07NV",481,247,"1200x900",800,0,600,400,"True",160,424,350,-74,74,1
"D07NV",482,39,"1200x900",600,0,600,400,"False",210,609,452,-157,157,0
"D07NV",483,499,"1200x900",1000,0,600,400,"False",93,271,387,116,116,1
"D07NV",484,501,"1200x900",1000,0,600,400,"True",96,323,386,63,63,1
"D07NV",485,369,"1200x900",800,2,600,400,"False",903,594,757,163,163,0
"D07NV",486,521,"1200x900",1000,1,600,400,"False",111,303,50,-253,253,1
"D07NV",487,399,"1200x900",800,2,600,400,"False",603,602,466,-136,136,0
"D07NV",488,17,"1200x900",600,0,600,400,"True",402,496,549,53,53,1
"D07NV",489,222,"1200x900",800,0,600,400,"False",152,206,366,160,160,1
"D07NV",490,120,"1200x900",600,1,600,400,"True",690,655,641,-14,14,0
"D07NV",491,629,"1200x900",1000,2,600,400,"False",681,257,696,439,439,0
"D07NV",492,415,"1200x900",800,2,600,400,"True",823,684,634,-50,50,0
"D07NV",493,219,"1200x900",800,0,600,400,"True",202,502,549,47,47,1
"D07NV",494,578,"1200x900",1000,2,600,400,"False",966,276,679,403,403,0
"D07NV",495,245,"1200x900",800,0,600,400,"False",296,235,299,64,64,1
"D07NV",496,201,"1200x900",600,2,600,400,"False",1005,462,282,-180,180,0
"D07NV",497,524,"1200x900",1000,1,600,400,"False",534,470,673,203,203,0
"D07NV",498,175,"1200x900",600,2,600,400,"True",1028,432,443,11,11,0
"D07NV",499,523,"1200x900",1000,1,600,400,"False",339,318,464,146,146,0
"D07NV",500,303,"1200x900",800,1,600,400,"True",241,431,463,32,32,0
"D07NV",501,147,"1200x900",600,2,600,400,"False",942,418,325,-93,93,0
"D07NV",502,363,"1200x900",800,2,600,400,"False",800,218,405,187,187,0
"D07NV",503,233,"1200x900",800,0,600,400,"True",164,700,672,-28,28,1
"D07NV",505,390,"1200x900",800,2,600,400,"True",982,674,704,30,30,1
"D07NV",506,93,"1200x900",600,1,600,400,"False",139,540,688,148,148,0
"D07NV",508,631,"1200x900",1000,2,600,400,"False",699,479,622,143,143,0
"D07NV",509,94,"1200x900",600,1,600,400,"False",729,482,557,75,75,0
"D07NV",510,340,"1200x900",800,1,600,400,"False",226,240,529,289,289,0
"D07NV",511,646,"1200x900",1000,2,600,400,"False",829,227,385,158,158,1
"D07NV",512,163,"1200x900",600,2,600,400,"True",1046,665,670,5,5,0
"D07NV",513,286,"1200x900",800,0,600,400,"True",105,378,357,-21,21,1
"D07NV",514,373,"1200x900",800,2,600,400,"False",694,326,466,140,140,0
"D07NV",515,5,"1200x900",600,0,600,400,"True",228,587,620,33,33,0
"D07NV",516,441,"1200x900",1000,0,600,400,"True",85,684,680,-4,4,1
"D07NV",517,543,"1200x900",1000,1,600,400,"False",88,202,445,243,243,0
"D07NV",518,542,"1200x900",1000,1,600,400,"False",304,401,129,-272,272,0
"D07NV",519,164,"1200x900",600,2,600,400,"False",1051,268,213,-55,55,0
"D07NV",520,348,"1200x900",800,1,600,400,"True",764,294,332,38,38,0
"D07NV",521,259,"1200x900",800,0,600,400,"True",156,180,199,19,19,1
"D07NV",522,541,"1200x900",1000,1,600,400,"False",339,478,336,-142,142,0
"D07NV",523,374,"1200x900",800,2,600,400,"True",755,450,422,-28,28,0
"D07NV",524,475,"1200x900",1000,0,600,400,"False",101,715,599,-116,116,1
"D07NV",525,75,"1200x900",600,1,600,400,"True",635,558,559,1,1,0
"D07NV",526,99,"1200x900",600,1,600,400,"True",811,407,375,-32,32,0
"D07NV",527,190,"1200x900",600,2,600,400,"True",977,238,202,-36,36,0
"D07NV",528,32,"1200x900",600,0,600,400,"False",152,563,497,-66,66,1
"D07NV",529,440,"1200x900",1000,0,600,400,"True",71,237,225,-12,12,1
"D07NV",530,153,"1200x900",600,2,600,400,"False",1037,601,471,-130,130,0
"D07NV",531,472,"1200x900",1000,0,600,400,"True",77,685,729,44,44,1
"D07NV",532,196,"1200x900",600,2,600,400,"False",1030,397,332,-65,65,0
"D07NV",533,419,"1200x900",800,2,600,400,"False",769,351,599,248,248,0
"D07NV",534,367,"1200x900",800,2,600,400,"False",613,464,333,-131,131,0
"D07NV",535,534,"1200x900",1000,1,600,400,"False",328,504,695,191,191,1
"D07NV",536,23,"1200x900",600,0,600,400,"True",308,463,424,-39,39,1
"D07NV",537,345,"1200x900",800,1,600,400,"False",841,566,624,58,58,1
"D07NV",538,528,"1200x900",1000,1,600,400,"False",839,227,568,341,341,1
"D07NV",539,177,"1200x900",600,2,600,400,"True",912,236,282,46,46,0
"D07NV",540,343,"1200x900",800,1,600,400,"False",407,557,354,-203,203,0
"D07NV",541,479,"1200x900",1000,0,600,400,"True",74,705,716,11,11,1
"D07NV",542,237,"1200x900",800,0,600,400,"False",204,481,596,115,115,1
"D07NV",544,166,"1200x900",600,2,600,400,"False",896,274,488,214,214,0
"D07NV",545,391,"1200x900",800,2,600,400,"False",895,521,279,-242,242,0
"D07NV",546,329,"1200x900",800,1,600,400,"False",517,239,312,73,73,0
"D07NV",547,117,"1200x900",600,1,600,400,"False",711,456,252,-204,204,0
"D07NV",548,20,"1200x900",600,0,600,400,"True",204,545,600,55,55,1
"D07NV",549,242,"1200x900",800,0,600,400,"True",117,448,475,27,27,1
"D07NV",550,376,"1200x900",800,2,600,400,"True",788,275,340,65,65,0
"D07NV",551,573,"1200x900",1000,1,600,400,"False",486,615,471,-144,144,0
"D07NV",552,264,"1200x900",800,0,600,400,"True",198,660,615,-45,45,1
"D07NV",553,535,"1200x900",1000,1,600,400,"True",372,410,471,61,61,0
"D07NV",554,438,"1200x900",1000,0,600,400,"True",77,713,675,-38,38,1
"D07NV",555,90,"1200x900",600,1,600,400,"True",560,474,434,-40,40,0
"D07NV",556,159,"1200x900",600,2,600,400,"True",992,309,266,-43,43,0
"D07NV",557,432,"1200x900",800,2,600,400,"False",792,380,106,-274,274,0
"D07NV",558,480,"1200x900",1000,0,600,400,"True",100,231,238,7,7,1
"D07NV",559,266,"1200x900",800,0,600,400,"True",126,303,322,19,19,1
"D07NV",560,195,"1200x900",600,2,600,400,"True",942,249,299,50,50,0
"D07NV",561,126,"1200x900",600,1,600,400,"True",849,354,287,-67,67,0
"D07NV",562,408,"1200x900",800,2,600,400,"False",758,567,448,-119,119,0
"D07NV",563,520,"1200x900",1000,1,600,400,"False",564,260,359,99,99,0
"D07NV",564,217,"1200x900",800,0,600,400,"True",85,573,577,4,4,1
"D07NV",565,47,"1200x900",600,0,600,400,"True",303,499,535,36,36,1
"D07NV",566,392,"1200x900",800,2,600,400,"True",1031,618,649,31,31,0
"D07NV",567,295,"1200x900",800,1,600,400,"True",471,334,300,-34,34,0
"D07NV",568,464,"1200x900",1000,0,600,400,"False",82,222,334,112,112,1
"D07NV",569,606,"1200x900",1000,2,600,400,"True",653,627,678,51,51,0
"D07NV",570,344,"1200x900",800,1,600,400,"False",589,408,502,94,94,0
"D07NV",571,170,"1200x900",600,2,600,400,"False",996,468,222,-246,246,0
"D07NV",572,44,"1200x900",600,0,600,400,"True",305,554,573,19,19,1
"D07NV",574,45,"1200x900",600,0,600,400,"True",487,678,668,-10,10,1
"D07NV",575,211,"1200x900",600,2,600,400,"False",986,407,315,-92,92,0
"D07NV",576,261,"1200x900",800,0,600,400,"True",86,713,722,9,9,1
"D07NV",577,481,"1200x900",1000,0,600,400,"False",80,185,343,158,158,1
"D07NV",578,296,"1200x900",800,1,600,400,"True",89,279,347,68,68,0
"D07NV",579,422,"1200x900",800,2,600,400,"False",712,558,440,-118,118,0
"D07NV",580,143,"1200x900",600,1,600,400,"True",479,284,302,18,18,1
"D07NV",581,443,"1200x900",1000,0,600,400,"True",99,651,619,-32,32,1
"D07NV",583,530,"1200x900",1000,1,600,400,"False",584,405,228,-177,177,1
"D07NV",584,557,"1200x900",1000,1,600,400,"False",677,505,659,154,154,1
"D07NV",585,289,"1200x900",800,1,600,400,"False",421,703,577,-126,126,1
"D07NV",586,151,"1200x900",600,2,600,400,"True",828,680,723,43,43,0
"D07NV",587,517,"1200x900",1000,1,600,400,"True",548,182,211,29,29,0
"D07NV",588,87,"1200x900",600,1,600,400,"True",231,604,539,-65,65,0
"D07NV",589,52,"1200x900",600,0,600,400,"True",171,188,235,47,47,0
"D07NV",590,453,"1200x900",1000,0,600,400,"True",71,393,374,-19,19,1
"D07NV",591,60,"1200x900",600,0,600,400,"True",365,213,241,28,28,1
"D07NV",592,594,"1200x900",1000,2,600,400,"False",537,637,408,-229,229,0
"D07NV",593,599,"1200x900",1000,2,600,400,"False",316,570,493,-77,77,0
"D07NV",594,69,"1200x900",600,0,600,400,"False",322,268,379,111,111,0
"D07NV",595,16,"1200x900",600,0,600,400,"True",297,514,455,-59,59,1
"D07NV",596,500,"1200x900",1000,0,600,400,"False",105,700,598,-102,102,1
"D07NV",597,581,"1200x900",1000,2,600,400,"True",310,357,383,26,26,0
"D07NV",598,346,"1200x900",800,1,600,400,"False",269,635,850,215,215,0
"D07NV",599,248,"1200x900",800,0,600,400,"True",94,240,165,-75,75,1
"D07NV",600,37,"1200x900",600,0,600,400,"True",258,403,385,-18,18,1
"D07NV",601,282,"1200x900",800,0,600,400,"False",109,246,332,86,86,1
"D07NV",602,215,"1200x900",600,2,600,400,"False",939,596,662,66,66,0
"D07NV",603,377,"1200x900",800,2,600,400,"True",683,388,361,-27,27,0
"D07NV",604,127,"1200x900",600,1,600,400,"False",309,691,850,159,159,0
"D07NV",605,208,"1200x900",600,2,600,400,"False",946,399,615,216,216,0
"D07NV",606,421,"1200x900",800,2,600,400,"False",898,394,161,-233,233,0
"D07NV",607,206,"1200x900",600,2,600,400,"True",975,223,262,39,39,0
"D07NV",608,570,"1200x900",1000,1,600,400,"False",315,352,521,169,169,0
"D07NV",609,600,"1200x900",1000,2,600,400,"False",765,207,589,382,382,0
"D07NV",610,436,"1200x900",1000,0,600,400,"False",82,617,513,-104,104,1
"D07NV",611,146,"1200x900",600,2,600,400,"False",989,492,180,-312,312,0
"D07NV",612,137,"1200x900",600,1,600,400,"False",789,577,497,-80,80,0
"D07NV",614,200,"1200x900",600,2,600,400,"False",897,302,487,185,185,0
"D07NV",615,284,"1200x900",800,0,600,400,"True",135,293,360,67,67,1
"D07NV",616,298,"1200x900",800,1,600,400,"False",311,457,238,-219,219,0
"D07NV",617,25,"1200x900",600,0,600,400,"True",263,403,420,17,17,1
"D07NV",618,400,"1200x900",800,2,600,400,"False",733,297,413,116,116,0
"D07NV",619,347,"1200x900",800,1,600,400,"False",757,295,576,281,281,1
"D07NV",620,97,"1200x900",600,1,600,400,"True",760,643,675,32,32,1
"D07NV",621,352,"1200x900",800,1,600,400,"False",235,717,558,-159,159,0
"D07NV",622,559,"1200x900",1000,1,600,400,"True",641,244,270,26,26,0
"D07NV",623,267,"1200x900",800,0,600,400,"True",145,665,643,-22,22,1
"D07NV",624,439,"1200x900",1000,0,600,400,"False",110,229,408,179,179,1
"D07NV",625,580,"1200x900",1000,2,600,400,"False",651,267,402,135,135,0
"D07NV",626,424,"1200x900",800,2,600,400,"False",903,545,270,-275,275,0
"D07NV",627,357,"1200x900",800,1,600,400,"False",109,594,392,-202,202,0
"D07NV",628,9,"1200x900",600,0,600,400,"False",509,654,565,-89,89,1
"D07NV",629,387,"1200x900",800,2,600,400,"False",990,444,568,124,124,0
"D07NV",630,577,"1200x900",1000,2,600,400,"True",455,420,491,71,71,0
"D07NV",631,515,"1200x900",1000,1,600,400,"False",307,217,382,165,165,0
"D07NV",632,68,"1200x900",600,0,600,400,"False",165,367,300,-67,67,0
"D07NV",633,492,"1200x900",1000,0,600,400,"False",76,692,603,-89,89,1
"D07NV",634,595,"1200x900",1000,2,600,400,"False",687,640,426,-214,214,0
"D07NV",635,349,"1200x900",800,1,600,400,"False",402,665,772,107,107,0
"D07NV",636,622,"1200x900",1000,2,600,400,"False",307,683,487,-196,196,0
"D07NV",637,278,"1200x900",800,0,600,400,"True",251,711,763,52,52,1
"D07NV",638,645,"1200x900",1000,2,600,400,"True",619,396,458,62,62,0
"D07NV",639,634,"1200x900",1000,2,600,400,"False",735,313,582,269,269,0
"D07NV",640,83,"1200x900",600,1,600,400,"True",763,568,588,20,20,1
"D07NV",641,257,"1200x900",800,0,600,400,"False",97,219,356,137,137,1
"D07NV",642,54,"1200x900",600,0,600,400,"True",474,564,570,6,6,1
"D07NV",644,572,"1200x900",1000,1,600,400,"False",302,260,346,86,86,0
"D07NV",645,587,"1200x900",1000,2,600,400,"False",741,686,274,-412,412,0
"D07NV",646,218,"1200x900",800,0,600,400,"True",106,397,451,54,54,1
"D07NV",647,398,"1200x900",800,2,600,400,"True",944,698,654,-44,44,0
"D07NV",648,550,"1200x900",1000,1,600,400,"True",301,459,437,-22,22,0
"D08JJ",1,636,"1200x900",1000,2,600,400,"False",575,583,211,-372,372,0
"D08JJ",2,530,"1200x900",1000,1,600,400,"True",584,405,397,-8,8,1
"D08JJ",3,187,"1200x900",600,2,600,400,"False",857,639,308,-331,331,0
"D08JJ",4,453,"1200x900",1000,0,600,400,"False",71,393,161,-232,232,1
"D08JJ",5,552,"1200x900",1000,1,600,400,"True",255,412,449,37,37,0
"D08JJ",6,177,"1200x900",600,2,600,400,"True",912,236,300,64,64,0
"D08JJ",7,215,"1200x900",600,2,600,400,"False",939,596,299,-297,297,0
"D08JJ",8,439,"1200x900",1000,0,600,400,"False",110,229,96,-133,133,1
"D08JJ",9,550,"1200x900",1000,1,600,400,"False",301,459,632,173,173,0
"D08JJ",10,219,"1200x900",800,0,600,400,"True",202,502,433,-69,69,1
"D08JJ",11,142,"1200x900",600,1,600,400,"True",286,474,494,20,20,0
"D08JJ",12,521,"1200x900",1000,1,600,400,"False",111,303,476,173,173,1
"D08JJ",13,239,"1200x900",800,0,600,400,"False",114,231,129,-102,102,1
"D08JJ",14,62,"1200x900",600,0,600,400,"False",345,346,275,-71,71,1
"D08JJ",15,429,"1200x900",800,2,600,400,"False",682,692,108,-584,584,0
"D08JJ",16,562,"1200x900",1000,1,600,400,"True",347,540,566,26,26,0
"D08JJ",17,98,"1200x900",600,1,600,400,"True",625,530,513,-17,17,0
"D08JJ",18,118,"1200x900",600,1,600,400,"True",190,588,620,32,32,0
"D08JJ",19,36,"1200x900",600,0,600,400,"True",128,346,310,-36,36,1
"D08JJ",20,188,"1200x900",600,2,600,400,"False",900,195,379,184,184,0
"D08JJ",21,461,"1200x900",1000,0,600,400,"False",95,711,576,-135,135,1
"D08JJ",22,258,"1200x900",800,0,600,400,"True",126,664,629,-35,35,1
"D08JJ",23,393,"1200x900",800,2,600,400,"False",657,620,504,-116,116,0
"D08JJ",24,267,"1200x900",800,0,600,400,"True",145,665,604,-61,61,1
"D08JJ",25,243,"1200x900",800,0,600,400,"True",114,332,336,4,4,1
"D08JJ",26,593,"1200x900",1000,2,600,400,"False",246,719,320,-399,399,0
"D08JJ",27,320,"1200x900",800,1,600,400,"True",644,376,417,41,41,0
"D08JJ",28,362,"1200x900",800,2,600,400,"False",819,338,221,-117,117,0
"D08JJ",29,198,"1200x900",600,2,600,400,"False",976,500,258,-242,242,0
"D08JJ",30,179,"1200x900",600,2,600,400,"False",908,602,458,-144,144,0
"D08JJ",31,617,"1200x900",1000,2,600,400,"False",294,180,445,265,265,0
"D08JJ",32,144,"1200x900",600,1,600,400,"False",718,371,449,78,78,0
"D08JJ",33,499,"1200x900",1000,0,600,400,"False",93,271,188,-83,83,1
"D08JJ",34,592,"1200x900",1000,2,600,400,"True",492,392,416,24,24,0
"D08JJ",35,197,"1200x900",600,2,600,400,"False",903,212,459,247,247,0
"D08JJ",36,204,"1200x900",600,2,600,400,"False",1053,432,231,-201,201,0
"D08JJ",37,438,"1200x900",1000,0,600,400,"False",77,713,584,-129,129,1
"D08JJ",38,391,"1200x900",800,2,600,400,"False",895,521,313,-208,208,0
"D08JJ",39,373,"1200x900",800,2,600,400,"True",694,326,362,36,36,0
"D08JJ",40,547,"1200x900",1000,1,600,400,"False",369,384,529,145,145,1
"D08JJ",41,264,"1200x900",800,0,600,400,"True",198,660,633,-27,27,1
"D08JJ",42,347,"1200x900",800,1,600,400,"False",757,295,650,355,355,1
"D08JJ",43,100,"1200x900",600,1,600,400,"False",453,511,283,-228,228,0
"D08JJ",44,566,"1200x900",1000,1,600,400,"True",378,472,420,-52,52,1
"D08JJ",45,608,"1200x900",1000,2,600,400,"True",742,250,291,41,41,0
"D08JJ",46,104,"1200x900",600,1,600,400,"True",448,584,553,-31,31,0
"D08JJ",47,427,"1200x900",800,2,600,400,"True",812,380,447,67,67,0
"D08JJ",48,83,"1200x900",600,1,600,400,"True",763,568,563,-5,5,1
"D08JJ",49,199,"1200x900",600,2,600,400,"True",992,467,417,-50,50,0
"D08JJ",50,595,"1200x900",1000,2,600,400,"False",687,640,364,-276,276,0
"D08JJ",51,113,"1200x900",600,1,600,400,"False",897,657,481,-176,176,0
"D08JJ",52,488,"1200x900",1000,0,600,400,"True",129,687,662,-25,25,1
"D08JJ",53,476,"1200x900",1000,0,600,400,"True",76,359,342,-17,17,1
"D08JJ",54,523,"1200x900",1000,1,600,400,"True",339,318,365,47,47,0
"D08JJ",55,570,"1200x900",1000,1,600,400,"True",315,352,417,65,65,0
"D08JJ",56,276,"1200x900",800,0,600,400,"True",281,217,277,60,60,1
"D08JJ",57,367,"1200x900",800,2,600,400,"False",613,464,241,-223,223,0
"D08JJ",58,31,"1200x900",600,0,600,400,"True",365,338,334,-4,4,1
"D08JJ",59,193,"1200x900",600,2,600,400,"False",874,588,421,-167,167,0
"D08JJ",60,49,"1200x900",600,0,600,400,"True",109,380,366,-14,14,0
"D08JJ",61,357,"1200x900",800,1,600,400,"False",109,594,653,59,59,0
"D08JJ",62,121,"1200x900",600,1,600,400,"False",884,364,556,192,192,0
"D08JJ",63,266,"1200x900",800,0,600,400,"True",126,303,264,-39,39,1
"D08JJ",64,434,"1200x900",1000,0,600,400,"False",89,657,537,-120,120,1
"D08JJ",65,235,"1200x900",800,0,600,400,"True",146,646,621,-25,25,1
"D08JJ",66,92,"1200x900",600,1,600,400,"False",624,605,707,102,102,0
"D08JJ",67,506,"1200x900",1000,1,600,400,"False",559,567,477,-90,90,1
"D08JJ",68,25,"1200x900",600,0,600,400,"True",263,403,387,-16,16,1
"D08JJ",69,111,"1200x900",600,1,600,400,"True",922,552,609,57,57,1
"D08JJ",70,52,"1200x900",600,0,600,400,"True",171,188,154,-34,34,0
"D08JJ",71,622,"1200x900",1000,2,600,400,"False",307,683,225,-458,458,0
"D08JJ",72,85,"1200x900",600,1,600,400,"False",434,347,584,237,237,0
"D08JJ",73,524,"1200x900",1000,1,600,400,"False",534,470,688,218,218,0
"D08JJ",74,61,"1200x900",600,0,600,400,"False",272,670,596,-74,74,1
"D08JJ",75,560,"1200x900",1000,1,600,400,"True",516,693,651,-42,42,0
"D08JJ",76,548,"1200x900",1000,1,600,400,"False",103,278,467,189,189,0
"D08JJ",77,8,"1200x900",600,0,600,400,"True",156,679,634,-45,45,0
"D08JJ",78,66,"1200x900",600,0,600,400,"True",155,673,676,3,3,0
"D08JJ",79,40,"1200x900",600,0,600,400,"True",143,513,575,62,62,0
"D08JJ",80,340,"1200x900",800,1,600,400,"False",226,240,483,243,243,0
"D08JJ",81,569,"1200x900",1000,1,600,400,"True",494,720,667,-53,53,0
"D08JJ",82,338,"1200x900",800,1,600,400,"False",813,253,133,-120,120,1
"D08JJ",83,594,"1200x900",1000,2,600,400,"False",537,637,282,-355,355,0
"D08JJ",84,497,"1200x900",1000,0,600,400,"True",106,696,671,-25,25,1
"D08JJ",85,99,"1200x900",600,1,600,400,"True",811,407,354,-53,53,0
"D08JJ",86,174,"1200x900",600,2,600,400,"True",998,457,480,23,23,0
"D08JJ",87,180,"1200x900",600,2,600,400,"False",929,270,423,153,153,0
"D08JJ",88,278,"1200x900",800,0,600,400,"False",251,711,570,-141,141,1
"D08JJ",89,541,"1200x900",1000,1,600,400,"False",339,478,617,139,139,0
"D08JJ",90,253,"1200x900",800,0,600,400,"True",177,424,454,30,30,1
"D08JJ",91,190,"1200x900",600,2,600,400,"True",977,238,221,-17,17,0
"D08JJ",92,502,"1200x900",1000,0,600,400,"False",111,639,449,-190,190,1
"D08JJ",93,277,"1200x900",800,0,600,400,"True",140,310,326,16,16,1
"D08JJ",94,109,"1200x900",600,1,600,400,"False",691,589,409,-180,180,0
"D08JJ",95,72,"1200x900",600,0,600,400,"True",158,537,525,-12,12,0
"D08JJ",96,257,"1200x900",800,0,600,400,"False",97,219,327,108,108,1
"D08JJ",97,28,"1200x900",600,0,600,400,"True",336,410,377,-33,33,1
"D08JJ",98,423,"1200x900",800,2,600,400,"False",1051,710,833,123,123,1
"D08JJ",99,292,"1200x900",800,1,600,400,"True",88,565,565,0,0,0
"D08JJ",100,15,"1200x900",600,0,600,400,"False",473,352,432,80,80,1
"D08JJ",101,226,"1200x900",800,0,600,400,"False",187,229,318,89,89,1
"D08JJ",102,513,"1200x900",1000,1,600,400,"False",235,602,357,-245,245,0
"D08JJ",103,232,"1200x900",800,0,600,400,"True",84,511,495,-16,16,1
"D08JJ",104,549,"1200x900",1000,1,600,400,"True",657,366,424,58,58,0
"D08JJ",105,75,"1200x900",600,1,600,400,"True",635,558,546,-12,12,0
"D08JJ",106,385,"1200x900",800,2,600,400,"True",740,456,498,42,42,0
"D08JJ",107,623,"1200x900",1000,2,600,400,"False",636,527,395,-132,132,0
"D08JJ",108,533,"1200x900",1000,1,600,400,"True",355,483,414,-69,69,0
"D08JJ",109,73,"1200x900",600,1,600,400,"True",94,665,625,-40,40,0
"D08JJ",110,404,"1200x900",800,2,600,400,"True",842,396,391,-5,5,0
"D08JJ",111,619,"1200x900",1000,2,600,400,"False",803,247,424,177,177,0
"D08JJ",112,508,"1200x900",1000,1,600,400,"True",596,485,454,-31,31,0
"D08JJ",113,60,"1200x900",600,0,600,400,"True",365,213,254,41,41,1
"D08JJ",114,81,"1200x900",600,1,600,400,"True",696,225,253,28,28,0
"D08JJ",115,648,"1200x900",1000,2,600,400,"False",557,394,333,-61,61,0
"D08JJ",116,126,"1200x900",600,1,600,400,"False",849,354,471,117,117,0
"D08JJ",117,355,"1200x900",800,1,600,400,"False",77,386,451,65,65,0
"D08JJ",118,561,"1200x900",1000,1,600,400,"False",231,406,690,284,284,0
"D08JJ",119,626,"1200x900",1000,2,600,400,"False",329,449,606,157,157,0
"D08JJ",120,462,"1200x900",1000,0,600,400,"True",102,672,657,-15,15,1
"D08JJ",121,191,"1200x900",600,2,600,400,"True",962,396,428,32,32,0
"D08JJ",122,231,"1200x900",800,0,600,400,"False",251,718,638,-80,80,1
"D08JJ",123,441,"1200x900",1000,0,600,400,"False",85,684,586,-98,98,1
"D08JJ",124,410,"1200x900",800,2,600,400,"False",916,477,596,119,119,0
"D08JJ",125,308,"1200x900",800,1,600,400,"False",437,425,583,158,158,0
"D08JJ",126,65,"1200x900",600,0,600,400,"True",442,645,611,-34,34,1
"D08JJ",127,254,"1200x900",800,0,600,400,"True",136,583,581,-2,2,1
"D08JJ",128,319,"1200x900",800,1,600,400,"False",494,587,688,101,101,1
"D08JJ",129,50,"1200x900",600,0,600,400,"True",75,582,586,4,4,0
"D08JJ",130,295,"1200x900",800,1,600,400,"True",471,334,397,63,63,0
"D08JJ",131,411,"1200x900",800,2,600,400,"True",805,361,386,25,25,0
"D08JJ",132,242,"1200x900",800,0,600,400,"True",117,448,388,-60,60,1
"D08JJ",133,421,"1200x900",800,2,600,400,"False",898,394,295,-99,99,0
"D08JJ",134,151,"1200x900",600,2,600,400,"True",828,680,671,-9,9,0
"D08JJ",135,234,"1200x900",800,0,600,400,"False",72,344,414,70,70,1
"D08JJ",136,471,"1200x900",1000,0,600,400,"True",122,200,183,-17,17,1
"D08JJ",137,324,"1200x900",800,1,600,400,"False",719,712,400,-312,312,1
"D08JJ",138,154,"1200x900",600,2,600,400,"False",941,454,326,-128,128,0
"D08JJ",139,372,"1200x900",800,2,600,400,"False",833,620,452,-168,168,0
"D08JJ",140,80,"1200x900",600,1,600,400,"False",616,423,663,240,240,1
"D08JJ",141,211,"1200x900",600,2,600,400,"True",986,407,479,72,72,0
"D08JJ",142,44,"1200x900",600,0,600,400,"True",305,554,532,-22,22,1
"D08JJ",143,390,"1200x900",800,2,600,400,"False",982,674,742,68,68,1
"D08JJ",144,527,"1200x900",1000,1,600,400,"False",565,601,716,115,115,0
"D08JJ",145,105,"1200x900",600,1,600,400,"False",527,440,748,308,308,0
"D08JJ",146,389,"1200x900",800,2,600,400,"False",843,530,623,93,93,0
"D08JJ",147,452,"1200x900",1000,0,600,400,"False",97,273,376,103,103,1
"D08JJ",148,7,"1200x900",600,0,600,400,"False",431,654,538,-116,116,1
"D08JJ",149,596,"1200x900",1000,2,600,400,"False",706,513,645,132,132,0
"D08JJ",150,370,"1200x900",800,2,600,400,"False",874,336,245,-91,91,0
"D08JJ",151,79,"1200x900",600,1,600,400,"True",731,289,220,-69,69,0
"D08JJ",152,217,"1200x900",800,0,600,400,"False",85,573,508,-65,65,1
"D08JJ",153,136,"1200x900",600,1,600,400,"True",264,205,193,-12,12,0
"D08JJ",154,224,"1200x900",800,0,600,400,"True",161,474,483,9,9,1
"D08JJ",155,178,"1200x900",600,2,600,400,"False",1041,510,581,71,71,0
"D08JJ",156,97,"1200x900",600,1,600,400,"False",760,643,715,72,72,1
"D08JJ",157,361,"1200x900",800,2,600,400,"False",931,328,656,328,328,0
"D08JJ",158,591,"1200x900",1000,2,600,400,"False",698,336,421,85,85,0
"D08JJ",161,275,"1200x900",800,0,600,400,"False",120,594,475,-119,119,0
"D08JJ",162,535,"1200x900",1000,1,600,400,"False",372,410,266,-144,144,0
"D08JJ",163,141,"1200x900",600,1,600,400,"False",671,582,448,-134,134,0
"D08JJ",164,580,"1200x900",1000,2,600,400,"True",651,267,339,72,72,0
"D08JJ",165,110,"1200x900",600,1,600,400,"False",776,550,693,143,143,1
"D08JJ",166,69,"1200x900",600,0,600,400,"True",322,268,323,55,55,0
"D08JJ",167,426,"1200x900",800,2,600,400,"False",830,263,379,116,116,0
"D08JJ",168,18,"1200x900",600,0,600,400,"True",400,318,286,-32,32,1
"D08JJ",169,4,"1200x900",600,0,600,400,"True",602,200,216,16,16,1
"D08JJ",170,139,"1200x900",600,1,600,400,"False",192,695,357,-338,338,0
"D08JJ",171,465,"1200x900",1000,0,600,400,"True",85,203,260,57,57,1
"D08JJ",172,11,"1200x900",600,0,600,400,"True",372,670,644,-26,26,1
"D08JJ",173,1,"1200x900",600,0,600,400,"True",136,502,496,-6,6,0
"D08JJ",174,5,"1200x900",600,0,600,400,"True",228,587,557,-30,30,0
"D08JJ",175,41,"1200x900",600,0,600,400,"True",370,452,457,5,5,1
"D08JJ",176,13,"1200x900",600,0,600,400,"True",296,211,259,48,48,1
"D08JJ",177,366,"1200x900",800,2,600,400,"False",931,464,282,-182,182,0
"D08JJ",178,309,"1200x900",800,1,600,400,"False",186,225,335,110,110,0
"D08JJ",179,448,"1200x900",1000,0,600,400,"True",107,641,596,-45,45,1
"D08JJ",180,55,"1200x900",600,0,600,400,"True",211,305,279,-26,26,1
"D08JJ",181,181,"1200x900",600,2,600,400,"True",1018,223,270,47,47,0
"D08JJ",182,510,"1200x900",1000,1,600,400,"False",486,338,245,-93,93,1
"D08JJ",183,475,"1200x900",1000,0,600,400,"True",101,715,654,-61,61,1
"D08JJ",184,534,"1200x900",1000,1,600,400,"True",328,504,466,-38,38,1
"D08JJ",185,628,"1200x900",1000,2,600,400,"True",768,410,440,30,30,0
"D08JJ",186,537,"1200x900",1000,1,600,400,"True",621,412,453,41,41,1
"D08JJ",187,74,"1200x900",600,1,600,400,"True",115,358,353,-5,5,0
"D08JJ",188,369,"1200x900",800,2,600,400,"False",903,594,660,66,66,0
"D08JJ",189,416,"1200x900",800,2,600,400,"False",748,617,552,-65,65,0
"D08JJ",190,645,"1200x900",1000,2,600,400,"False",619,396,617,221,221,0
"D08JJ",191,606,"1200x900",1000,2,600,400,"False",653,627,536,-91,91,0
"D08JJ",192,605,"1200x900",1000,2,600,400,"False",493,665,528,-137,137,0
"D08JJ",193,525,"1200x900",1000,1,600,400,"False",123,690,591,-99,99,0
"D08JJ",194,565,"1200x900",1000,1,600,400,"False",451,562,655,93,93,0
"D08JJ",195,26,"1200x900",600,0,600,400,"True",70,712,707,-5,5,0
"D08JJ",196,408,"1200x900",800,2,600,400,"False",758,567,741,174,174,0
"D08JJ",197,229,"1200x900",800,0,600,400,"True",117,697,680,-17,17,1
"D08JJ",198,388,"1200x900",800,2,600,400,"False",930,320,629,309,309,0
"D08JJ",199,613,"1200x900",1000,2,600,400,"False",690,374,442,68,68,0
"D08JJ",200,146,"1200x900",600,2,600,400,"False",989,492,423,-69,69,0
"D08JJ",201,489,"1200x900",1000,0,600,400,"True",88,604,573,-31,31,1
"D08JJ",202,526,"1200x900",1000,1,600,400,"True",497,710,722,12,12,0
"D08JJ",203,327,"1200x900",800,1,600,400,"True",152,339,399,60,60,0
"D08JJ",204,356,"1200x900",800,1,600,400,"False",123,484,554,70,70,0
"D08JJ",205,576,"1200x900",1000,1,600,400,"True",376,713,697,-16,16,0
"D08JJ",206,486,"1200x900",1000,0,600,400,"True",102,676,644,-32,32,1
"D08JJ",207,469,"1200x900",1000,0,600,400,"False",73,227,488,261,261,1
"D08JJ",208,42,"1200x900",600,0,600,400,"True",233,479,454,-25,25,0
"D08JJ",209,286,"1200x900",800,0,600,400,"True",105,378,371,-7,7,1
"D08JJ",210,495,"1200x900",1000,0,600,400,"False",93,692,581,-111,111,1
"D08JJ",211,127,"1200x900",600,1,600,400,"True",309,691,708,17,17,0
"D08JJ",212,464,"1200x900",1000,0,600,400,"False",82,222,438,216,216,1
"D08JJ",213,223,"1200x900",800,0,600,400,"True",179,191,184,-7,7,1
"D08JJ",214,265,"1200x900",800,0,600,400,"True",229,353,337,-16,16,1
"D08JJ",215,117,"1200x900",600,1,600,400,"False",711,456,244,-212,212,0
"D08JJ",216,567,"1200x900",1000,1,600,400,"False",655,297,427,130,130,1
"D08JJ",217,303,"1200x900",800,1,600,400,"True",241,431,491,60,60,0
"D08JJ",218,474,"1200x900",1000,0,600,400,"True",85,339,364,25,25,1
"D08JJ",219,586,"1200x900",1000,2,600,400,"False",802,262,330,68,68,0
"D08JJ",220,9,"1200x900",600,0,600,400,"True",509,654,722,68,68,1
"D08JJ",221,2,"1200x900",600,0,600,400,"False",159,323,388,65,65,0
"D08JJ",222,210,"1200x900",600,2,600,400,"True",835,506,504,-2,2,0
"D08JJ",223,54,"1200x900",600,0,600,400,"True",474,564,611,47,47,1
"D08JJ",224,431,"1200x900",800,2,600,400,"True",694,382,414,32,32,0
"D08JJ",225,201,"1200x900",600,2,600,400,"False",1005,462,327,-135,135,0
"D08JJ",226,638,"1200x900",1000,2,600,400,"True",385,198,263,65,65,0
"D08JJ",227,216,"1200x900",600,2,600,400,"False",1029,286,196,-90,90,0
"D08JJ",228,196,"1200x900",600,2,600,400,"True",1030,397,360,-37,37,0
"D08JJ",229,603,"1200x900",1000,2,600,400,"False",693,280,510,230,230,0
"D08JJ",230,150,"1200x900",600,2,600,400,"True",897,345,296,-49,49,0
"D08JJ",231,175,"1200x900",600,2,600,400,"False",1028,432,281,-151,151,0
"D08JJ",232,93,"1200x900",600,1,600,400,"False",139,540,414,-126,126,0
"D08JJ",233,209,"1200x900",600,2,600,400,"False",937,637,542,-95,95,0
"D08JJ",234,214,"1200x900",600,2,600,400,"False",1046,305,223,-82,82,0
"D08JJ",235,218,"1200x900",800,0,600,400,"True",106,397,418,21,21,1
"D08JJ",236,94,"1200x900",600,1,600,400,"True",729,482,454,-28,28,0
"D08JJ",237,641,"1200x900",1000,2,600,400,"False",897,272,575,303,303,0
"D08JJ",238,299,"1200x900",800,1,600,400,"False",779,274,510,236,236,0
"D08JJ",239,616,"1200x900",1000,2,600,400,"False",854,357,241,-116,116,1
"D08JJ",240,182,"1200x900",600,2,600,400,"False",933,389,232,-157,157,0
"D08JJ",241,189,"1200x900",600,2,600,400,"True",881,397,382,-15,15,0
"D08JJ",242,227,"1200x900",800,0,600,400,"True",196,551,566,15,15,1
"D08JJ",243,344,"1200x900",800,1,600,400,"False",589,408,513,105,105,0
"D08JJ",244,21,"1200x900",600,0,600,400,"True",314,383,408,25,25,1
"D08JJ",245,289,"1200x900",800,1,600,400,"True",421,703,671,-32,32,1
"D08JJ",246,37,"1200x900",600,0,600,400,"False",258,403,489,86,86,1
"D08JJ",247,531,"1200x900",1000,1,600,400,"False",233,362,510,148,148,0
"D08JJ",248,501,"1200x900",1000,0,600,400,"True",96,323,359,36,36,1
"D08JJ",249,17,"1200x900",600,0,600,400,"True",402,496,499,3,3,1
"D08JJ",250,536,"1200x900",1000,1,600,400,"False",580,213,325,112,112,0
"D08JJ",251,343,"1200x900",800,1,600,400,"False",407,557,345,-212,212,0
"D08JJ",252,440,"1200x900",1000,0,600,400,"True",71,237,297,60,60,1
"D08JJ",253,584,"1200x900",1000,2,600,400,"True",731,413,451,38,38,0
"D08JJ",254,504,"1200x900",1000,0,600,400,"False",107,699,600,-99,99,1
"D08JJ",255,351,"1200x900",800,1,600,400,"True",122,581,637,56,56,0
"D08JJ",256,454,"1200x900",1000,0,600,400,"True",78,687,655,-32,32,1
"D08JJ",257,540,"1200x900",1000,1,600,400,"False",389,568,650,82,82,1
"D08JJ",258,316,"1200x900",800,1,600,400,"False",362,319,492,173,173,0
"D08JJ",259,30,"1200x900",600,0,600,400,"True",107,353,356,3,3,0
"D08JJ",260,145,"1200x900",600,2,600,400,"False",1004,630,503,-127,127,0
"D08JJ",261,296,"1200x900",800,1,600,400,"True",89,279,347,68,68,0
"D08JJ",262,336,"1200x900",800,1,600,400,"False",251,587,471,-116,116,0
"D08JJ",263,484,"1200x900",1000,0,600,400,"False",100,223,333,110,110,1
"D08JJ",264,381,"1200x900",800,2,600,400,"True",705,408,381,-27,27,0
"D08JJ",265,294,"1200x900",800,1,600,400,"False",262,287,540,253,253,0
"D08JJ",266,107,"1200x900",600,1,600,400,"True",878,678,661,-17,17,0
"D08JJ",267,413,"1200x900",800,2,600,400,"False",849,506,630,124,124,0
"D08JJ",268,245,"1200x900",800,0,600,400,"True",296,235,276,41,41,1
"D08JJ",269,237,"1200x900",800,0,600,400,"True",204,481,508,27,27,1
"D08JJ",271,466,"1200x900",1000,0,600,400,"False",82,205,374,169,169,1
"D08JJ",272,432,"1200x900",800,2,600,400,"True",792,380,375,-5,5,0
"D08JJ",273,447,"1200x900",1000,0,600,400,"True",71,339,313,-26,26,1
"D08JJ",274,363,"1200x900",800,2,600,400,"False",800,218,311,93,93,0
"D08JJ",275,456,"1200x900",1000,0,600,400,"True",91,257,255,-2,2,1
"D08JJ",276,364,"1200x900",800,2,600,400,"False",1018,204,344,140,140,0
"D08JJ",277,542,"1200x900",1000,1,600,400,"True",304,401,487,86,86,0
"D08JJ",278,493,"1200x900",1000,0,600,400,"True",80,582,586,4,4,1
"D08JJ",279,115,"1200x900",600,1,600,400,"True",545,307,410,103,103,0
"D08JJ",280,165,"1200x900",600,2,600,400,"True",912,554,478,-76,76,0
"D08JJ",281,359,"1200x900",800,1,600,400,"False",653,241,365,124,124,0
"D08JJ",282,529,"1200x900",1000,1,600,400,"False",267,412,332,-80,80,1
"D08JJ",283,348,"1200x900",800,1,600,400,"True",764,294,357,63,63,0
"D08JJ",284,436,"1200x900",1000,0,600,400,"False",82,617,498,-119,119,1
"D08JJ",285,551,"1200x900",1000,1,600,400,"True",146,445,481,36,36,1
"D08JJ",286,129,"1200x900",600,1,600,400,"False",859,482,371,-111,111,1
"D08JJ",287,430,"1200x900",800,2,600,400,"True",922,254,242,-12,12,0
"D08JJ",288,293,"1200x900",800,1,600,400,"True",561,396,369,-27,27,0
"D08JJ",289,3,"1200x900",600,0,600,400,"True",298,443,465,22,22,1
"D08JJ",290,39,"1200x900",600,0,600,400,"True",210,609,550,-59,59,0
"D08JJ",291,392,"1200x900",800,2,600,400,"False",1031,618,701,83,83,0
"D08JJ",292,194,"1200x900",600,2,600,400,"True",896,236,244,8,8,0
"D08JJ",293,397,"1200x900",800,2,600,400,"False",817,692,520,-172,172,0
"D08JJ",294,382,"1200x900",800,2,600,400,"False",870,523,440,-83,83,0
"D08JJ",295,160,"1200x900",600,2,600,400,"True",863,606,550,-56,56,0
"D08JJ",296,53,"1200x900",600,0,600,400,"True",177,189,224,35,35,0
"D08JJ",297,375,"1200x900",800,2,600,400,"True",716,384,458,74,74,0
"D08JJ",298,360,"1200x900",800,1,600,400,"True",203,608,547,-61,61,0
"D08JJ",299,48,"1200x900",600,0,600,400,"True",323,645,621,-24,24,1
"D08JJ",300,241,"1200x900",800,0,600,400,"False",129,227,378,151,151,1
"D08JJ",301,644,"1200x900",1000,2,600,400,"True",495,486,430,-56,56,0
"D08JJ",302,302,"1200x900",800,1,600,400,"True",479,467,420,-47,47,1
"D08JJ",303,283,"1200x900",800,0,600,400,"True",90,264,286,22,22,1
"D08JJ",304,352,"1200x900",800,1,600,400,"False",235,717,556,-161,161,0
"D08JJ",305,350,"1200x900",800,1,600,400,"True",182,566,619,53,53,0
"D08JJ",306,487,"1200x900",1000,0,600,400,"False",78,670,588,-82,82,1
"D08JJ",307,544,"1200x900",1000,1,600,400,"False",602,620,534,-86,86,0
"D08JJ",308,402,"1200x900",800,2,600,400,"True",878,234,224,-10,10,0
"D08JJ",309,403,"1200x900",800,2,600,400,"False",625,704,490,-214,214,0
"D08JJ",310,140,"1200x900",600,1,600,400,"True",700,523,548,25,25,0
"D08JJ",311,259,"1200x900",800,0,600,400,"False",156,180,282,102,102,1
"D08JJ",312,212,"1200x900",600,2,600,400,"True",841,206,200,-6,6,0
"D08JJ",313,556,"1200x900",1000,1,600,400,"False",415,420,320,-100,100,0
"D08JJ",314,78,"1200x900",600,1,600,400,"False",885,684,746,62,62,0
"D08JJ",315,333,"1200x900",800,1,600,400,"False",521,548,425,-123,123,0
"D08JJ",316,149,"1200x900",600,2,600,400,"True",890,289,287,-2,2,0
"D08JJ",317,168,"1200x900",600,2,600,400,"False",1001,439,273,-166,166,0
"D08JJ",318,16,"1200x900",600,0,600,400,"True",297,514,469,-45,45,1
"D08JJ",319,262,"1200x900",800,0,600,400,"True",196,481,433,-48,48,1
"D08JJ",320,101,"1200x900",600,1,600,400,"True",541,656,636,-20,20,0
"D08JJ",321,380,"1200x900",800,2,600,400,"True",942,228,273,45,45,0
"D08JJ",322,152,"1200x900",600,2,600,400,"False",971,399,180,-219,219,0
"D08JJ",323,457,"1200x900",1000,0,600,400,"False",97,630,499,-131,131,1
"D08JJ",324,463,"1200x900",1000,0,600,400,"False",115,693,538,-155,155,1
"D08JJ",325,279,"1200x900",800,0,600,400,"False",252,202,329,127,127,1
"D08JJ",326,263,"1200x900",800,0,600,400,"True",82,396,402,6,6,1
"D08JJ",327,349,"1200x900",800,1,600,400,"False",402,665,554,-111,111,0
"D08JJ",328,620,"1200x900",1000,2,600,400,"False",832,649,441,-208,208,0
"D08JJ",329,640,"1200x900",1000,2,600,400,"True",361,334,275,-59,59,0
"D08JJ",330,386,"1200x900",800,2,600,400,"False",774,301,190,-111,111,0
"D08JJ",331,47,"1200x900",600,0,600,400,"False",303,499,427,-72,72,1
"D08JJ",332,419,"1200x900",800,2,600,400,"False",769,351,209,-142,142,0
"D08JJ",333,82,"1200x900",600,1,600,400,"True",108,213,206,-7,7,0
"D08JJ",334,642,"1200x900",1000,2,600,400,"True",776,316,374,58,58,0
"D08JJ",335,246,"1200x900",800,0,600,400,"True",196,418,431,13,13,1
"D08JJ",336,615,"1200x900",1000,2,600,400,"False",736,634,528,-106,106,0
"D08JJ",337,252,"1200x900",800,0,600,400,"True",224,673,688,15,15,1
"D08JJ",338,376,"1200x900",800,2,600,400,"False",788,275,140,-135,135,0
"D08JJ",339,23,"1200x900",600,0,600,400,"False",308,463,381,-82,82,1
"D08JJ",340,396,"1200x900",800,2,600,400,"True",678,663,639,-24,24,0
"D08JJ",341,135,"1200x900",600,1,600,400,"True",759,569,633,64,64,0
"D08JJ",342,184,"1200x900",600,2,600,400,"False",1067,441,745,304,304,0
"D08JJ",343,503,"1200x900",1000,0,600,400,"False",86,279,347,68,68,1
"D08JJ",344,492,"1200x900",1000,0,600,400,"False",76,692,597,-95,95,1
"D08JJ",345,272,"1200x900",800,0,600,400,"False",200,181,305,124,124,1
"D08JJ",346,323,"1200x900",800,1,600,400,"False",388,348,650,302,302,0
"D08JJ",347,647,"1200x900",1000,2,600,400,"False",560,637,760,123,123,0
"D08JJ",348,589,"1200x900",1000,2,600,400,"True",856,418,428,10,10,0
"D08JJ",349,532,"1200x900",1000,1,600,400,"False",215,207,291,84,84,0
"D08JJ",350,618,"1200x900",1000,2,600,400,"False",276,671,441,-230,230,0
"D08JJ",351,225,"1200x900",800,0,600,400,"True",178,423,435,12,12,1
"D08JJ",352,406,"1200x900",800,2,600,400,"True",971,233,279,46,46,0
"D08JJ",353,539,"1200x900",1000,1,600,400,"True",510,383,388,5,5,0
"D08JJ",354,46,"1200x900",600,0,600,400,"True",193,355,341,-14,14,1
"D08JJ",355,114,"1200x900",600,1,600,400,"True",183,697,680,-17,17,0
"D08JJ",356,633,"1200x900",1000,2,600,400,"False",564,253,472,219,219,0
"D08JJ",357,291,"1200x900",800,1,600,400,"False",522,694,620,-74,74,0
"D08JJ",358,157,"1200x900",600,2,600,400,"True",1016,323,315,-8,8,0
"D08JJ",359,300,"1200x900",800,1,600,400,"False",620,693,587,-106,106,0
"D08JJ",360,248,"1200x900",800,0,600,400,"False",94,240,390,150,150,1
"D08JJ",361,87,"1200x900",600,1,600,400,"False",231,604,703,99,99,0
"D08JJ",362,545,"1200x900",1000,1,600,400,"True",358,562,575,13,13,0
"D08JJ",363,334,"1200x900",800,1,600,400,"True",481,665,672,7,7,0
"D08JJ",364,230,"1200x900",800,0,600,400,"True",99,678,677,-1,1,1
"D08JJ",365,134,"1200x900",600,1,600,400,"True",300,188,236,48,48,0
"D08JJ",366,611,"1200x900",1000,2,600,400,"False",414,511,341,-170,170,0
"D08JJ",367,637,"1200x900",1000,2,600,400,"False",750,460,568,108,108,0
"D08JJ",368,307,"1200x900",800,1,600,400,"False",716,247,345,98,98,0
"D08JJ",369,20,"1200x900",600,0,600,400,"True",204,545,531,-14,14,1
"D08JJ",370,371,"1200x900",800,2,600,400,"False",730,560,240,-320,320,0
"D08JJ",371,147,"1200x900",600,2,600,400,"True",942,418,427,9,9,0
"D08JJ",373,288,"1200x900",800,0,600,400,"True",180,547,539,-8,8,1
"D08JJ",375,326,"1200x900",800,1,600,400,"True",103,482,507,25,25,0
"D08JJ",376,341,"1200x900",800,1,600,400,"True",735,632,602,-30,30,1
"D08JJ",377,625,"1200x900",1000,2,600,400,"False",279,228,697,469,469,0
"D08JJ",378,627,"1200x900",1000,2,600,400,"False",760,510,254,-256,256,0
"D08JJ",379,123,"1200x900",600,1,600,400,"False",761,365,291,-74,74,1
"D08JJ",380,170,"1200x900",600,2,600,400,"False",996,468,353,-115,115,0
"D08JJ",381,564,"1200x900",1000,1,600,400,"False",215,264,414,150,150,0
"D08JJ",382,331,"1200x900",800,1,600,400,"False",240,620,425,-195,195,0
"D08JJ",383,169,"1200x900",600,2,600,400,"False",924,290,402,112,112,0
"D08JJ",384,88,"1200x900",600,1,600,400,"True",186,554,574,20,20,0
"D08JJ",385,51,"1200x900",600,0,600,400,"True",272,181,169,-12,12,1
"D08JJ",386,64,"1200x900",600,0,600,400,"True",102,339,336,-3,3,0
"D08JJ",387,557,"1200x900",1000,1,600,400,"True",677,505,534,29,29,1
"D08JJ",388,251,"1200x900",800,0,600,400,"False",88,352,488,136,136,1
"D08JJ",389,32,"1200x900",600,0,600,400,"True",152,563,566,3,3,1
"D08JJ",390,378,"1200x900",800,2,600,400,"False",1018,708,452,-256,256,0
"D08JJ",391,417,"1200x900",800,2,600,400,"True",750,280,288,8,8,0
"D08JJ",392,71,"1200x900",600,0,600,400,"True",219,248,257,9,9,0
"D08JJ",393,480,"1200x900",1000,0,600,400,"True",100,231,242,11,11,1
"D08JJ",394,315,"1200x900",800,1,600,400,"True",105,211,224,13,13,0
"D08JJ",395,207,"1200x900",600,2,600,400,"False",838,235,322,87,87,0
"D08JJ",396,238,"1200x900",800,0,600,400,"True",162,283,263,-20,20,1
"D08JJ",397,120,"1200x900",600,1,600,400,"False",690,655,556,-99,99,0
"D08JJ",398,213,"1200x900",600,2,600,400,"False",822,275,467,192,192,0
"D08JJ",399,96,"1200x900",600,1,600,400,"False",433,458,596,138,138,0
"D08JJ",400,383,"1200x900",800,2,600,400,"False",855,407,532,125,125,0
"D08JJ",401,635,"1200x900",1000,2,600,400,"True",833,402,473,71,71,0
"D08JJ",402,631,"1200x900",1000,2,600,400,"True",699,479,449,-30,30,0
"D08JJ",403,418,"1200x900",800,2,600,400,"True",754,507,461,-46,46,0
"D08JJ",404,161,"1200x900",600,2,600,400,"True",939,553,536,-17,17,0
"D08JJ",405,122,"1200x900",600,1,600,400,"True",817,709,714,5,5,0
"D08JJ",406,555,"1200x900",1000,1,600,400,"False",444,556,675,119,119,0
"D08JJ",407,449,"1200x900",1000,0,600,400,"True",105,683,700,17,17,1
"D08JJ",408,345,"1200x900",800,1,600,400,"False",841,566,679,113,113,1
"D08JJ",409,511,"1200x900",1000,1,600,400,"False",408,390,625,235,235,1
"D08JJ",410,387,"1200x900",800,2,600,400,"False",990,444,187,-257,257,0
"D08JJ",411,38,"1200x900",600,0,600,400,"False",120,628,524,-104,104,1
"D08JJ",412,546,"1200x900",1000,1,600,400,"False",305,374,458,84,84,0
"D08JJ",413,377,"1200x900",800,2,600,400,"False",683,388,294,-94,94,0
"D08JJ",414,477,"1200x900",1000,0,600,400,"False",88,640,530,-110,110,1
"D08JJ",415,400,"1200x900",800,2,600,400,"True",733,297,286,-11,11,0
"D08JJ",416,445,"1200x900",1000,0,600,400,"False",78,302,371,69,69,1
"D08JJ",417,444,"1200x900",1000,0,600,400,"False",101,714,555,-159,159,1
"D08JJ",418,192,"1200x900",600,2,600,400,"True",1064,320,372,52,52,0
"D08JJ",419,332,"1200x900",800,1,600,400,"True",260,699,624,-75,75,0
"D08JJ",420,222,"1200x900",800,0,600,400,"False",152,206,385,179,179,1
"D08JJ",421,609,"1200x900",1000,2,600,400,"False",697,627,362,-265,265,0
"D08JJ",422,468,"1200x900",1000,0,600,400,"True",121,219,231,12,12,1
"D08JJ",423,519,"1200x900",1000,1,600,400,"False",319,565,700,135,135,1
"D08JJ",424,624,"1200x900",1000,2,600,400,"False",693,501,375,-126,126,0
"D08JJ",425,420,"1200x900",800,2,600,400,"True",519,223,232,9,9,0
"D08JJ",426,185,"1200x900",600,2,600,400,"False",907,212,306,94,94,0
"D08JJ",427,583,"1200x900",1000,2,600,400,"True",949,284,285,1,1,1
"D08JJ",428,240,"1200x900",800,0,600,400,"False",330,656,553,-103,103,1
"D08JJ",429,249,"1200x900",800,0,600,400,"True",126,306,332,26,26,1
"D08JJ",430,342,"1200x900",800,1,600,400,"True",677,204,254,50,50,0
"D08JJ",431,322,"1200x900",800,1,600,400,"False",703,206,364,158,158,1
"D08JJ",432,67,"1200x900",600,0,600,400,"True",289,308,249,-59,59,1
"D08JJ",433,195,"1200x900",600,2,600,400,"False",942,249,166,-83,83,0
"D08JJ",434,183,"1200x900",600,2,600,400,"True",927,289,276,-13,13,0
"D08JJ",435,148,"1200x900",600,2,600,400,"True",907,330,386,56,56,0
"D08JJ",436,507,"1200x900",1000,1,600,400,"True",608,583,592,9,9,1
"D08JJ",437,311,"1200x900",800,1,600,400,"False",710,261,565,304,304,0
"D08JJ",438,630,"1200x900",1000,2,600,400,"False",754,559,381,-178,178,0
"D08JJ",439,577,"1200x900",1000,2,600,400,"True",455,420,486,66,66,0
"D08JJ",440,639,"1200x900",1000,2,600,400,"False",504,456,304,-152,152,0
"D08JJ",441,339,"1200x900",800,1,600,400,"True",273,545,588,43,43,1
"D08JJ",442,629,"1200x900",1000,2,600,400,"True",681,257,293,36,36,0
"D08JJ",443,45,"1200x900",600,0,600,400,"False",487,678,529,-149,149,1
"D08JJ",444,600,"1200x900",1000,2,600,400,"False",765,207,570,363,363,0
"D08JJ",445,63,"1200x900",600,0,600,400,"True",311,188,145,-43,43,1
"D08JJ",446,103,"1200x900",600,1,600,400,"False",528,320,483,163,163,1
"D08JJ",447,415,"1200x900",800,2,600,400,"False",823,684,436,-248,248,0
"D08JJ",448,601,"1200x900",1000,2,600,400,"False",735,697,630,-67,67,0
"D08JJ",449,172,"1200x900",600,2,600,400,"False",912,444,584,140,140,0
"D08JJ",450,602,"1200x900",1000,2,600,400,"False",865,452,104,-348,348,0
"D08JJ",451,435,"1200x900",1000,0,600,400,"False",119,200,327,127,127,1
"D08JJ",452,512,"1200x900",1000,1,600,400,"True",139,261,261,0,0,0
"D08JJ",453,407,"1200x900",800,2,600,400,"True",989,340,289,-51,51,0
"D08JJ",454,164,"1200x900",600,2,600,400,"True",1051,268,290,22,22,0
"D08JJ",455,374,"1200x900",800,2,600,400,"False",755,450,355,-95,95,0
"D08JJ",456,314,"1200x900",800,1,600,400,"False",277,616,499,-117,117,1
"D08JJ",457,106,"1200x900",600,1,600,400,"True",803,659,653,-6,6,1
"D08JJ",458,425,"1200x900",800,2,600,400,"False",621,438,652,214,214,0
"D08JJ",459,572,"1200x900",1000,1,600,400,"False",302,260,514,254,254,0
"D08JJ",460,490,"1200x900",1000,0,600,400,"False",114,183,261,78,78,1
"D08JJ",461,358,"1200x900",800,1,600,400,"False",263,635,241,-394,394,0
"D08JJ",462,481,"1200x900",1000,0,600,400,"False",80,185,313,128,128,1
"D08JJ",463,634,"1200x900",1000,2,600,400,"True",735,313,288,-25,25,0
"D08JJ",464,559,"1200x900",1000,1,600,400,"True",641,244,237,-7,7,0
"D08JJ",465,346,"1200x900",800,1,600,400,"False",269,635,509,-126,126,0
"D08JJ",466,395,"1200x900",800,2,600,400,"True",743,334,327,-7,7,0
"D08JJ",467,27,"1200x900",600,0,600,400,"True",373,309,297,-12,12,1
"D08JJ",468,306,"1200x900",800,1,600,400,"False",164,524,615,91,91,0
"D08JJ",469,270,"1200x900",800,0,600,400,"True",192,418,463,45,45,1
"D08JJ",470,221,"1200x900",800,0,600,400,"True",132,520,462,-58,58,1
"D08JJ",471,558,"1200x900",1000,1,600,400,"True",72,464,488,24,24,1
"D08JJ",472,158,"1200x900",600,2,600,400,"False",939,300,204,-96,96,0
"D08JJ",473,19,"1200x900",600,0,600,400,"False",286,686,529,-157,157,0
"D08JJ",474,233,"1200x900",800,0,600,400,"True",164,700,704,4,4,1
"D08JJ",475,200,"1200x900",600,2,600,400,"True",897,302,344,42,42,0
"D08JJ",476,24,"1200x900",600,0,600,400,"True",430,538,539,1,1,1
"D08JJ",477,553,"1200x900",1000,1,600,400,"False",116,712,162,-550,550,0
"D08JJ",478,528,"1200x900",1000,1,600,400,"False",839,227,634,407,407,1
"D08JJ",479,399,"1200x900",800,2,600,400,"False",603,602,497,-105,105,0
"D08JJ",480,86,"1200x900",600,1,600,400,"True",692,388,355,-33,33,1
"D08JJ",481,568,"1200x900",1000,1,600,400,"True",286,475,407,-68,68,1
"D08JJ",482,412,"1200x900",800,2,600,400,"True",842,280,368,88,88,0
"D08JJ",483,163,"1200x900",600,2,600,400,"True",1046,665,678,13,13,0
"D08JJ",484,84,"1200x900",600,1,600,400,"False",144,184,109,-75,75,0
"D08JJ",485,250,"1200x900",800,0,600,400,"False",290,248,341,93,93,1
"D08JJ",486,443,"1200x900",1000,0,600,400,"False",99,651,526,-125,125,1
"D08JJ",487,280,"1200x900",800,0,600,400,"False",104,302,395,93,93,1
"D08JJ",488,573,"1200x900",1000,1,600,400,"False",486,615,425,-190,190,0
"D08JJ",489,578,"1200x900",1000,2,600,400,"False",966,276,682,406,406,0
"D08JJ",490,485,"1200x900",1000,0,600,400,"True",121,694,665,-29,29,1
"D08JJ",491,433,"1200x900",1000,0,600,400,"False",76,222,432,210,210,1
"D08JJ",492,10,"1200x900",600,0,600,400,"True",400,499,480,-19,19,1
"D08JJ",493,422,"1200x900",800,2,600,400,"False",712,558,402,-156,156,0
"D08JJ",494,132,"1200x900",600,1,600,400,"True",333,185,176,-9,9,0
"D08JJ",495,520,"1200x900",1000,1,600,400,"False",564,260,341,81,81,0
"D08JJ",496,269,"1200x900",800,0,600,400,"True",160,295,257,-38,38,1
"D08JJ",497,325,"1200x900",800,1,600,400,"False",105,394,323,-71,71,0
"D08JJ",498,162,"1200x900",600,2,600,400,"False",849,279,415,136,136,0
"D08JJ",499,298,"1200x900",800,1,600,400,"False",311,457,385,-72,72,0
"D08JJ",500,614,"1200x900",1000,2,600,400,"False",823,563,403,-160,160,0
"D08JJ",501,515,"1200x900",1000,1,600,400,"False",307,217,310,93,93,0
"D08JJ",502,34,"1200x900",600,0,600,400,"True",361,242,226,-16,16,1
"D08JJ",503,43,"1200x900",600,0,600,400,"False",277,446,350,-96,96,1
"D08JJ",504,587,"1200x900",1000,2,600,400,"False",741,686,372,-314,314,0
"D08JJ",505,554,"1200x900",1000,1,600,400,"True",79,309,315,6,6,1
"D08JJ",507,318,"1200x900",800,1,600,400,"True",788,534,576,42,42,0
"D08JJ",508,517,"1200x900",1000,1,600,400,"False",548,182,274,92,92,0
"D08JJ",509,90,"1200x900",600,1,600,400,"False",560,474,359,-115,115,0
"D08JJ",510,368,"1200x900",800,2,600,400,"False",778,515,427,-88,88,0
"D08JJ",511,102,"1200x900",600,1,600,400,"True",861,603,569,-34,34,0
"D08JJ",512,472,"1200x900",1000,0,600,400,"False",77,685,581,-104,104,1
"D08JJ",514,643,"1200x900",1000,2,600,400,"True",740,325,314,-11,11,0
"D08JJ",515,607,"1200x900",1000,2,600,400,"False",900,573,675,102,102,1
"D08JJ",516,538,"1200x900",1000,1,600,400,"False",308,457,632,175,175,1
"D08JJ",517,143,"1200x900",600,1,600,400,"False",479,284,490,206,206,1
"D08JJ",518,297,"1200x900",800,1,600,400,"True",625,244,314,70,70,0
"D08JJ",519,478,"1200x900",1000,0,600,400,"False",79,672,556,-116,116,1
"D08JJ",520,268,"1200x900",800,0,600,400,"True",148,400,384,-16,16,1
"D08JJ",521,598,"1200x900",1000,2,600,400,"False",706,559,404,-155,155,0
"D08JJ",522,128,"1200x900",600,1,600,400,"True",661,258,223,-35,35,1
"D08JJ",523,91,"1200x900",600,1,600,400,"False",417,630,524,-106,106,1
"D08JJ",524,155,"1200x900",600,2,600,400,"True",940,269,273,4,4,0
"D08JJ",525,220,"1200x900",800,0,600,400,"False",108,699,591,-108,108,1
"D08JJ",526,282,"1200x900",800,0,600,400,"False",109,246,412,166,166,1
"D08JJ",527,467,"1200x900",1000,0,600,400,"False",74,712,551,-161,161,1
"D08JJ",528,57,"1200x900",600,0,600,400,"True",354,508,498,-10,10,1
"D08JJ",529,284,"1200x900",800,0,600,400,"True",135,293,334,41,41,1
"D08JJ",530,317,"1200x900",800,1,600,400,"False",185,564,681,117,117,0
"D08JJ",531,470,"1200x900",1000,0,600,400,"True",91,666,636,-30,30,1
"D08JJ",532,112,"1200x900",600,1,600,400,"False",681,490,374,-116,116,0
"D08JJ",533,450,"1200x900",1000,0,600,400,"False",130,204,348,144,144,1
"D08JJ",534,313,"1200x900",800,1,600,400,"False",588,421,304,-117,117,0
"D08JJ",535,353,"1200x900",800,1,600,400,"False",90,476,575,99,99,0
"D08JJ",536,328,"1200x900",800,1,600,400,"True",104,649,628,-21,21,0
"D08JJ",537,171,"1200x900",600,2,600,400,"True",909,200,300,100,100,0
"D08JJ",538,206,"1200x900",600,2,600,400,"True",975,223,204,-19,19,0
"D08JJ",539,312,"1200x900",800,1,600,400,"False",238,683,771,88,88,0
"D08JJ",540,310,"1200x900",800,1,600,400,"False",559,592,682,90,90,0
"D08JJ",541,496,"1200x900",1000,0,600,400,"True",70,639,656,17,17,1
"D08JJ",542,119,"1200x900",600,1,600,400,"False",168,563,671,108,108,0
"D08JJ",543,255,"1200x900",800,0,600,400,"True",93,709,669,-40,40,1
"D08JJ",544,202,"1200x900",600,2,600,400,"False",966,460,398,-62,62,0
"D08JJ",545,409,"1200x900",800,2,600,400,"True",501,659,590,-69,69,0
"D08JJ",546,442,"1200x900",1000,0,600,400,"False",87,183,392,209,209,1
"D08JJ",547,491,"1200x900",1000,0,600,400,"True",108,198,219,21,21,1
"D08JJ",548,6,"1200x900",600,0,600,400,"False",217,689,552,-137,137,1
"D08JJ",549,516,"1200x900",1000,1,600,400,"False",440,559,660,101,101,0
"D08JJ",550,281,"1200x900",800,0,600,400,"True",112,611,592,-19,19,1
"D08JJ",551,414,"1200x900",800,2,600,400,"True",831,592,539,-53,53,0
"D08JJ",552,621,"1200x900",1000,2,600,400,"False",540,478,591,113,113,0
"D08JJ",553,398,"1200x900",800,2,600,400,"True",944,698,655,-43,43,0
"D08JJ",554,604,"1200x900",1000,2,600,400,"False",459,593,750,157,157,0
"D08JJ",555,153,"1200x900",600,2,600,400,"True",1037,601,593,-8,8,0
"D08JJ",556,236,"1200x900",800,0,600,400,"True",162,350,378,28,28,1
"D08JJ",557,301,"1200x900",800,1,600,400,"True",162,574,567,-7,7,0
"D08JJ",558,581,"1200x900",1000,2,600,400,"False",310,357,690,333,333,0
"D08JJ",559,354,"1200x900",800,1,600,400,"True",118,236,205,-31,31,0
"D08JJ",560,156,"1200x900",600,2,600,400,"True",913,197,245,48,48,0
"D08JJ",561,287,"1200x900",800,0,600,400,"False",120,567,439,-128,128,1
"D08JJ",562,131,"1200x900",600,1,600,400,"False",531,367,569,202,202,0
"D08JJ",563,167,"1200x900",600,2,600,400,"True",956,241,289,48,48,0
"D08JJ",564,330,"1200x900",800,1,600,400,"False",759,301,191,-110,110,1
"D08JJ",565,473,"1200x900",1000,0,600,400,"True",75,323,264,-59,59,1
"D08JJ",566,290,"1200x900",800,1,600,400,"False",789,603,445,-158,158,0
"D08JJ",567,125,"1200x900",600,1,600,400,"True",750,531,531,0,0,0
"D08JJ",568,446,"1200x900",1000,0,600,400,"False",72,298,381,83,83,1
"D08JJ",569,173,"1200x900",600,2,600,400,"True",948,693,647,-46,46,0
"D08JJ",570,582,"1200x900",1000,2,600,400,"True",554,347,390,43,43,0
"D08JJ",571,563,"1200x900",1000,1,600,400,"False",201,696,441,-255,255,0
"D08JJ",572,590,"1200x900",1000,2,600,400,"True",636,278,318,40,40,0
"D08JJ",573,610,"1200x900",1000,2,600,400,"True",702,293,250,-43,43,0
"D08JJ",574,394,"1200x900",800,2,600,400,"False",847,292,389,97,97,0
"D08JJ",575,58,"1200x900",600,0,600,400,"False",353,655,566,-89,89,1
"D08JJ",576,483,"1200x900",1000,0,600,400,"False",93,191,334,143,143,1
"D08JJ",577,208,"1200x900",600,2,600,400,"True",946,399,408,9,9,0
"D08JJ",578,379,"1200x900",800,2,600,400,"False",994,325,404,79,79,0
"D08JJ",579,68,"1200x900",600,0,600,400,"True",165,367,352,-15,15,0
"D08JJ",580,458,"1200x900",1000,0,600,400,"False",78,624,488,-136,136,1
"D08JJ",581,130,"1200x900",600,1,600,400,"True",741,428,492,64,64,0
"D08JJ",582,459,"1200x900",1000,0,600,400,"True",70,645,594,-51,51,1
"D08JJ",583,574,"1200x900",1000,1,600,400,"False",614,194,263,69,69,0
"D08JJ",584,22,"1200x900",600,0,600,400,"True",398,591,540,-51,51,1
"D08JJ",585,588,"1200x900",1000,2,600,400,"False",585,350,240,-110,110,0
"D08JJ",586,514,"1200x900",1000,1,600,400,"False",539,690,560,-130,130,0
"D08JJ",587,384,"1200x900",800,2,600,400,"False",821,707,624,-83,83,0
"D08JJ",588,138,"1200x900",600,1,600,400,"False",844,580,687,107,107,1
"D08JJ",589,95,"1200x900",600,1,600,400,"True",749,425,359,-66,66,1
"D08JJ",590,108,"1200x900",600,1,600,400,"False",830,239,366,127,127,0
"D08JJ",591,424,"1200x900",800,2,600,400,"False",903,545,381,-164,164,0
"D08JJ",592,12,"1200x900",600,0,600,400,"True",365,336,270,-66,66,1
"D08JJ",593,455,"1200x900",1000,0,600,400,"False",107,718,483,-235,235,1
"D08JJ",594,571,"1200x900",1000,1,600,400,"True",239,522,566,44,44,1
"D08JJ",595,76,"1200x900",600,1,600,400,"False",647,614,675,61,61,0
"D08JJ",596,599,"1200x900",1000,2,600,400,"True",316,570,564,-6,6,0
"D08JJ",597,335,"1200x900",800,1,600,400,"False",124,360,503,143,143,0
"D08JJ",598,133,"1200x900",600,1,600,400,"False",345,551,622,71,71,0
"D08JJ",599,579,"1200x900",1000,2,600,400,"False",803,394,540,146,146,0
"D08JJ",600,304,"1200x900",800,1,600,400,"False",667,605,300,-305,305,0
"D08JJ",601,77,"1200x900",600,1,600,400,"True",780,525,542,17,17,0
"D08JJ",602,522,"1200x900",1000,1,600,400,"False",223,379,547,168,168,0
"D08JJ",603,460,"1200x900",1000,0,600,400,"False",155,189,329,140,140,1
"D08JJ",604,59,"1200x900",600,0,600,400,"True",391,692,647,-45,45,1
"D08JJ",605,305,"1200x900",800,1,600,400,"True",471,716,662,-54,54,0
"D08JJ",606,451,"1200x900",1000,0,600,400,"True",110,702,669,-33,33,1
"D08JJ",608,271,"1200x900",800,0,600,400,"True",74,360,399,39,39,1
"D08JJ",609,646,"1200x900",1000,2,600,400,"True",829,227,259,32,32,1
"D08JJ",610,247,"1200x900",800,0,600,400,"False",160,424,347,-77,77,1
"D08JJ",611,228,"1200x900",800,0,600,400,"True",174,687,645,-42,42,1
"D08JJ",612,256,"1200x900",800,0,600,400,"True",192,656,653,-3,3,1
"D08JJ",613,166,"1200x900",600,2,600,400,"True",896,274,307,33,33,0
"D08JJ",614,274,"1200x900",800,0,600,400,"False",146,497,425,-72,72,1
"D08JJ",615,329,"1200x900",800,1,600,400,"False",517,239,514,275,275,0
"D08JJ",616,14,"1200x900",600,0,600,400,"False",399,224,322,98,98,1
"D08JJ",617,405,"1200x900",800,2,600,400,"False",790,307,451,144,144,0
"D08JJ",618,365,"1200x900",800,2,600,400,"False",1055,305,577,272,272,0
"D08JJ",619,494,"1200x900",1000,0,600,400,"True",127,692,691,-1,1,1
"D08JJ",620,505,"1200x900",1000,1,600,400,"False",191,484,642,158,158,1
"D08JJ",621,585,"1200x900",1000,2,600,400,"False",698,688,571,-117,117,1
"D08JJ",622,116,"1200x900",600,1,600,400,"True",767,289,278,-11,11,0
"D08JJ",623,137,"1200x900",600,1,600,400,"True",789,577,534,-43,43,0
"D08JJ",624,498,"1200x900",1000,0,600,400,"False",100,260,419,159,159,1
"D08JJ",625,260,"1200x900",800,0,600,400,"True",103,525,515,-10,10,1
"D08JJ",626,479,"1200x900",1000,0,600,400,"False",74,705,613,-92,92,1
"D08JJ",627,205,"1200x900",600,2,600,400,"True",1021,504,531,27,27,0
"D08JJ",628,124,"1200x900",600,1,600,400,"False",345,467,334,-133,133,0
"D08JJ",629,500,"1200x900",1000,0,600,400,"False",105,700,573,-127,127,1
"D08JJ",630,509,"1200x900",1000,1,600,400,"True",509,434,481,47,47,0
"D08JJ",631,35,"1200x900",600,0,600,400,"True",366,555,512,-43,43,1
"D08JJ",632,482,"1200x900",1000,0,600,400,"True",79,686,626,-60,60,1
"D08JJ",633,261,"1200x900",800,0,600,400,"True",86,713,685,-28,28,1
"D08JJ",634,203,"1200x900",600,2,600,400,"True",938,603,545,-58,58,0
"D08JJ",635,401,"1200x900",800,2,600,400,"True",821,260,284,24,24,0
"D08JJ",636,273,"1200x900",800,0,600,400,"True",180,309,265,-44,44,1
"D08JJ",637,575,"1200x900",1000,1,600,400,"False",272,693,520,-173,173,0
"D08JJ",638,186,"1200x900",600,2,600,400,"True",997,197,266,69,69,0
"D08JJ",639,176,"1200x900",600,2,600,400,"True",1033,281,291,10,10,0
"D08JJ",640,597,"1200x900",1000,2,600,400,"False",352,239,556,317,317,0
"D08JJ",641,244,"1200x900",800,0,600,400,"True",194,203,244,41,41,1
"D08JJ",642,543,"1200x900",1000,1,600,400,"False",88,202,445,243,243,0
"D08JJ",643,56,"1200x900",600,0,600,400,"True",148,491,444,-47,47,0
"D08JJ",644,612,"1200x900",1000,2,600,400,"False",706,198,326,128,128,0
"D08JJ",645,159,"1200x900",600,2,600,400,"False",992,309,236,-73,73,0
"D08JJ",646,632,"1200x900",1000,2,600,400,"False",984,227,638,411,411,0
"D08JJ",647,518,"1200x900",1000,1,600,400,"False",583,717,497,-220,220,0
"D08JJ",648,337,"1200x900",800,1,600,400,"True",299,622,601,-21,21,0
"D09MK",1,227,"1200x900",800,0,600,400,"False",196,551,655,104,104,1
"D09MK",2,407,"1200x900",800,2,600,400,"False",989,340,167,-173,173,0
"D09MK",3,333,"1200x900",800,1,600,400,"True",521,548,511,-37,37,0
"D09MK",4,427,"1200x900",800,2,600,400,"True",812,380,452,72,72,0
"D09MK",5,400,"1200x900",800,2,600,400,"True",733,297,352,55,55,0
"D09MK",6,132,"1200x900",600,1,600,400,"True",333,185,137,-48,48,0
"D09MK",7,450,"1200x900",1000,0,600,400,"True",130,204,259,55,55,1
"D09MK",8,369,"1200x900",800,2,600,400,"True",903,594,616,22,22,0
"D09MK",9,90,"1200x900",600,1,600,400,"False",560,474,131,-343,343,0
"D09MK",10,574,"1200x900",1000,1,600,400,"False",614,194,335,141,141,0
"D09MK",11,582,"1200x900",1000,2,600,400,"True",554,347,294,-53,53,0
"D09MK",12,591,"1200x900",1000,2,600,400,"True",698,336,291,-45,45,0
"D09MK",13,634,"1200x900",1000,2,600,400,"False",735,313,660,347,347,0
"D09MK",14,379,"1200x900",800,2,600,400,"False",994,325,681,356,356,0
"D09MK",15,243,"1200x900",800,0,600,400,"True",114,332,319,-13,13,1
"D09MK",16,25,"1200x900",600,0,600,400,"True",263,403,379,-24,24,1
"D09MK",17,282,"1200x900",800,0,600,400,"True",109,246,263,17,17,1
"D09MK",18,588,"1200x900",1000,2,600,400,"False",585,350,159,-191,191,0
"D09MK",19,457,"1200x900",1000,0,600,400,"False",97,630,449,-181,181,1
"D09MK",20,325,"1200x900",800,1,600,400,"True",105,394,396,2,2,0
"D09MK",21,6,"1200x900",600,0,600,400,"True",217,689,647,-42,42,1
"D09MK",22,587,"1200x900",1000,2,600,400,"False",741,686,471,-215,215,0
"D09MK",23,30,"1200x900",600,0,600,400,"True",107,353,395,42,42,0
"D09MK",24,113,"1200x900",600,1,600,400,"False",897,657,409,-248,248,0
"D09MK",25,359,"1200x900",800,1,600,400,"False",653,241,489,248,248,0
"D09MK",26,130,"1200x900",600,1,600,400,"True",741,428,450,22,22,0
"D09MK",27,340,"1200x900",800,1,600,400,"False",226,240,587,347,347,0
"D09MK",28,76,"1200x900",600,1,600,400,"True",647,614,663,49,49,0
"D09MK",29,106,"1200x900",600,1,600,400,"False",803,659,541,-118,118,1
"D09MK",30,606,"1200x900",1000,2,600,400,"False",653,627,718,91,91,0
"D09MK",31,144,"1200x900",600,1,600,400,"False",718,371,456,85,85,0
"D09MK",32,551,"1200x900",1000,1,600,400,"True",146,445,496,51,51,1
"D09MK",33,34,"1200x900",600,0,600,400,"True",361,242,200,-42,42,1
"D09MK",34,542,"1200x900",1000,1,600,400,"False",304,401,226,-175,175,0
"D09MK",35,92,"1200x900",600,1,600,400,"False",624,605,693,88,88,0
"D09MK",36,107,"1200x900",600,1,600,400,"False",878,678,586,-92,92,0
"D09MK",37,553,"1200x900",1000,1,600,400,"False",116,712,188,-524,524,0
"D09MK",38,594,"1200x900",1000,2,600,400,"False",537,637,506,-131,131,0
"D09MK",40,251,"1200x900",800,0,600,400,"True",88,352,411,59,59,1
"D09MK",41,544,"1200x900",1000,1,600,400,"False",602,620,453,-167,167,0
"D09MK",42,469,"1200x900",1000,0,600,400,"False",73,227,444,217,217,1
"D09MK",43,489,"1200x900",1000,0,600,400,"False",88,604,504,-100,100,1
"D09MK",44,39,"1200x900",600,0,600,400,"True",210,609,579,-30,30,0
"D09MK",45,205,"1200x900",600,2,600,400,"False",1021,504,679,175,175,0
"D09MK",46,363,"1200x900",800,2,600,400,"False",800,218,368,150,150,0
"D09MK",47,171,"1200x900",600,2,600,400,"False",909,200,118,-82,82,0
"D09MK",48,599,"1200x900",1000,2,600,400,"False",316,570,268,-302,302,0
"D09MK",49,228,"1200x900",800,0,600,400,"True",174,687,632,-55,55,1
"D09MK",50,193,"1200x900",600,2,600,400,"False",874,588,757,169,169,0
"D09MK",51,608,"1200x900",1000,2,600,400,"False",742,250,483,233,233,0
"D09MK",52,225,"1200x900",800,0,600,400,"True",178,423,373,-50,50,1
"D09MK",53,299,"1200x900",800,1,600,400,"False",779,274,738,464,464,0
"D09MK",54,179,"1200x900",600,2,600,400,"False",908,602,297,-305,305,0
"D09MK",55,447,"1200x900",1000,0,600,400,"True",71,339,382,43,43,1
"D09MK",56,23,"1200x900",600,0,600,400,"True",308,463,427,-36,36,1
"D09MK",57,586,"1200x900",1000,2,600,400,"False",802,262,482,220,220,0
"D09MK",58,53,"1200x900",600,0,600,400,"False",177,189,266,77,77,0
"D09MK",59,335,"1200x900",800,1,600,400,"False",124,360,540,180,180,0
"D09MK",60,358,"1200x900",800,1,600,400,"False",263,635,290,-345,345,0
"D09MK",61,376,"1200x900",800,2,600,400,"False",788,275,145,-130,130,0
"D09MK",62,374,"1200x900",800,2,600,400,"True",755,450,506,56,56,0
"D09MK",63,625,"1200x900",1000,2,600,400,"False",279,228,507,279,279,0
"D09MK",65,598,"1200x900",1000,2,600,400,"False",706,559,429,-130,130,0
"D09MK",66,392,"1200x900",800,2,600,400,"True",1031,618,668,50,50,0
"D09MK",67,188,"1200x900",600,2,600,400,"False",900,195,298,103,103,0
"D09MK",68,380,"1200x900",800,2,600,400,"True",942,228,198,-30,30,0
"D09MK",69,240,"1200x900",800,0,600,400,"False",330,656,486,-170,170,1
"D09MK",70,313,"1200x900",800,1,600,400,"True",588,421,478,57,57,0
"D09MK",71,644,"1200x900",1000,2,600,400,"False",495,486,640,154,154,0
"D09MK",72,264,"1200x900",800,0,600,400,"True",198,660,741,81,81,1
"D09MK",73,368,"1200x900",800,2,600,400,"False",778,515,670,155,155,0
"D09MK",74,61,"1200x900",600,0,600,400,"True",272,670,659,-11,11,1
"D09MK",75,579,"1200x900",1000,2,600,400,"False",803,394,660,266,266,0
"D09MK",76,381,"1200x900",800,2,600,400,"False",705,408,644,236,236,0
"D09MK",77,252,"1200x900",800,0,600,400,"True",224,673,751,78,78,1
"D09MK",78,499,"1200x900",1000,0,600,400,"False",93,271,461,190,190,1
"D09MK",79,387,"1200x900",800,2,600,400,"False",990,444,207,-237,237,0
"D09MK",80,250,"1200x900",800,0,600,400,"False",290,248,348,100,100,1
"D09MK",81,623,"1200x900",1000,2,600,400,"True",636,527,474,-53,53,0
"D09MK",82,418,"1200x900",800,2,600,400,"True",754,507,541,34,34,0
"D09MK",83,569,"1200x900",1000,1,600,400,"False",494,720,624,-96,96,0
"D09MK",84,399,"1200x900",800,2,600,400,"False",603,602,510,-92,92,0
"D09MK",85,137,"1200x900",600,1,600,400,"True",789,577,563,-14,14,0
"D09MK",86,524,"1200x900",1000,1,600,400,"False",534,470,706,236,236,0
"D09MK",87,515,"1200x900",1000,1,600,400,"False",307,217,483,266,266,0
"D09MK",88,601,"1200x900",1000,2,600,400,"False",735,697,278,-419,419,0
"D09MK",89,216,"1200x900",600,2,600,400,"True",1029,286,323,37,37,0
"D09MK",90,184,"1200x900",600,2,600,400,"False",1067,441,681,240,240,0
"D09MK",91,209,"1200x900",600,2,600,400,"True",937,637,597,-40,40,0
"D09MK",92,456,"1200x900",1000,0,600,400,"True",91,257,250,-7,7,1
"D09MK",93,630,"1200x900",1000,2,600,400,"False",754,559,431,-128,128,0
"D09MK",94,118,"1200x900",600,1,600,400,"False",190,588,767,179,179,0
"D09MK",95,52,"1200x900",600,0,600,400,"True",171,188,164,-24,24,0
"D09MK",96,627,"1200x900",1000,2,600,400,"False",760,510,312,-198,198,0
"D09MK",97,314,"1200x900",800,1,600,400,"False",277,616,403,-213,213,1
"D09MK",98,581,"1200x900",1000,2,600,400,"False",310,357,492,135,135,0
"D09MK",99,232,"1200x900",800,0,600,400,"False",84,511,427,-84,84,1
"D09MK",100,229,"1200x900",800,0,600,400,"False",117,697,550,-147,147,1
"D09MK",101,253,"1200x900",800,0,600,400,"True",177,424,482,58,58,1
"D09MK",102,65,"1200x900",600,0,600,400,"True",442,645,618,-27,27,1
"D09MK",103,329,"1200x900",800,1,600,400,"False",517,239,582,343,343,0
"D09MK",104,617,"1200x900",1000,2,600,400,"False",294,180,447,267,267,0
"D09MK",105,125,"1200x900",600,1,600,400,"False",750,531,456,-75,75,0
"D09MK",107,560,"1200x900",1000,1,600,400,"False",516,693,529,-164,164,0
"D09MK",108,642,"1200x900",1000,2,600,400,"False",776,316,442,126,126,0
"D09MK",109,120,"1200x900",600,1,600,400,"False",690,655,416,-239,239,0
"D09MK",110,463,"1200x900",1000,0,600,400,"True",115,693,653,-40,40,1
"D09MK",111,348,"1200x900",800,1,600,400,"False",764,294,387,93,93,0
"D09MK",112,354,"1200x900",800,1,600,400,"False",118,236,161,-75,75,0
"D09MK",113,637,"1200x900",1000,2,600,400,"True",750,460,485,25,25,0
"D09MK",115,504,"1200x900",1000,0,600,400,"False",107,699,540,-159,159,1
"D09MK",116,523,"1200x900",1000,1,600,400,"False",339,318,545,227,227,0
"D09MK",117,64,"1200x900",600,0,600,400,"True",102,339,282,-57,57,0
"D09MK",118,327,"1200x900",800,1,600,400,"False",152,339,236,-103,103,0
"D09MK",119,18,"1200x900",600,0,600,400,"True",400,318,295,-23,23,1
"D09MK",120,484,"1200x900",1000,0,600,400,"False",100,223,395,172,172,1
"D09MK",121,539,"1200x900",1000,1,600,400,"True",510,383,428,45,45,0
"D09MK",122,49,"1200x900",600,0,600,400,"True",109,380,397,17,17,0
"D09MK",123,640,"1200x900",1000,2,600,400,"False",361,334,417,83,83,0
"D09MK",124,511,"1200x900",1000,1,600,400,"True",408,390,397,7,7,1
"D09MK",125,401,"1200x900",800,2,600,400,"False",821,260,187,-73,73,0
"D09MK",126,256,"1200x900",800,0,600,400,"False",192,656,542,-114,114,1
"D09MK",127,280,"1200x900",800,0,600,400,"True",104,302,362,60,60,1
"D09MK",128,620,"1200x900",1000,2,600,400,"False",832,649,264,-385,385,0
"D09MK",129,402,"1200x900",800,2,600,400,"False",878,234,400,166,166,0
"D09MK",130,207,"1200x900",600,2,600,400,"True",838,235,312,77,77,0
"D09MK",131,10,"1200x900",600,0,600,400,"False",400,499,423,-76,76,1
"D09MK",132,54,"1200x900",600,0,600,400,"False",474,564,499,-65,65,1
"D09MK",133,80,"1200x900",600,1,600,400,"False",616,423,597,174,174,1
"D09MK",134,122,"1200x900",600,1,600,400,"False",817,709,617,-92,92,0
"D09MK",135,102,"1200x900",600,1,600,400,"False",861,603,677,74,74,0
"D09MK",136,616,"1200x900",1000,2,600,400,"True",854,357,396,39,39,1
"D09MK",139,347,"1200x900",800,1,600,400,"False",757,295,610,315,315,1
"D09MK",140,174,"1200x900",600,2,600,400,"False",998,457,318,-139,139,0
"D09MK",141,538,"1200x900",1000,1,600,400,"True",308,457,513,56,56,1
"D09MK",142,261,"1200x900",800,0,600,400,"False",86,713,637,-76,76,1
"D09MK",143,128,"1200x900",600,1,600,400,"False",661,258,143,-115,115,1
"D09MK",144,479,"1200x900",1000,0,600,400,"False",74,705,620,-85,85,1
"D09MK",145,68,"1200x900",600,0,600,400,"False",165,367,454,87,87,0
"D09MK",146,459,"1200x900",1000,0,600,400,"False",70,645,517,-128,128,1
"D09MK",147,638,"1200x900",1000,2,600,400,"False",385,198,386,188,188,0
"D09MK",148,67,"1200x900",600,0,600,400,"True",289,308,306,-2,2,1
"D09MK",150,273,"1200x900",800,0,600,400,"True",180,309,286,-23,23,1
"D09MK",151,580,"1200x900",1000,2,600,400,"False",651,267,394,127,127,0
"D09MK",153,152,"1200x900",600,2,600,400,"False",971,399,207,-192,192,0
"D09MK",154,521,"1200x900",1000,1,600,400,"False",111,303,508,205,205,1
"D09MK",155,157,"1200x900",600,2,600,400,"False",1016,323,509,186,186,0
"D09MK",156,370,"1200x900",800,2,600,400,"True",874,336,285,-51,51,0
"D09MK",158,259,"1200x900",800,0,600,400,"True",156,180,201,21,21,1
"D09MK",159,507,"1200x900",1000,1,600,400,"False",608,583,390,-193,193,1
"D09MK",160,296,"1200x900",800,1,600,400,"False",89,279,397,118,118,0
"D09MK",161,258,"1200x900",800,0,600,400,"True",126,664,657,-7,7,1
"D09MK",162,185,"1200x900",600,2,600,400,"False",907,212,625,413,413,0
"D09MK",163,235,"1200x900",800,0,600,400,"False",146,646,529,-117,117,1
"D09MK",164,73,"1200x900",600,1,600,400,"False",94,665,806,141,141,0
"D09MK",165,344,"1200x900",800,1,600,400,"False",589,408,646,238,238,0
"D09MK",166,169,"1200x900",600,2,600,400,"False",924,290,489,199,199,0
"D09MK",167,297,"1200x900",800,1,600,400,"True",625,244,249,5,5,0
"D09MK",168,143,"1200x900",600,1,600,400,"True",479,284,357,73,73,1
"D09MK",169,448,"1200x900",1000,0,600,400,"False",107,641,547,-94,94,1
"D09MK",170,277,"1200x900",800,0,600,400,"True",140,310,280,-30,30,1
"D09MK",171,255,"1200x900",800,0,600,400,"False",93,709,603,-106,106,1
"D09MK",172,622,"1200x900",1000,2,600,400,"False",307,683,517,-166,166,0
"D09MK",173,201,"1200x900",600,2,600,400,"True",1005,462,545,83,83,0
"D09MK",174,486,"1200x900",1000,0,600,400,"False",102,676,585,-91,91,1
"D09MK",175,175,"1200x900",600,2,600,400,"False",1028,432,221,-211,211,0
"D09MK",176,405,"1200x900",800,2,600,400,"False",790,307,540,233,233,0
"D09MK",177,59,"1200x900",600,0,600,400,"True",391,692,636,-56,56,1
"D09MK",178,48,"1200x900",600,0,600,400,"True",323,645,652,7,7,1
"D09MK",180,533,"1200x900",1000,1,600,400,"False",355,483,674,191,191,0
"D09MK",181,509,"1200x900",1000,1,600,400,"False",509,434,581,147,147,0
"D09MK",182,443,"1200x900",1000,0,600,400,"True",99,651,595,-56,56,1
"D09MK",183,301,"1200x900",800,1,600,400,"False",162,574,641,67,67,0
"D09MK",184,87,"1200x900",600,1,600,400,"True",231,604,584,-20,20,0
"D09MK",185,36,"1200x900",600,0,600,400,"False",128,346,455,109,109,1
"D09MK",186,508,"1200x900",1000,1,600,400,"True",596,485,447,-38,38,0
"D09MK",187,89,"1200x900",600,1,600,400,"True",917,366,424,58,58,1
"D09MK",188,487,"1200x900",1000,0,600,400,"False",78,670,533,-137,137,1
"D09MK",189,131,"1200x900",600,1,600,400,"False",531,367,770,403,403,0
"D09MK",190,557,"1200x900",1000,1,600,400,"False",677,505,685,180,180,1
"D09MK",191,610,"1200x900",1000,2,600,400,"False",702,293,579,286,286,0
"D09MK",192,422,"1200x900",800,2,600,400,"True",712,558,492,-66,66,0
"D09MK",193,19,"1200x900",600,0,600,400,"True",286,686,716,30,30,0
"D09MK",194,356,"1200x900",800,1,600,400,"False",123,484,591,107,107,0
"D09MK",195,316,"1200x900",800,1,600,400,"False",362,319,503,184,184,0
"D09MK",196,346,"1200x900",800,1,600,400,"False",269,635,453,-182,182,0
"D09MK",197,141,"1200x900",600,1,600,400,"False",671,582,452,-130,130,0
"D09MK",198,86,"1200x900",600,1,600,400,"False",692,388,480,92,92,1
"D09MK",199,481,"1200x900",1000,0,600,400,"False",80,185,250,65,65,1
"D09MK",200,183,"1200x900",600,2,600,400,"False",927,289,429,140,140,0
"D09MK",201,191,"1200x900",600,2,600,400,"True",962,396,353,-43,43,0
"D09MK",202,242,"1200x900",800,0,600,400,"True",117,448,430,-18,18,1
"D09MK",203,583,"1200x900",1000,2,600,400,"True",949,284,280,-4,4,1
"D09MK",204,274,"1200x900",800,0,600,400,"True",146,497,482,-15,15,1
"D09MK",205,199,"1200x900",600,2,600,400,"False",992,467,326,-141,141,0
"D09MK",206,140,"1200x900",600,1,600,400,"True",700,523,464,-59,59,0
"D09MK",207,490,"1200x900",1000,0,600,400,"True",114,183,222,39,39,1
"D09MK",208,115,"1200x900",600,1,600,400,"True",545,307,288,-19,19,0
"D09MK",209,119,"1200x900",600,1,600,400,"False",168,563,379,-184,184,0
"D09MK",210,604,"1200x900",1000,2,600,400,"True",459,593,538,-55,55,0
"D09MK",211,4,"1200x900",600,0,600,400,"True",602,200,146,-54,54,1
"D09MK",212,265,"1200x900",800,0,600,400,"True",229,353,330,-23,23,1
"D09MK",213,309,"1200x900",800,1,600,400,"False",186,225,391,166,166,0
"D09MK",214,57,"1200x900",600,0,600,400,"True",354,508,470,-38,38,1
"D09MK",215,136,"1200x900",600,1,600,400,"True",264,205,215,10,10,0
"D09MK",216,116,"1200x900",600,1,600,400,"False",767,289,174,-115,115,0
"D09MK",217,549,"1200x900",1000,1,600,400,"True",657,366,394,28,28,0
"D09MK",218,322,"1200x900",800,1,600,400,"False",703,206,409,203,203,1
"D09MK",219,45,"1200x900",600,0,600,400,"True",487,678,676,-2,2,1
"D09MK",220,181,"1200x900",600,2,600,400,"False",1018,223,512,289,289,0
"D09MK",221,146,"1200x900",600,2,600,400,"False",989,492,369,-123,123,0
"D09MK",222,592,"1200x900",1000,2,600,400,"True",492,392,455,63,63,0
"D09MK",223,28,"1200x900",600,0,600,400,"True",336,410,427,17,17,1
"D09MK",224,578,"1200x900",1000,2,600,400,"False",966,276,536,260,260,0
"D09MK",225,186,"1200x900",600,2,600,400,"False",997,197,578,381,381,0
"D09MK",226,323,"1200x900",800,1,600,400,"False",388,348,599,251,251,0
"D09MK",227,161,"1200x900",600,2,600,400,"True",939,553,591,38,38,0
"D09MK",228,168,"1200x900",600,2,600,400,"False",1001,439,562,123,123,0
"D09MK",229,396,"1200x900",800,2,600,400,"False",678,663,525,-138,138,0
"D09MK",230,283,"1200x900",800,0,600,400,"True",90,264,270,6,6,1
"D09MK",231,71,"1200x900",600,0,600,400,"True",219,248,276,28,28,0
"D09MK",232,492,"1200x900",1000,0,600,400,"False",76,692,495,-197,197,1
"D09MK",233,419,"1200x900",800,2,600,400,"False",769,351,516,165,165,0
"D09MK",234,570,"1200x900",1000,1,600,400,"True",315,352,409,57,57,0
"D09MK",235,395,"1200x900",800,2,600,400,"False",743,334,248,-86,86,0
"D09MK",236,331,"1200x900",800,1,600,400,"False",240,620,773,153,153,0
"D09MK",237,554,"1200x900",1000,1,600,400,"False",79,309,233,-76,76,1
"D09MK",238,466,"1200x900",1000,0,600,400,"True",82,205,255,50,50,1
"D09MK",239,527,"1200x900",1000,1,600,400,"False",565,601,450,-151,151,0
"D09MK",240,20,"1200x900",600,0,600,400,"True",204,545,582,37,37,1
"D09MK",241,17,"1200x900",600,0,600,400,"True",402,496,464,-32,32,1
"D09MK",242,26,"1200x900",600,0,600,400,"False",70,712,646,-66,66,0
"D09MK",243,410,"1200x900",800,2,600,400,"False",916,477,594,117,117,0
"D09MK",244,391,"1200x900",800,2,600,400,"True",895,521,473,-48,48,0
"D09MK",245,31,"1200x900",600,0,600,400,"True",365,338,379,41,41,1
"D09MK",246,121,"1200x900",600,1,600,400,"True",884,364,354,-10,10,0
"D09MK",247,212,"1200x900",600,2,600,400,"False",841,206,341,135,135,0
"D09MK",248,373,"1200x900",800,2,600,400,"True",694,326,291,-35,35,0
"D09MK",249,470,"1200x900",1000,0,600,400,"False",91,666,487,-179,179,1
"D09MK",250,472,"1200x900",1000,0,600,400,"False",77,685,545,-140,140,1
"D09MK",252,284,"1200x900",800,0,600,400,"False",135,293,373,80,80,1
"D09MK",253,420,"1200x900",800,2,600,400,"False",519,223,378,155,155,0
"D09MK",254,78,"1200x900",600,1,600,400,"False",885,684,830,146,146,0
"D09MK",255,99,"1200x900",600,1,600,400,"True",811,407,388,-19,19,0
"D09MK",256,41,"1200x900",600,0,600,400,"True",370,452,423,-29,29,1
"D09MK",258,268,"1200x900",800,0,600,400,"True",148,400,405,5,5,1
"D09MK",259,81,"1200x900",600,1,600,400,"False",696,225,374,149,149,0
"D09MK",260,303,"1200x900",800,1,600,400,"True",241,431,468,37,37,0
"D09MK",261,488,"1200x900",1000,0,600,400,"False",129,687,507,-180,180,1
"D09MK",262,238,"1200x900",800,0,600,400,"True",162,283,344,61,61,1
"D09MK",263,285,"1200x900",800,0,600,400,"True",237,396,373,-23,23,1
"D09MK",264,267,"1200x900",800,0,600,400,"False",145,665,581,-84,84,1
"D09MK",265,597,"1200x900",1000,2,600,400,"False",352,239,659,420,420,0
"D09MK",266,332,"1200x900",800,1,600,400,"False",260,699,758,59,59,0
"D09MK",267,529,"1200x900",1000,1,600,400,"False",267,412,547,135,135,1
"D09MK",268,58,"1200x900",600,0,600,400,"True",353,655,642,-13,13,1
"D09MK",269,535,"1200x900",1000,1,600,400,"False",372,410,601,191,191,0
"D09MK",270,552,"1200x900",1000,1,600,400,"False",255,412,648,236,236,0
"D09MK",271,198,"1200x900",600,2,600,400,"False",976,500,692,192,192,0
"D09MK",272,241,"1200x900",800,0,600,400,"True",129,227,246,19,19,1
"D09MK",273,142,"1200x900",600,1,600,400,"False",286,474,298,-176,176,0
"D09MK",275,353,"1200x900",800,1,600,400,"False",90,476,572,96,96,0
"D09MK",276,47,"1200x900",600,0,600,400,"True",303,499,500,1,1,1
"D09MK",278,440,"1200x900",1000,0,600,400,"True",71,237,280,43,43,1
"D09MK",279,352,"1200x900",800,1,600,400,"False",235,717,596,-121,121,0
"D09MK",280,589,"1200x900",1000,2,600,400,"False",856,418,620,202,202,0
"D09MK",281,593,"1200x900",1000,2,600,400,"False",246,719,576,-143,143,0
"D09MK",282,607,"1200x900",1000,2,600,400,"True",900,573,569,-4,4,1
"D09MK",284,434,"1200x900",1000,0,600,400,"False",89,657,568,-89,89,1
"D09MK",285,312,"1200x900",800,1,600,400,"True",238,683,645,-38,38,0
"D09MK",286,70,"1200x900",600,0,600,400,"True",309,703,676,-27,27,1
"D09MK",287,178,"1200x900",600,2,600,400,"False",1041,510,701,191,191,0
"D09MK",288,646,"1200x900",1000,2,600,400,"False",829,227,702,475,475,1
"D09MK",289,51,"1200x900",600,0,600,400,"True",272,181,212,31,31,1
"D09MK",290,104,"1200x900",600,1,600,400,"False",448,584,751,167,167,0
"D09MK",291,97,"1200x900",600,1,600,400,"True",760,643,573,-70,70,1
"D09MK",292,111,"1200x900",600,1,600,400,"True",922,552,538,-14,14,1
"D09MK",293,221,"1200x900",800,0,600,400,"True",132,520,520,0,0,1
"D09MK",294,194,"1200x900",600,2,600,400,"False",896,236,513,277,277,0
"D09MK",295,485,"1200x900",1000,0,600,400,"False",121,694,571,-123,123,1
"D09MK",296,233,"1200x900",800,0,600,400,"False",164,700,572,-128,128,1
"D09MK",298,196,"1200x900",600,2,600,400,"True",1030,397,394,-3,3,0
"D09MK",300,300,"1200x900",800,1,600,400,"False",620,693,404,-289,289,0
"D09MK",301,291,"1200x900",800,1,600,400,"False",522,694,544,-150,150,0
"D09MK",302,556,"1200x900",1000,1,600,400,"False",415,420,545,125,125,0
"D09MK",303,272,"1200x900",800,0,600,400,"True",200,181,178,-3,3,1
"D09MK",304,263,"1200x900",800,0,600,400,"False",82,396,309,-87,87,1
"D09MK",305,483,"1200x900",1000,0,600,400,"False",93,191,310,119,119,1
"D09MK",307,510,"1200x900",1000,1,600,400,"False",486,338,281,-57,57,1
"D09MK",308,482,"1200x900",1000,0,600,400,"False",79,686,416,-270,270,1
"D09MK",309,79,"1200x900",600,1,600,400,"False",731,289,415,126,126,0
"D09MK",310,647,"1200x900",1000,2,600,400,"False",560,637,383,-254,254,0
"D09MK",311,548,"1200x900",1000,1,600,400,"True",103,278,337,59,59,0
"D09MK",312,342,"1200x900",800,1,600,400,"False",677,204,349,145,145,0
"D09MK",313,555,"1200x900",1000,1,600,400,"False",444,556,440,-116,116,0
"D09MK",314,619,"1200x900",1000,2,600,400,"False",803,247,403,156,156,0
"D09MK",316,217,"1200x900",800,0,600,400,"False",85,573,760,187,187,1
"D09MK",317,585,"1200x900",1000,2,600,400,"True",698,688,675,-13,13,1
"D09MK",318,176,"1200x900",600,2,600,400,"False",1033,281,569,288,288,0
"D09MK",319,11,"1200x900",600,0,600,400,"True",372,670,628,-42,42,1
"D09MK",321,390,"1200x900",800,2,600,400,"True",982,674,594,-80,80,1
"D09MK",322,21,"1200x900",600,0,600,400,"True",314,383,442,59,59,1
"D09MK",323,302,"1200x900",800,1,600,400,"True",479,467,514,47,47,1
"D09MK",324,404,"1200x900",800,2,600,400,"True",842,396,438,42,42,0
"D09MK",325,480,"1200x900",1000,0,600,400,"False",100,231,304,73,73,1
"D09MK",326,77,"1200x900",600,1,600,400,"False",780,525,333,-192,192,0
"D09MK",327,14,"1200x900",600,0,600,400,"False",399,224,341,117,117,1
"D09MK",328,22,"1200x900",600,0,600,400,"True",398,591,529,-62,62,1
"D09MK",329,350,"1200x900",800,1,600,400,"True",182,566,536,-30,30,0
"D09MK",331,200,"1200x900",600,2,600,400,"False",897,302,465,163,163,0
"D09MK",332,565,"1200x900",1000,1,600,400,"True",451,562,553,-9,9,0
"D09MK",334,345,"1200x900",800,1,600,400,"False",841,566,707,141,141,1
"D09MK",335,584,"1200x900",1000,2,600,400,"False",731,413,601,188,188,0
"D09MK",336,513,"1200x900",1000,1,600,400,"False",235,602,50,-552,552,0
"D09MK",337,383,"1200x900",800,2,600,400,"False",855,407,850,443,443,0
"D09MK",338,436,"1200x900",1000,0,600,400,"False",82,617,534,-83,83,1
"D09MK",339,522,"1200x900",1000,1,600,400,"False",223,379,721,342,342,0
"D09MK",340,257,"1200x900",800,0,600,400,"True",97,219,227,8,8,1
"D09MK",341,462,"1200x900",1000,0,600,400,"False",102,672,441,-231,231,1
"D09MK",342,415,"1200x900",800,2,600,400,"False",823,684,470,-214,214,0
"D09MK",344,412,"1200x900",800,2,600,400,"False",842,280,479,199,199,0
"D09MK",346,279,"1200x900",800,0,600,400,"True",252,202,232,30,30,1
"D09MK",347,629,"1200x900",1000,2,600,400,"True",681,257,252,-5,5,0
"D09MK",348,621,"1200x900",1000,2,600,400,"True",540,478,424,-54,54,0
"D09MK",349,451,"1200x900",1000,0,600,400,"False",110,702,525,-177,177,1
"D09MK",350,643,"1200x900",1000,2,600,400,"False",740,325,553,228,228,0
"D09MK",352,426,"1200x900",800,2,600,400,"True",830,263,259,-4,4,0
"D09MK",353,3,"1200x900",600,0,600,400,"False",298,443,535,92,92,1
"D09MK",354,8,"1200x900",600,0,600,400,"False",156,679,538,-141,141,0
"D09MK",355,576,"1200x900",1000,1,600,400,"False",376,713,551,-162,162,0
"D09MK",356,151,"1200x900",600,2,600,400,"True",828,680,715,35,35,0
"D09MK",357,94,"1200x900",600,1,600,400,"False",729,482,627,145,145,0
"D09MK",358,573,"1200x900",1000,1,600,400,"True",486,615,626,11,11,0
"D09MK",359,432,"1200x900",800,2,600,400,"True",792,380,454,74,74,0
"D09MK",361,502,"1200x900",1000,0,600,400,"False",111,639,481,-158,158,1
"D09MK",362,433,"1200x900",1000,0,600,400,"False",76,222,297,75,75,1
"D09MK",363,109,"1200x900",600,1,600,400,"False",691,589,292,-297,297,0
"D09MK",364,417,"1200x900",800,2,600,400,"False",750,280,387,107,107,0
"D09MK",365,494,"1200x900",1000,0,600,400,"False",127,692,408,-284,284,1
"D09MK",366,166,"1200x900",600,2,600,400,"False",896,274,392,118,118,0
"D09MK",367,546,"1200x900",1000,1,600,400,"True",305,374,411,37,37,0
"D09MK",368,12,"1200x900",600,0,600,400,"True",365,336,389,53,53,1
"D09MK",369,444,"1200x900",1000,0,600,400,"False",101,714,574,-140,140,1
"D09MK",371,491,"1200x900",1000,0,600,400,"True",108,198,259,61,61,1
"D09MK",372,32,"1200x900",600,0,600,400,"True",152,563,616,53,53,1
"D09MK",374,537,"1200x900",1000,1,600,400,"False",621,412,597,185,185,1
"D09MK",375,15,"1200x900",600,0,600,400,"True",473,352,342,-10,10,1
"D09MK",376,375,"1200x900",800,2,600,400,"True",716,384,349,-35,35,0
"D09MK",377,360,"1200x900",800,1,600,400,"False",203,608,460,-148,148,0
"D09MK",378,471,"1200x900",1000,0,600,400,"False",122,200,296,96,96,1
"D09MK",379,294,"1200x900",800,1,600,400,"True",262,287,295,8,8,0
"D09MK",380,226,"1200x900",800,0,600,400,"True",187,229,269,40,40,1
"D09MK",381,397,"1200x900",800,2,600,400,"False",817,692,305,-387,387,0
"D09MK",382,602,"1200x900",1000,2,600,400,"False",865,452,369,-83,83,0
"D09MK",383,641,"1200x900",1000,2,600,400,"False",897,272,447,175,175,0
"D09MK",384,389,"1200x900",800,2,600,400,"False",843,530,419,-111,111,0
"D09MK",385,414,"1200x900",800,2,600,400,"False",831,592,438,-154,154,0
"D09MK",386,37,"1200x900",600,0,600,400,"False",258,403,484,81,81,1
"D09MK",387,639,"1200x900",1000,2,600,400,"True",504,456,465,9,9,0
"D09MK",388,497,"1200x900",1000,0,600,400,"False",106,696,507,-189,189,1
"D09MK",389,124,"1200x900",600,1,600,400,"True",345,467,508,41,41,0
"D09MK",390,438,"1200x900",1000,0,600,400,"False",77,713,565,-148,148,1
"D09MK",391,453,"1200x900",1000,0,600,400,"False",71,393,287,-106,106,1
"D09MK",392,355,"1200x900",800,1,600,400,"False",77,386,286,-100,100,0
"D09MK",393,164,"1200x900",600,2,600,400,"True",1051,268,345,77,77,0
"D09MK",394,460,"1200x900",1000,0,600,400,"True",155,189,209,20,20,1
"D09MK",395,382,"1200x900",800,2,600,400,"False",870,523,221,-302,302,0
"D09MK",396,540,"1200x900",1000,1,600,400,"False",389,568,329,-239,239,1
"D09MK",398,473,"1200x900",1000,0,600,400,"True",75,323,313,-10,10,1
"D09MK",399,33,"1200x900",600,0,600,400,"False",198,533,461,-72,72,1
"D09MK",400,245,"1200x900",800,0,600,400,"False",296,235,324,89,89,1
"D09MK",401,42,"1200x900",600,0,600,400,"True",233,479,489,10,10,0
"D09MK",402,278,"1200x900",800,0,600,400,"False",251,711,537,-174,174,1
"D09MK",403,501,"1200x900",1000,0,600,400,"False",96,323,241,-82,82,1
"D09MK",404,514,"1200x900",1000,1,600,400,"False",539,690,311,-379,379,0
"D09MK",405,195,"1200x900",600,2,600,400,"False",942,249,433,184,184,0
"D09MK",406,550,"1200x900",1000,1,600,400,"True",301,459,411,-48,48,0
"D09MK",407,135,"1200x900",600,1,600,400,"False",759,569,485,-84,84,0
"D09MK",408,75,"1200x900",600,1,600,400,"True",635,558,510,-48,48,0
"D09MK",410,290,"1200x900",800,1,600,400,"False",789,603,533,-70,70,0
"D09MK",411,408,"1200x900",800,2,600,400,"True",758,567,587,20,20,0
"D09MK",412,311,"1200x900",800,1,600,400,"False",710,261,660,399,399,0
"D09MK",413,603,"1200x900",1000,2,600,400,"False",693,280,661,381,381,0
"D09MK",416,105,"1200x900",600,1,600,400,"False",527,440,579,139,139,0
"D09MK",417,334,"1200x900",800,1,600,400,"True",481,665,621,-44,44,0
"D09MK",418,424,"1200x900",800,2,600,400,"False",903,545,418,-127,127,0
"D09MK",419,153,"1200x900",600,2,600,400,"True",1037,601,578,-23,23,0
"D09MK",420,618,"1200x900",1000,2,600,400,"False",276,671,440,-231,231,0
"D09MK",421,5,"1200x900",600,0,600,400,"True",228,587,591,4,4,0
"D09MK",422,96,"1200x900",600,1,600,400,"True",433,458,506,48,48,0
"D09MK",423,108,"1200x900",600,1,600,400,"False",830,239,456,217,217,0
"D09MK",426,247,"1200x900",800,0,600,400,"False",160,424,216,-208,208,1
"D09MK",428,236,"1200x900",800,0,600,400,"True",162,350,348,-2,2,1
"D09MK",429,145,"1200x900",600,2,600,400,"False",1004,630,349,-281,281,0
"D09MK",430,615,"1200x900",1000,2,600,400,"False",736,634,398,-236,236,0
"D09MK",431,500,"1200x900",1000,0,600,400,"False",105,700,580,-120,120,1
"D09MK",432,223,"1200x900",800,0,600,400,"True",179,191,195,4,4,1
"D09MK",433,281,"1200x900",800,0,600,400,"False",112,611,515,-96,96,1
"D09MK",434,475,"1200x900",1000,0,600,400,"False",101,715,597,-118,118,1
"D09MK",435,288,"1200x900",800,0,600,400,"True",180,547,506,-41,41,1
"D09MK",436,13,"1200x900",600,0,600,400,"True",296,211,235,24,24,1
"D09MK",437,384,"1200x900",800,2,600,400,"False",821,707,337,-370,370,0
"D09MK",438,496,"1200x900",1000,0,600,400,"True",70,639,585,-54,54,1
"D09MK",439,454,"1200x900",1000,0,600,400,"False",78,687,623,-64,64,1
"D09MK",440,40,"1200x900",600,0,600,400,"True",143,513,490,-23,23,0
"D09MK",441,442,"1200x900",1000,0,600,400,"False",87,183,270,87,87,1
"D09MK",442,24,"1200x900",600,0,600,400,"True",430,538,563,25,25,1
"D09MK",443,503,"1200x900",1000,0,600,400,"True",86,279,281,2,2,1
"D09MK",444,324,"1200x900",800,1,600,400,"False",719,712,464,-248,248,1
"D09MK",445,517,"1200x900",1000,1,600,400,"False",548,182,396,214,214,0
"D09MK",446,56,"1200x900",600,0,600,400,"False",148,491,344,-147,147,0
"D09MK",447,133,"1200x900",600,1,600,400,"False",345,551,325,-226,226,0
"D09MK",448,50,"1200x900",600,0,600,400,"False",75,582,700,118,118,0
"D09MK",449,600,"1200x900",1000,2,600,400,"False",765,207,550,343,343,0
"D09MK",450,465,"1200x900",1000,0,600,400,"False",85,203,358,155,155,1
"D09MK",451,430,"1200x900",800,2,600,400,"True",922,254,318,64,64,0
"D09MK",453,393,"1200x900",800,2,600,400,"False",657,620,367,-253,253,0
"D09MK",455,260,"1200x900",800,0,600,400,"False",103,525,732,207,207,1
"D09MK",456,170,"1200x900",600,2,600,400,"False",996,468,683,215,215,0
"D09MK",457,27,"1200x900",600,0,600,400,"True",373,309,342,33,33,1
"D09MK",458,477,"1200x900",1000,0,600,400,"False",88,640,473,-167,167,1
"D09MK",459,101,"1200x900",600,1,600,400,"False",541,656,726,70,70,0
"D09MK",460,439,"1200x900",1000,0,600,400,"False",110,229,318,89,89,1
"D09MK",461,190,"1200x900",600,2,600,400,"True",977,238,317,79,79,0
"D09MK",462,289,"1200x900",800,1,600,400,"True",421,703,741,38,38,1
"D09MK",463,123,"1200x900",600,1,600,400,"True",761,365,451,86,86,1
"D09MK",464,406,"1200x900",800,2,600,400,"False",971,233,431,198,198,0
"D09MK",465,541,"1200x900",1000,1,600,400,"True",339,478,429,-49,49,0
"D09MK",467,159,"1200x900",600,2,600,400,"True",992,309,370,61,61,0
"D09MK",468,117,"1200x900",600,1,600,400,"False",711,456,366,-90,90,0
"D09MK",469,498,"1200x900",1000,0,600,400,"True",100,260,282,22,22,1
"D09MK",471,139,"1200x900",600,1,600,400,"False",192,695,350,-345,345,0
"D09MK",472,398,"1200x900",800,2,600,400,"True",944,698,728,30,30,0
"D09MK",473,60,"1200x900",600,0,600,400,"False",365,213,339,126,126,1
"D09MK",474,528,"1200x900",1000,1,600,400,"False",839,227,647,420,420,1
"D09MK",475,230,"1200x900",800,0,600,400,"True",99,678,652,-26,26,1
"D09MK",476,319,"1200x900",800,1,600,400,"True",494,587,586,-1,1,1
"D09MK",478,409,"1200x900",800,2,600,400,"False",501,659,421,-238,238,0
"D09MK",479,525,"1200x900",1000,1,600,400,"False",123,690,609,-81,81,0
"D09MK",480,455,"1200x900",1000,0,600,400,"False",107,718,593,-125,125,1
"D09MK",481,305,"1200x900",800,1,600,400,"False",471,716,622,-94,94,0
"D09MK",482,449,"1200x900",1000,0,600,400,"False",105,683,598,-85,85,1
"D09MK",483,218,"1200x900",800,0,600,400,"True",106,397,462,65,65,1
"D09MK",484,44,"1200x900",600,0,600,400,"False",305,554,474,-80,80,1
"D09MK",485,571,"1200x900",1000,1,600,400,"True",239,522,535,13,13,1
"D09MK",486,431,"1200x900",800,2,600,400,"False",694,382,519,137,137,0
"D09MK",487,150,"1200x900",600,2,600,400,"False",897,345,459,114,114,0
"D09MK",488,134,"1200x900",600,1,600,400,"True",300,188,158,-30,30,0
"D09MK",489,339,"1200x900",800,1,600,400,"False",273,545,273,-272,272,1
"D09MK",490,386,"1200x900",800,2,600,400,"True",774,301,371,70,70,0
"D09MK",491,180,"1200x900",600,2,600,400,"True",929,270,261,-9,9,0
"D09MK",493,239,"1200x900",800,0,600,400,"False",114,231,318,87,87,1
"D09MK",494,110,"1200x900",600,1,600,400,"False",776,550,689,139,139,1
"D09MK",495,55,"1200x900",600,0,600,400,"False",211,305,438,133,133,1
"D09MK",496,271,"1200x900",800,0,600,400,"False",74,360,437,77,77,1
"D09MK",498,286,"1200x900",800,0,600,400,"True",105,378,388,10,10,1
"D09MK",499,234,"1200x900",800,0,600,400,"True",72,344,368,24,24,1
"D09MK",500,532,"1200x900",1000,1,600,400,"False",215,207,377,170,170,0
"D09MK",503,562,"1200x900",1000,1,600,400,"False",347,540,439,-101,101,0
"D09MK",504,351,"1200x900",800,1,600,400,"False",122,581,367,-214,214,0
"D09MK",505,372,"1200x900",800,2,600,400,"False",833,620,382,-238,238,0
"D09MK",506,72,"1200x900",600,0,600,400,"True",158,537,531,-6,6,0
"D09MK",507,88,"1200x900",600,1,600,400,"True",186,554,508,-46,46,0
"D09MK",508,62,"1200x900",600,0,600,400,"False",345,346,421,75,75,1
"D09MK",511,559,"1200x900",1000,1,600,400,"False",641,244,317,73,73,0
"D09MK",512,129,"1200x900",600,1,600,400,"False",859,482,338,-144,144,1
"D09MK",513,43,"1200x900",600,0,600,400,"False",277,446,581,135,135,1
"D09MK",515,266,"1200x900",800,0,600,400,"True",126,303,320,17,17,1
"D09MK",516,35,"1200x900",600,0,600,400,"True",366,555,491,-64,64,1
"D09MK",517,214,"1200x900",600,2,600,400,"False",1046,305,496,191,191,0
"D09MK",518,114,"1200x900",600,1,600,400,"True",183,697,642,-55,55,0
"D09MK",519,262,"1200x900",800,0,600,400,"True",196,481,495,14,14,1
"D09MK",520,93,"1200x900",600,1,600,400,"True",139,540,494,-46,46,0
"D09MK",521,526,"1200x900",1000,1,600,400,"True",497,710,722,12,12,0
"D09MK",522,254,"1200x900",800,0,600,400,"False",136,583,680,97,97,1
"D09MK",523,165,"1200x900",600,2,600,400,"False",912,554,651,97,97,0
"D09MK",524,249,"1200x900",800,0,600,400,"True",126,306,367,61,61,1
"D09MK",525,295,"1200x900",800,1,600,400,"True",471,334,307,-27,27,0
"D09MK",526,575,"1200x900",1000,1,600,400,"False",272,693,354,-339,339,0
"D09MK",527,476,"1200x900",1000,0,600,400,"True",76,359,397,38,38,1
"D09MK",528,82,"1200x900",600,1,600,400,"False",108,213,463,250,250,0
"D09MK",529,215,"1200x900",600,2,600,400,"False",939,596,498,-98,98,0
"D09MK",530,563,"1200x900",1000,1,600,400,"False",201,696,553,-143,143,0
"D09MK",532,220,"1200x900",800,0,600,400,"True",108,699,635,-64,64,1
"D09MK",533,536,"1200x900",1000,1,600,400,"False",580,213,400,187,187,0
"D09MK",534,162,"1200x900",600,2,600,400,"False",849,279,396,117,117,0
"D09MK",535,531,"1200x900",1000,1,600,400,"False",233,362,452,90,90,0
"D09MK",536,564,"1200x900",1000,1,600,400,"False",215,264,383,119,119,0
"D09MK",538,495,"1200x900",1000,0,600,400,"False",93,692,514,-178,178,1
"D09MK",539,349,"1200x900",800,1,600,400,"True",402,665,683,18,18,0
"D09MK",540,458,"1200x900",1000,0,600,400,"True",78,624,590,-34,34,1
"D09MK",541,100,"1200x900",600,1,600,400,"False",453,511,414,-97,97,0
"D09MK",542,287,"1200x900",800,0,600,400,"True",120,567,612,45,45,1
"D09MK",543,568,"1200x900",1000,1,600,400,"False",286,475,585,110,110,1
"D09MK",544,337,"1200x900",800,1,600,400,"True",299,622,529,-93,93,0
"D09MK",545,577,"1200x900",1000,2,600,400,"False",455,420,530,110,110,0
"D09MK",546,611,"1200x900",1000,2,600,400,"True",414,511,508,-3,3,0
"D09MK",548,441,"1200x900",1000,0,600,400,"False",85,684,592,-92,92,1
"D09MK",549,269,"1200x900",800,0,600,400,"False",160,295,444,149,149,1
"D09MK",550,304,"1200x900",800,1,600,400,"False",667,605,408,-197,197,0
"D09MK",551,74,"1200x900",600,1,600,400,"False",115,358,90,-268,268,0
"D09MK",552,547,"1200x900",1000,1,600,400,"True",369,384,385,1,1,1
"D09MK",553,127,"1200x900",600,1,600,400,"False",309,691,488,-203,203,0
"D09MK",554,306,"1200x900",800,1,600,400,"False",164,524,644,120,120,0
"D09MK",555,367,"1200x900",800,2,600,400,"True",613,464,495,31,31,0
"D09MK",556,1,"1200x900",600,0,600,400,"True",136,502,477,-25,25,0
"D09MK",557,91,"1200x900",600,1,600,400,"False",417,630,478,-152,152,1
"D09MK",559,231,"1200x900",800,0,600,400,"True",251,718,752,34,34,1
"D09MK",560,160,"1200x900",600,2,600,400,"False",863,606,697,91,91,0
"D09MK",561,276,"1200x900",800,0,600,400,"False",281,217,441,224,224,1
"D09MK",562,2,"1200x900",600,0,600,400,"True",159,323,318,-5,5,0
"D09MK",563,298,"1200x900",800,1,600,400,"False",311,457,383,-74,74,0
"D09MK",564,530,"1200x900",1000,1,600,400,"False",584,405,133,-272,272,1
"D09MK",565,156,"1200x900",600,2,600,400,"False",913,197,411,214,214,0
"D09MK",566,338,"1200x900",800,1,600,400,"False",813,253,377,124,124,1
"D09MK",567,566,"1200x900",1000,1,600,400,"True",378,472,426,-46,46,1
"D09MK",569,635,"1200x900",1000,2,600,400,"True",833,402,408,6,6,0
"D09MK",570,248,"1200x900",800,0,600,400,"True",94,240,172,-68,68,1
"D09MK",571,519,"1200x900",1000,1,600,400,"False",319,565,396,-169,169,1
"D09MK",572,394,"1200x900",800,2,600,400,"False",847,292,416,124,124,0
"D09MK",573,423,"1200x900",800,2,600,400,"True",1051,710,693,-17,17,1
"D09MK",574,474,"1200x900",1000,0,600,400,"True",85,339,377,38,38,1
"D09MK",575,317,"1200x900",800,1,600,400,"True",185,564,520,-44,44,0
"D09MK",576,378,"1200x900",800,2,600,400,"False",1018,708,519,-189,189,0
"D09MK",577,336,"1200x900",800,1,600,400,"True",251,587,506,-81,81,0
"D09MK",581,506,"1200x900",1000,1,600,400,"True",559,567,552,-15,15,1
"D09MK",582,534,"1200x900",1000,1,600,400,"True",328,504,517,13,13,1
"D09MK",583,516,"1200x900",1000,1,600,400,"True",440,559,524,-35,35,0
"D09MK",584,613,"1200x900",1000,2,600,400,"True",690,374,440,66,66,0
"D09MK",585,84,"1200x900",600,1,600,400,"False",144,184,300,116,116,0
"D09MK",586,429,"1200x900",800,2,600,400,"False",682,692,380,-312,312,0
"D09MK",587,308,"1200x900",800,1,600,400,"False",437,425,498,73,73,0
"D09MK",588,437,"1200x900",1000,0,600,400,"True",74,667,617,-50,50,1
"D09MK",589,572,"1200x900",1000,1,600,400,"False",302,260,404,144,144,0
"D09MK",590,388,"1200x900",800,2,600,400,"True",930,320,374,54,54,0
"D09MK",591,7,"1200x900",600,0,600,400,"False",431,654,735,81,81,1
"D09MK",592,567,"1200x900",1000,1,600,400,"False",655,297,125,-172,172,1
"D09MK",593,357,"1200x900",800,1,600,400,"False",109,594,315,-279,279,0
"D09MK",594,365,"1200x900",800,2,600,400,"False",1055,305,399,94,94,0
"D09MK",595,633,"1200x900",1000,2,600,400,"False",564,253,413,160,160,0
"D09MK",596,149,"1200x900",600,2,600,400,"False",890,289,419,130,130,0
"D09MK",597,512,"1200x900",1000,1,600,400,"False",139,261,379,118,118,0
"D09MK",598,377,"1200x900",800,2,600,400,"False",683,388,523,135,135,0
"D09MK",599,222,"1200x900",800,0,600,400,"True",152,206,211,5,5,1
"D09MK",600,83,"1200x900",600,1,600,400,"True",763,568,590,22,22,1
"D09MK",601,155,"1200x900",600,2,600,400,"False",940,269,651,382,382,0
"D09MK",602,505,"1200x900",1000,1,600,400,"False",191,484,578,94,94,1
"D09MK",603,98,"1200x900",600,1,600,400,"True",625,530,502,-28,28,0
"D09MK",604,464,"1200x900",1000,0,600,400,"True",82,222,162,-60,60,1
"D09MK",605,126,"1200x900",600,1,600,400,"False",849,354,165,-189,189,0
"D09MK",606,66,"1200x900",600,0,600,400,"True",155,673,648,-25,25,0
"D09MK",607,210,"1200x900",600,2,600,400,"False",835,506,634,128,128,0
"D09MK",608,173,"1200x900",600,2,600,400,"True",948,693,622,-71,71,0
"D09MK",609,445,"1200x900",1000,0,600,400,"False",78,302,611,309,309,1
"D09MK",610,446,"1200x900",1000,0,600,400,"True",72,298,288,-10,10,1
"D09MK",611,320,"1200x900",800,1,600,400,"True",644,376,382,6,6,0
"D09MK",612,318,"1200x900",800,1,600,400,"True",788,534,501,-33,33,0
"D09MK",613,366,"1200x900",800,2,600,400,"False",931,464,403,-61,61,0
"D09MK",614,85,"1200x900",600,1,600,400,"False",434,347,695,348,348,0
"D09MK",615,29,"1200x900",600,0,600,400,"True",385,533,525,-8,8,1
"D09MK",616,246,"1200x900",800,0,600,400,"False",196,418,494,76,76,1
"D09MK",617,38,"1200x900",600,0,600,400,"False",120,628,850,222,222,1
"D09MK",619,645,"1200x900",1000,2,600,400,"False",619,396,604,208,208,0
"D09MK",620,16,"1200x900",600,0,600,400,"False",297,514,285,-229,229,1
"D09MK",621,63,"1200x900",600,0,600,400,"True",311,188,200,12,12,1
"D09MK",622,435,"1200x900",1000,0,600,400,"True",119,200,181,-19,19,1
"D09MK",623,614,"1200x900",1000,2,600,400,"False",823,563,219,-344,344,0
"D09MK",624,275,"1200x900",800,0,600,400,"True",120,594,603,9,9,0
"D09MK",625,632,"1200x900",1000,2,600,400,"False",984,227,675,448,448,0
"D09MK",626,371,"1200x900",800,2,600,400,"False",730,560,322,-238,238,0
"D09MK",627,244,"1200x900",800,0,600,400,"True",194,203,198,-5,5,1
"D09MK",628,648,"1200x900",1000,2,600,400,"False",557,394,317,-77,77,0
"D09MK",629,46,"1200x900",600,0,600,400,"True",193,355,328,-27,27,1
"D09MK",630,192,"1200x900",600,2,600,400,"False",1064,320,456,136,136,0
"D09MK",631,330,"1200x900",800,1,600,400,"True",759,301,296,-5,5,1
"D09MK",632,341,"1200x900",800,1,600,400,"True",735,632,591,-41,41,1
"D09MK",633,154,"1200x900",600,2,600,400,"True",941,454,508,54,54,0
"D09MK",634,428,"1200x900",800,2,600,400,"False",732,665,474,-191,191,0
"D09MK",635,468,"1200x900",1000,0,600,400,"False",121,219,295,76,76,1
"D09MK",637,595,"1200x900",1000,2,600,400,"False",687,640,270,-370,370,0
"D09MK",638,343,"1200x900",800,1,600,400,"False",407,557,372,-185,185,0
"D09MK",641,461,"1200x900",1000,0,600,400,"False",95,711,598,-113,113,1
"D09MK",642,452,"1200x900",1000,0,600,400,"True",97,273,251,-22,22,1
"D09MK",643,631,"1200x900",1000,2,600,400,"False",699,479,561,82,82,0
"D09MK",644,138,"1200x900",600,1,600,400,"True",844,580,524,-56,56,1
"D09MK",645,307,"1200x900",800,1,600,400,"False",716,247,373,126,126,0
"D09MK",646,467,"1200x900",1000,0,600,400,"False",74,712,602,-110,110,1
"D09MK",647,628,"1200x900",1000,2,600,400,"False",768,410,502,92,92,0
"D09MK",648,520,"1200x900",1000,1,600,400,"False",564,260,361,101,101,0
"D10RT",1,49,"1200x900",600,0,600,400,"True",109,380,436,56,56,0
"D10RT",2,22,"1200x900",600,0,600,400,"True",398,591,563,-28,28,1
"D10RT",3,586,"1200x900",1000,2,600,400,"False",802,262,415,153,153,0
"D10RT",4,414,"1200x900",800,2,600,400,"False",831,592,237,-355,355,0
"D10RT",5,206,"1200x900",600,2,600,400,"False",975,223,357,134,134,0
"D10RT",6,531,"1200x900",1000,1,600,400,"False",233,362,560,198,198,0
"D10RT",7,359,"1200x900",800,1,600,400,"False",653,241,376,135,135,0
"D10RT",8,474,"1200x900",1000,0,600,400,"False",85,339,431,92,92,1
"D10RT",9,238,"1200x900",800,0,600,400,"True",162,283,347,64,64,1
"D10RT",10,513,"1200x900",1000,1,600,400,"False",235,602,455,-147,147,0
"D10RT",11,534,"1200x900",1000,1,600,400,"False",328,504,197,-307,307,1
"D10RT",12,592,"1200x900",1000,2,600,400,"False",492,392,590,198,198,0
"D10RT",13,515,"1200x900",1000,1,600,400,"False",307,217,338,121,121,0
"D10RT",14,72,"1200x900",600,0,600,400,"True",158,537,547,10,10,0
"D10RT",15,122,"1200x900",600,1,600,400,"False",817,709,566,-143,143,0
"D10RT",16,645,"1200x900",1000,2,600,400,"False",619,396,254,-142,142,0
"D10RT",17,119,"1200x900",600,1,600,400,"False",168,563,332,-231,231,0
"D10RT",18,37,"1200x900",600,0,600,400,"True",258,403,372,-31,31,1
"D10RT",19,633,"1200x900",1000,2,600,400,"False",564,253,471,218,218,0
"D10RT",20,381,"1200x900",800,2,600,400,"True",705,408,433,25,25,0
"D10RT",21,266,"1200x900",800,0,600,400,"False",126,303,423,120,120,1
"D10RT",22,330,"1200x900",800,1,600,400,"False",759,301,202,-99,99,1
"D10RT",23,416,"1200x900",800,2,600,400,"False",748,617,238,-379,379,0
"D10RT",24,431,"1200x900",800,2,600,400,"False",694,382,273,-109,109,0
"D10RT",25,623,"1200x900",1000,2,600,400,"False",636,527,353,-174,174,0
"D10RT",26,115,"1200x900",600,1,600,400,"False",545,307,492,185,185,0
"D10RT",27,240,"1200x900",800,0,600,400,"False",330,656,557,-99,99,1
"D10RT",28,387,"1200x900",800,2,600,400,"True",990,444,514,70,70,0
"D10RT",29,61,"1200x900",600,0,600,400,"True",272,670,627,-43,43,1
"D10RT",30,344,"1200x900",800,1,600,400,"False",589,408,545,137,137,0
"D10RT",31,292,"1200x900",800,1,600,400,"True",88,565,491,-74,74,0
"D10RT",32,441,"1200x900",1000,0,600,400,"True",85,684,654,-30,30,1
"D10RT",33,483,"1200x900",1000,0,600,400,"False",93,191,466,275,275,1
"D10RT",34,352,"1200x900",800,1,600,400,"False",235,717,443,-274,274,0
"D10RT",35,222,"1200x900",800,0,600,400,"False",152,206,396,190,190,1
"D10RT",36,145,"1200x900",600,2,600,400,"True",1004,630,563,-67,67,0
"D10RT",37,490,"1200x900",1000,0,600,400,"False",114,183,420,237,237,1
"D10RT",38,53,"1200x900",600,0,600,400,"False",177,189,271,82,82,0
"D10RT",39,176,"1200x900",600,2,600,400,"True",1033,281,245,-36,36,0
"D10RT",40,244,"1200x900",800,0,600,400,"True",194,203,243,40,40,1
"D10RT",41,512,"1200x900",1000,1,600,400,"False",139,261,321,60,60,0
"D10RT",42,218,"1200x900",800,0,600,400,"True",106,397,351,-46,46,1
"D10RT",43,161,"1200x900",600,2,600,400,"True",939,553,480,-73,73,0
"D10RT",44,540,"1200x900",1000,1,600,400,"True",389,568,510,-58,58,1
"D10RT",45,25,"1200x900",600,0,600,400,"True",263,403,452,49,49,1
"D10RT",46,632,"1200x900",1000,2,600,400,"False",984,227,671,444,444,0
"D10RT",47,235,"1200x900",800,0,600,400,"False",146,646,540,-106,106,1
"D10RT",48,120,"1200x900",600,1,600,400,"True",690,655,596,-59,59,0
"D10RT",49,52,"1200x900",600,0,600,400,"True",171,188,212,24,24,0
"D10RT",50,611,"1200x900",1000,2,600,400,"False",414,511,328,-183,183,0
"D10RT",51,609,"1200x900",1000,2,600,400,"False",697,627,373,-254,254,0
"D10RT",52,219,"1200x900",800,0,600,400,"True",202,502,484,-18,18,1
"D10RT",53,378,"1200x900",800,2,600,400,"False",1018,708,405,-303,303,0
"D10RT",54,524,"1200x900",1000,1,600,400,"False",534,470,712,242,242,0
"D10RT",55,335,"1200x900",800,1,600,400,"False",124,360,466,106,106,0
"D10RT",56,283,"1200x900",800,0,600,400,"True",90,264,289,25,25,1
"D10RT",57,447,"1200x900",1000,0,600,400,"True",71,339,321,-18,18,1
"D10RT",58,415,"1200x900",800,2,600,400,"False",823,684,418,-266,266,0
"D10RT",59,311,"1200x900",800,1,600,400,"False",710,261,531,270,270,0
"D10RT",60,433,"1200x900",1000,0,600,400,"True",76,222,249,27,27,1
"D10RT",61,27,"1200x900",600,0,600,400,"True",373,309,274,-35,35,1
"D10RT",62,5,"1200x900",600,0,600,400,"True",228,587,539,-48,48,0
"D10RT",63,213,"1200x900",600,2,600,400,"False",822,275,491,216,216,0
"D10RT",64,41,"1200x900",600,0,600,400,"True",370,452,465,13,13,1
"D10RT",65,38,"1200x900",600,0,600,400,"False",120,628,523,-105,105,1
"D10RT",66,532,"1200x900",1000,1,600,400,"False",215,207,328,121,121,0
"D10RT",67,140,"1200x900",600,1,600,400,"True",700,523,507,-16,16,0
"D10RT",68,156,"1200x900",600,2,600,400,"False",913,197,355,158,158,0
"D10RT",69,375,"1200x900",800,2,600,400,"False",716,384,249,-135,135,0
"D10RT",70,116,"1200x900",600,1,600,400,"True",767,289,376,87,87,0
"D10RT",71,638,"1200x900",1000,2,600,400,"True",385,198,207,9,9,0
"D10RT",72,506,"1200x900",1000,1,600,400,"False",559,567,409,-158,158,1
"D10RT",73,551,"1200x900",1000,1,600,400,"True",146,445,473,28,28,1
"D10RT",74,301,"1200x900",800,1,600,400,"False",162,574,412,-162,162,0
"D10RT",76,272,"1200x900",800,0,600,400,"False",200,181,352,171,171,1
"D10RT",77,153,"1200x900",600,2,600,400,"True",1037,601,531,-70,70,0
"D10RT",78,507,"1200x900",1000,1,600,400,"True",608,583,619,36,36,1
"D10RT",79,591,"1200x900",1000,2,600,400,"False",698,336,612,276,276,0
"D10RT",80,404,"1200x900",800,2,600,400,"True",842,396,439,43,43,0
"D10RT",81,228,"1200x900",800,0,600,400,"True",174,687,633,-54,54,1
"D10RT",82,139,"1200x900",600,1,600,400,"True",192,695,648,-47,47,0
"D10RT",83,18,"1200x900",600,0,600,400,"False",400,318,442,124,124,1
"D10RT",84,158,"1200x900",600,2,600,400,"False",939,300,431,131,131,0
"D10RT",85,473,"1200x900",1000,0,600,400,"False",75,323,461,138,138,1
"D10RT",86,564,"1200x900",1000,1,600,400,"True",215,264,324,60,60,0
"D10RT",87,602,"1200x900",1000,2,600,400,"False",865,452,270,-182,182,0
"D10RT",88,134,"1200x900",600,1,600,400,"True",300,188,61,-127,127,0
"D10RT",89,252,"1200x900",800,0,600,400,"False",224,673,520,-153,153,1
"D10RT",90,67,"1200x900",600,0,600,400,"True",289,308,353,45,45,1
"D10RT",91,298,"1200x900",800,1,600,400,"False",311,457,266,-191,191,0
"D10RT",92,622,"1200x900",1000,2,600,400,"False",307,683,489,-194,194,0
"D10RT",93,603,"1200x900",1000,2,600,400,"False",693,280,172,-108,108,0
"D10RT",94,568,"1200x900",1000,1,600,400,"False",286,475,328,-147,147,1
"D10RT",95,310,"1200x900",800,1,600,400,"False",559,592,314,-278,278,0
"D10RT",96,380,"1200x900",800,2,600,400,"True",942,228,215,-13,13,0
"D10RT",97,587,"1200x900",1000,2,600,400,"False",741,686,356,-330,330,0
"D10RT",98,437,"1200x900",1000,0,600,400,"False",74,667,572,-95,95,1
"D10RT",100,482,"1200x900",1000,0,600,400,"False",79,686,590,-96,96,1
"D10RT",101,316,"1200x900",800,1,600,400,"False",362,319,498,179,179,0
"D10RT",102,477,"1200x900",1000,0,600,400,"False",88,640,562,-78,78,1
"D10RT",103,435,"1200x900",1000,0,600,400,"False",119,200,452,252,252,1
"D10RT",104,46,"1200x900",600,0,600,400,"True",193,355,335,-20,20,1
"D10RT",105,286,"1200x900",800,0,600,400,"True",105,378,318,-60,60,1
"D10RT",106,200,"1200x900",600,2,600,400,"False",897,302,200,-102,102,0
"D10RT",107,398,"1200x900",800,2,600,400,"False",944,698,495,-203,203,0
"D10RT",108,74,"1200x900",600,1,600,400,"False",115,358,50,-308,308,0
"D10RT",109,445,"1200x900",1000,0,600,400,"False",78,302,516,214,214,1
"D10RT",110,450,"1200x900",1000,0,600,400,"False",130,204,395,191,191,1
"D10RT",111,243,"1200x900",800,0,600,400,"True",114,332,335,3,3,1
"D10RT",112,424,"1200x900",800,2,600,400,"False",903,545,376,-169,169,0
"D10RT",113,446,"1200x900",1000,0,600,400,"True",72,298,225,-73,73,1
"D10RT",114,419,"1200x900",800,2,600,400,"True",769,351,302,-49,49,0
"D10RT",115,307,"1200x900",800,1,600,400,"True",716,247,296,49,49,0
"D10RT",116,229,"1200x900",800,0,600,400,"False",117,697,483,-214,214,1
"D10RT",117,264,"1200x900",800,0,600,400,"True",198,660,625,-35,35,1
"D10RT",118,106,"1200x900",600,1,600,400,"False",803,659,589,-70,70,1
"D10RT",119,523,"1200x900",1000,1,600,400,"True",339,318,341,23,23,0
"D10RT",120,629,"1200x900",1000,2,600,400,"False",681,257,563,306,306,0
"D10RT",121,350,"1200x900",800,1,600,400,"False",182,566,385,-181,181,0
"D10RT",122,619,"1200x900",1000,2,600,400,"False",803,247,379,132,132,0
"D10RT",123,28,"1200x900",600,0,600,400,"False",336,410,502,92,92,1
"D10RT",124,502,"1200x900",1000,0,600,400,"False",111,639,561,-78,78,1
"D10RT",125,54,"1200x900",600,0,600,400,"True",474,564,537,-27,27,1
"D10RT",126,135,"1200x900",600,1,600,400,"True",759,569,514,-55,55,0
"D10RT",127,3,"1200x900",600,0,600,400,"True",298,443,502,59,59,1
"D10RT",128,577,"1200x900",1000,2,600,400,"True",455,420,481,61,61,0
"D10RT",129,466,"1200x900",1000,0,600,400,"False",82,205,360,155,155,1
"D10RT",130,559,"1200x900",1000,1,600,400,"False",641,244,389,145,145,0
"D10RT",131,205,"1200x900",600,2,600,400,"True",1021,504,490,-14,14,0
"D10RT",132,290,"1200x900",800,1,600,400,"False",789,603,486,-117,117,0
"D10RT",133,250,"1200x900",800,0,600,400,"True",290,248,297,49,49,1
"D10RT",134,45,"1200x900",600,0,600,400,"False",487,678,541,-137,137,1
"D10RT",135,455,"1200x900",1000,0,600,400,"False",107,718,624,-94,94,1
"D10RT",136,104,"1200x900",600,1,600,400,"False",448,584,665,81,81,0
"D10RT",137,605,"1200x900",1000,2,600,400,"False",493,665,492,-173,173,0
"D10RT",138,226,"1200x900",800,0,600,400,"False",187,229,299,70,70,1
"D10RT",139,423,"1200x900",800,2,600,400,"False",1051,710,546,-164,164,1
"D10RT",140,147,"1200x900",600,2,600,400,"False",942,418,514,96,96,0
"D10RT",141,470,"1200x900",1000,0,600,400,"False",91,666,501,-165,165,1
"D10RT",142,621,"1200x900",1000,2,600,400,"True",540,478,506,28,28,0
"D10RT",143,230,"1200x900",800,0,600,400,"False",99,678,602,-76,76,1
"D10RT",144,557,"1200x900",1000,1,600,400,"False",677,505,578,73,73,1
"D10RT",145,208,"1200x900",600,2,600,400,"False",946,399,573,174,174,0
"D10RT",146,29,"1200x900",600,0,600,400,"True",385,533,557,24,24,1
"D10RT",147,191,"1200x900",600,2,600,400,"True",962,396,341,-55,55,0
"D10RT",148,647,"1200x900",1000,2,600,400,"False",560,637,472,-165,165,0
"D10RT",149,396,"1200x900",800,2,600,400,"False",678,663,584,-79,79,0
"D10RT",150,183,"1200x900",600,2,600,400,"True",927,289,368,79,79,0
"D10RT",151,373,"1200x900",800,2,600,400,"False",694,326,482,156,156,0
"D10RT",152,299,"1200x900",800,1,600,400,"False",779,274,578,304,304,0
"D10RT",153,449,"1200x900",1000,0,600,400,"False",105,683,589,-94,94,1
"D10RT",154,627,"1200x900",1000,2,600,400,"False",760,510,612,102,102,0
"D10RT",155,58,"1200x900",600,0,600,400,"True",353,655,642,-13,13,1
"D10RT",157,257,"1200x900",800,0,600,400,"False",97,219,334,115,115,1
"D10RT",158,187,"1200x900",600,2,600,400,"False",857,639,338,-301,301,0
"D10RT",159,33,"1200x900",600,0,600,400,"True",198,533,525,-8,8,1
"D10RT",160,333,"1200x900",800,1,600,400,"False",521,548,693,145,145,0
"D10RT",161,454,"1200x900",1000,0,600,400,"True",78,687,725,38,38,1
"D10RT",162,174,"1200x900",600,2,600,400,"True",998,457,420,-37,37,0
"D10RT",163,481,"1200x900",1000,0,600,400,"False",80,185,356,171,171,1
"D10RT",164,537,"1200x900",1000,1,600,400,"False",621,412,653,241,241,1
"D10RT",165,410,"1200x900",800,2,600,400,"False",916,477,279,-198,198,0
"D10RT",166,443,"1200x900",1000,0,600,400,"False",99,651,430,-221,221,1
"D10RT",167,634,"1200x900",1000,2,600,400,"True",735,313,327,14,14,0
"D10RT",168,113,"1200x900",600,1,600,400,"False",897,657,585,-72,72,0
"D10RT",169,154,"1200x900",600,2,600,400,"False",941,454,222,-232,232,0
"D10RT",170,184,"1200x900",600,2,600,400,"False",1067,441,659,218,218,0
"D10RT",171,40,"1200x900",600,0,600,400,"True",143,513,521,8,8,0
"D10RT",172,397,"1200x900",800,2,600,400,"False",817,692,522,-170,170,0
"D10RT",173,199,"1200x900",600,2,600,400,"True",992,467,464,-3,3,0
"D10RT",174,610,"1200x900",1000,2,600,400,"False",702,293,406,113,113,0
"D10RT",175,269,"1200x900",800,0,600,400,"True",160,295,321,26,26,1
"D10RT",176,21,"1200x900",600,0,600,400,"True",314,383,345,-38,38,1
"D10RT",177,308,"1200x900",800,1,600,400,"False",437,425,489,64,64,0
"D10RT",178,432,"1200x900",800,2,600,400,"True",792,380,332,-48,48,0
"D10RT",179,508,"1200x900",1000,1,600,400,"True",596,485,441,-44,44,0
"D10RT",180,302,"1200x900",800,1,600,400,"True",479,467,495,28,28,1
"D10RT",181,34,"1200x900",600,0,600,400,"True",361,242,281,39,39,1
"D10RT",182,543,"1200x900",1000,1,600,400,"False",88,202,350,148,148,0
"D10RT",183,364,"1200x900",800,2,600,400,"False",1018,204,404,200,200,0
"D10RT",184,165,"1200x900",600,2,600,400,"False",912,554,405,-149,149,0
"D10RT",185,580,"1200x900",1000,2,600,400,"False",651,267,402,135,135,0
"D10RT",186,276,"1200x900",800,0,600,400,"False",281,217,407,190,190,1
"D10RT",187,260,"1200x900",800,0,600,400,"False",103,525,414,-111,111,1
"D10RT",188,492,"1200x900",1000,0,600,400,"False",76,692,460,-232,232,1
"D10RT",189,44,"1200x900",600,0,600,400,"True",305,554,503,-51,51,1
"D10RT",190,89,"1200x900",600,1,600,400,"True",917,366,344,-22,22,1
"D10RT",192,369,"1200x900",800,2,600,400,"False",903,594,406,-188,188,0
"D10RT",193,465,"1200x900",1000,0,600,400,"False",85,203,294,91,91,1
"D10RT",194,499,"1200x900",1000,0,600,400,"True",93,271,214,-57,57,1
"D10RT",195,251,"1200x900",800,0,600,400,"False",88,352,212,-140,140,1
"D10RT",196,193,"1200x900",600,2,600,400,"False",874,588,339,-249,249,0
"D10RT",197,624,"1200x900",1000,2,600,400,"False",693,501,384,-117,117,0
"D10RT",198,472,"1200x900",1000,0,600,400,"False",77,685,509,-176,176,1
"D10RT",199,111,"1200x900",600,1,600,400,"False",922,552,670,118,118,1
"D10RT",200,185,"1200x900",600,2,600,400,"True",907,212,232,20,20,0
"D10RT",201,342,"1200x900",800,1,600,400,"False",677,204,358,154,154,0
"D10RT",202,180,"1200x900",600,2,600,400,"True",929,270,337,67,67,0
"D10RT",203,616,"1200x900",1000,2,600,400,"True",854,357,334,-23,23,1
"D10RT",204,503,"1200x900",1000,0,600,400,"True",86,279,231,-48,48,1
"D10RT",206,618,"1200x900",1000,2,600,400,"False",276,671,529,-142,142,0
"D10RT",207,91,"1200x900",600,1,600,400,"True",417,630,581,-49,49,1
"D10RT",208,538,"1200x900",1000,1,600,400,"True",308,457,460,3,3,1
"D10RT",209,248,"1200x900",800,0,600,400,"False",94,240,356,116,116,1
"D10RT",210,348,"1200x900",800,1,600,400,"True",764,294,319,25,25,0
"D10RT",211,173,"1200x900",600,2,600,400,"False",948,693,466,-227,227,0
"D10RT",212,572,"1200x900",1000,1,600,400,"True",302,260,294,34,34,0
"D10RT",213,383,"1200x900",800,2,600,400,"False",855,407,296,-111,111,0
"D10RT",214,386,"1200x900",800,2,600,400,"True",774,301,337,36,36,0
"D10RT",215,97,"1200x900",600,1,600,400,"False",760,643,473,-170,170,1
"D10RT",216,9,"1200x900",600,0,600,400,"False",509,654,560,-94,94,1
"D10RT",217,146,"1200x900",600,2,600,400,"True",989,492,561,69,69,0
"D10RT",218,76,"1200x900",600,1,600,400,"True",647,614,559,-55,55,0
"D10RT",219,558,"1200x900",1000,1,600,400,"False",72,464,278,-186,186,1
"D10RT",220,179,"1200x900",600,2,600,400,"False",908,602,368,-234,234,0
"D10RT",221,430,"1200x900",800,2,600,400,"False",922,254,417,163,163,0
"D10RT",222,493,"1200x900",1000,0,600,400,"False",80,582,444,-138,138,1
"D10RT",223,87,"1200x900",600,1,600,400,"True",231,604,589,-15,15,0
"D10RT",224,400,"1200x900",800,2,600,400,"True",733,297,268,-29,29,0
"D10RT",225,282,"1200x900",800,0,600,400,"True",109,246,277,31,31,1
"D10RT",226,526,"1200x900",1000,1,600,400,"False",497,710,158,-552,552,0
"D10RT",227,362,"1200x900",800,2,600,400,"True",819,338,277,-61,61,0
"D10RT",228,354,"1200x900",800,1,600,400,"False",118,236,323,87,87,0
"D10RT",229,300,"1200x900",800,1,600,400,"False",620,693,277,-416,416,0
"D10RT",231,588,"1200x900",1000,2,600,400,"False",585,350,130,-220,220,0
"D10RT",232,175,"1200x900",600,2,600,400,"False",1028,432,254,-178,178,0
"D10RT",233,463,"1200x900",1000,0,600,400,"True",115,693,633,-60,60,1
"D10RT",234,249,"1200x900",800,0,600,400,"False",126,306,376,70,70,1
"D10RT",235,461,"1200x900",1000,0,600,400,"False",95,711,375,-336,336,1
"D10RT",236,55,"1200x900",600,0,600,400,"True",211,305,320,15,15,1
"D10RT",237,47,"1200x900",600,0,600,400,"False",303,499,384,-115,115,1
"D10RT",238,109,"1200x900",600,1,600,400,"True",691,589,566,-23,23,0
"D10RT",239,60,"1200x900",600,0,600,400,"True",365,213,269,56,56,1
"D10RT",240,549,"1200x900",1000,1,600,400,"True",657,366,312,-54,54,0
"D10RT",241,281,"1200x900",800,0,600,400,"True",112,611,585,-26,26,1
"D10RT",242,428,"1200x900",800,2,600,400,"False",732,665,487,-178,178,0
"D10RT",243,132,"1200x900",600,1,600,400,"False",333,185,443,258,258,0
"D10RT",244,130,"1200x900",600,1,600,400,"False",741,428,503,75,75,0
"D10RT",245,567,"1200x900",1000,1,600,400,"False",655,297,206,-91,91,1
"D10RT",246,339,"1200x900",800,1,600,400,"False",273,545,214,-331,331,1
"D10RT",247,285,"1200x900",800,0,600,400,"True",237,396,404,8,8,1
"D10RT",248,57,"1200x900",600,0,600,400,"True",354,508,467,-41,41,1
"D10RT",249,392,"1200x900",800,2,600,400,"False",1031,618,477,-141,141,0
"D10RT",250,101,"1200x900",600,1,600,400,"True",541,656,675,19,19,0
"D10RT",251,409,"1200x900",800,2,600,400,"False",501,659,582,-77,77,0
"D10RT",252,177,"1200x900",600,2,600,400,"False",912,236,398,162,162,0
"D10RT",253,6,"1200x900",600,0,600,400,"True",217,689,677,-12,12,1
"D10RT",254,30,"1200x900",600,0,600,400,"False",107,353,440,87,87,0
"D10RT",256,62,"1200x900",600,0,600,400,"True",345,346,365,19,19,1
"D10RT",257,608,"1200x900",1000,2,600,400,"False",742,250,313,63,63,0
"D10RT",259,303,"1200x900",800,1,600,400,"False",241,431,339,-92,92,0
"D10RT",261,550,"1200x900",1000,1,600,400,"True",301,459,488,29,29,0
"D10RT",263,288,"1200x900",800,0,600,400,"True",180,547,576,29,29,1
"D10RT",264,384,"1200x900",800,2,600,400,"False",821,707,500,-207,207,0
"D10RT",265,144,"1200x900",600,1,600,400,"False",718,371,641,270,270,0
"D10RT",266,500,"1200x900",1000,0,600,400,"True",105,700,663,-37,37,1
"D10RT",267,408,"1200x900",800,2,600,400,"True",758,567,593,26,26,0
"D10RT",268,242,"1200x900",800,0,600,400,"True",117,448,437,-11,11,1
"D10RT",269,353,"1200x900",800,1,600,400,"False",90,476,555,79,79,0
"D10RT",270,635,"1200x900",1000,2,600,400,"False",833,402,292,-110,110,0
"D10RT",271,468,"1200x900",1000,0,600,400,"True",121,219,273,54,54,1
"D10RT",272,338,"1200x900",800,1,600,400,"False",813,253,411,158,158,1
"D10RT",273,100,"1200x900",600,1,600,400,"False",453,511,371,-140,140,0
"D10RT",274,575,"1200x900",1000,1,600,400,"False",272,693,483,-210,210,0
"D10RT",275,487,"1200x900",1000,0,600,400,"False",78,670,532,-138,138,1
"D10RT",276,402,"1200x900",800,2,600,400,"True",878,234,268,34,34,0
"D10RT",277,413,"1200x900",800,2,600,400,"True",849,506,511,5,5,0
"D10RT",278,488,"1200x900",1000,0,600,400,"True",129,687,652,-35,35,1
"D10RT",279,170,"1200x900",600,2,600,400,"False",996,468,262,-206,206,0
"D10RT",280,412,"1200x900",800,2,600,400,"True",842,280,360,80,80,0
"D10RT",281,351,"1200x900",800,1,600,400,"False",122,581,362,-219,219,0
"D10RT",282,520,"1200x900",1000,1,600,400,"False",564,260,365,105,105,0
"D10RT",283,297,"1200x900",800,1,600,400,"True",625,244,306,62,62,0
"D10RT",284,291,"1200x900",800,1,600,400,"False",522,694,483,-211,211,0
"D10RT",285,544,"1200x900",1000,1,600,400,"False",602,620,487,-133,133,0
"D10RT",286,355,"1200x900",800,1,600,400,"False",77,386,644,258,258,0
"D10RT",287,374,"1200x900",800,2,600,400,"True",755,450,506,56,56,0
"D10RT",288,494,"1200x900",1000,0,600,400,"True",127,692,718,26,26,1
"D10RT",289,211,"1200x900",600,2,600,400,"True",986,407,431,24,24,0
"D10RT",290,123,"1200x900",600,1,600,400,"True",761,365,315,-50,50,1
"D10RT",291,625,"1200x900",1000,2,600,400,"False",279,228,371,143,143,0
"D10RT",292,590,"1200x900",1000,2,600,400,"True",636,278,284,6,6,0
"D10RT",293,65,"1200x900",600,0,600,400,"False",442,645,437,-208,208,1
"D10RT",294,95,"1200x900",600,1,600,400,"False",749,425,283,-142,142,1
"D10RT",295,340,"1200x900",800,1,600,400,"False",226,240,388,148,148,0
"D10RT",296,341,"1200x900",800,1,600,400,"False",735,632,395,-237,237,1
"D10RT",297,562,"1200x900",1000,1,600,400,"True",347,540,596,56,56,0
"D10RT",298,476,"1200x900",1000,0,600,400,"True",76,359,343,-16,16,1
"D10RT",299,234,"1200x900",800,0,600,400,"True",72,344,312,-32,32,1
"D10RT",300,318,"1200x900",800,1,600,400,"True",788,534,541,7,7,0
"D10RT",301,201,"1200x900",600,2,600,400,"True",1005,462,406,-56,56,0
"D10RT",302,204,"1200x900",600,2,600,400,"True",1053,432,434,2,2,0
"D10RT",303,434,"1200x900",1000,0,600,400,"True",89,657,620,-37,37,1
"D10RT",304,456,"1200x900",1000,0,600,400,"True",91,257,323,66,66,1
"D10RT",305,223,"1200x900",800,0,600,400,"True",179,191,175,-16,16,1
"D10RT",306,356,"1200x900",800,1,600,400,"False",123,484,355,-129,129,0
"D10RT",307,1,"1200x900",600,0,600,400,"False",136,502,414,-88,88,0
"D10RT",308,68,"1200x900",600,0,600,400,"True",165,367,342,-25,25,0
"D10RT",309,571,"1200x900",1000,1,600,400,"True",239,522,452,-70,70,1
"D10RT",310,2,"1200x900",600,0,600,400,"False",159,323,395,72,72,0
"D10RT",311,86,"1200x900",600,1,600,400,"True",692,388,353,-35,35,1
"D10RT",312,73,"1200x900",600,1,600,400,"False",94,665,516,-149,149,0
"D10RT",313,357,"1200x900",800,1,600,400,"True",109,594,547,-47,47,0
"D10RT",314,530,"1200x900",1000,1,600,400,"False",584,405,260,-145,145,1
"D10RT",315,56,"1200x900",600,0,600,400,"True",148,491,480,-11,11,0
"D10RT",316,379,"1200x900",800,2,600,400,"False",994,325,651,326,326,0
"D10RT",317,460,"1200x900",1000,0,600,400,"False",155,189,280,91,91,1
"D10RT",318,129,"1200x900",600,1,600,400,"False",859,482,319,-163,163,1
"D10RT",319,43,"1200x900",600,0,600,400,"True",277,446,393,-53,53,1
"D10RT",320,64,"1200x900",600,0,600,400,"True",102,339,389,50,50,0
"D10RT",321,92,"1200x900",600,1,600,400,"False",624,605,665,60,60,0
"D10RT",322,484,"1200x900",1000,0,600,400,"False",100,223,361,138,138,1
"D10RT",323,32,"1200x900",600,0,600,400,"True",152,563,600,37,37,1
"D10RT",324,245,"1200x900",800,0,600,400,"False",296,235,338,103,103,1
"D10RT",325,271,"1200x900",800,0,600,400,"True",74,360,295,-65,65,1
"D10RT",326,579,"1200x900",1000,2,600,400,"False",803,394,599,205,205,0
"D10RT",327,212,"1200x900",600,2,600,400,"False",841,206,299,93,93,0
"D10RT",328,166,"1200x900",600,2,600,400,"True",896,274,267,-7,7,0
"D10RT",329,422,"1200x900",800,2,600,400,"True",712,558,560,2,2,0
"D10RT",330,39,"1200x900",600,0,600,400,"False",210,609,531,-78,78,0
"D10RT",331,181,"1200x900",600,2,600,400,"True",1018,223,297,74,74,0
"D10RT",332,88,"1200x900",600,1,600,400,"True",186,554,509,-45,45,0
"D10RT",333,495,"1200x900",1000,0,600,400,"False",93,692,604,-88,88,1
"D10RT",334,59,"1200x900",600,0,600,400,"True",391,692,676,-16,16,1
"D10RT",335,504,"1200x900",1000,0,600,400,"True",107,699,718,19,19,1
"D10RT",336,110,"1200x900",600,1,600,400,"True",776,550,538,-12,12,1
"D10RT",338,155,"1200x900",600,2,600,400,"False",940,269,444,175,175,0
"D10RT",339,554,"1200x900",1000,1,600,400,"False",79,309,165,-144,144,1
"D10RT",340,275,"1200x900",800,0,600,400,"False",120,594,415,-179,179,0
"D10RT",341,556,"1200x900",1000,1,600,400,"False",415,420,498,78,78,0
"D10RT",342,382,"1200x900",800,2,600,400,"True",870,523,470,-53,53,0
"D10RT",343,295,"1200x900",800,1,600,400,"True",471,334,299,-35,35,0
"D10RT",347,241,"1200x900",800,0,600,400,"True",129,227,255,28,28,1
"D10RT",348,19,"1200x900",600,0,600,400,"False",286,686,613,-73,73,0
"D10RT",349,142,"1200x900",600,1,600,400,"True",286,474,437,-37,37,0
"D10RT",350,440,"1200x900",1000,0,600,400,"True",71,237,266,29,29,1
"D10RT",351,485,"1200x900",1000,0,600,400,"False",121,694,439,-255,255,1
"D10RT",352,346,"1200x900",800,1,600,400,"True",269,635,594,-41,41,0
"D10RT",353,613,"1200x900",1000,2,600,400,"True",690,374,417,43,43,0
"D10RT",354,407,"1200x900",800,2,600,400,"False",989,340,260,-80,80,0
"D10RT",355,541,"1200x900",1000,1,600,400,"False",339,478,366,-112,112,0
"D10RT",356,365,"1200x900",800,2,600,400,"False",1055,305,590,285,285,0
"D10RT",357,548,"1200x900",1000,1,600,400,"False",103,278,360,82,82,0
"D10RT",358,108,"1200x900",600,1,600,400,"True",830,239,304,65,65,0
"D10RT",359,395,"1200x900",800,2,600,400,"True",743,334,284,-50,50,0
"D10RT",360,277,"1200x900",800,0,600,400,"True",140,310,264,-46,46,1
"D10RT",361,121,"1200x900",600,1,600,400,"True",884,364,361,-3,3,0
"D10RT",362,197,"1200x900",600,2,600,400,"False",903,212,351,139,139,0
"D10RT",363,459,"1200x900",1000,0,600,400,"False",70,645,448,-197,197,1
"D10RT",364,598,"1200x900",1000,2,600,400,"False",706,559,432,-127,127,0
"D10RT",365,401,"1200x900",800,2,600,400,"False",821,260,358,98,98,0
"D10RT",366,390,"1200x900",800,2,600,400,"True",982,674,569,-105,105,1
"D10RT",367,631,"1200x900",1000,2,600,400,"True",699,479,497,18,18,0
"D10RT",368,4,"1200x900",600,0,600,400,"False",602,200,392,192,192,1
"D10RT",369,614,"1200x900",1000,2,600,400,"False",823,563,453,-110,110,0
"D10RT",370,293,"1200x900",800,1,600,400,"False",561,396,473,77,77,0
"D10RT",371,547,"1200x900",1000,1,600,400,"False",369,384,498,114,114,1
"D10RT",372,214,"1200x900",600,2,600,400,"True",1046,305,293,-12,12,0
"D10RT",373,552,"1200x900",1000,1,600,400,"False",255,412,577,165,165,0
"D10RT",374,167,"1200x900",600,2,600,400,"False",956,241,337,96,96,0
"D10RT",375,178,"1200x900",600,2,600,400,"True",1041,510,531,21,21,0
"D10RT",376,24,"1200x900",600,0,600,400,"True",430,538,525,-13,13,1
"D10RT",377,480,"1200x900",1000,0,600,400,"False",100,231,343,112,112,1
"D10RT",378,10,"1200x900",600,0,600,400,"False",400,499,600,101,101,1
"D10RT",379,528,"1200x900",1000,1,600,400,"False",839,227,541,314,314,1
"D10RT",380,479,"1200x900",1000,0,600,400,"False",74,705,545,-160,160,1
"D10RT",381,278,"1200x900",800,0,600,400,"True",251,711,662,-49,49,1
"D10RT",382,581,"1200x900",1000,2,600,400,"False",310,357,513,156,156,0
"D10RT",383,417,"1200x900",800,2,600,400,"False",750,280,397,117,117,0
"D10RT",384,137,"1200x900",600,1,600,400,"True",789,577,511,-66,66,0
"D10RT",385,117,"1200x900",600,1,600,400,"False",711,456,276,-180,180,0
"D10RT",386,545,"1200x900",1000,1,600,400,"True",358,562,571,9,9,0
"D10RT",387,337,"1200x900",800,1,600,400,"True",299,622,662,40,40,0
"D10RT",388,594,"1200x900",1000,2,600,400,"True",537,637,597,-40,40,0
"D10RT",389,315,"1200x900",800,1,600,400,"True",105,211,256,45,45,0
"D10RT",390,406,"1200x900",800,2,600,400,"False",971,233,553,320,320,0
"D10RT",391,421,"1200x900",800,2,600,400,"False",898,394,157,-237,237,0
"D10RT",392,329,"1200x900",800,1,600,400,"False",517,239,332,93,93,0
"D10RT",393,169,"1200x900",600,2,600,400,"True",924,290,273,-17,17,0
"D10RT",394,518,"1200x900",1000,1,600,400,"False",583,717,538,-179,179,0
"D10RT",395,270,"1200x900",800,0,600,400,"False",192,418,539,121,121,1
"D10RT",396,84,"1200x900",600,1,600,400,"True",144,184,169,-15,15,0
"D10RT",397,78,"1200x900",600,1,600,400,"True",885,684,685,1,1,0
"D10RT",398,469,"1200x900",1000,0,600,400,"True",73,227,199,-28,28,1
"D10RT",399,236,"1200x900",800,0,600,400,"False",162,350,267,-83,83,1
"D10RT",400,620,"1200x900",1000,2,600,400,"False",832,649,335,-314,314,0
"D10RT",401,262,"1200x900",800,0,600,400,"False",196,481,337,-144,144,1
"D10RT",402,306,"1200x900",800,1,600,400,"False",164,524,692,168,168,0
"D10RT",403,227,"1200x900",800,0,600,400,"True",196,551,617,66,66,1
"D10RT",404,232,"1200x900",800,0,600,400,"False",84,511,599,88,88,1
"D10RT",405,94,"1200x900",600,1,600,400,"True",729,482,540,58,58,0
"D10RT",406,394,"1200x900",800,2,600,400,"False",847,292,621,329,329,0
"D10RT",407,233,"1200x900",800,0,600,400,"True",164,700,654,-46,46,1
"D10RT",408,372,"1200x900",800,2,600,400,"False",833,620,541,-79,79,0
"D10RT",409,600,"1200x900",1000,2,600,400,"False",765,207,651,444,444,0
"D10RT",410,312,"1200x900",800,1,600,400,"False",238,683,470,-213,213,0
"D10RT",411,16,"1200x900",600,0,600,400,"True",297,514,545,31,31,1
"D10RT",412,280,"1200x900",800,0,600,400,"False",104,302,381,79,79,1
"D10RT",413,328,"1200x900",800,1,600,400,"False",104,649,505,-144,144,0
"D10RT",414,326,"1200x900",800,1,600,400,"False",103,482,655,173,173,0
"D10RT",415,393,"1200x900",800,2,600,400,"False",657,620,504,-116,116,0
"D10RT",416,188,"1200x900",600,2,600,400,"False",900,195,392,197,197,0
"D10RT",417,403,"1200x900",800,2,600,400,"False",625,704,561,-143,143,0
"D10RT",418,255,"1200x900",800,0,600,400,"False",93,709,623,-86,86,1
"D10RT",419,444,"1200x900",1000,0,600,400,"False",101,714,624,-90,90,1
"D10RT",420,411,"1200x900",800,2,600,400,"True",805,361,338,-23,23,0
"D10RT",421,69,"1200x900",600,0,600,400,"False",322,268,99,-169,169,0
"D10RT",422,171,"1200x900",600,2,600,400,"False",909,200,355,155,155,0
"D10RT",423,26,"1200x900",600,0,600,400,"False",70,712,539,-173,173,0
"D10RT",424,112,"1200x900",600,1,600,400,"False",681,490,333,-157,157,0
"D10RT",425,321,"1200x900",800,1,600,400,"False",601,190,351,161,161,0
"D10RT",426,239,"1200x900",800,0,600,400,"False",114,231,310,79,79,1
"D10RT",427,190,"1200x900",600,2,600,400,"True",977,238,225,-13,13,0
"D10RT",429,163,"1200x900",600,2,600,400,"False",1046,665,461,-204,204,0
"D10RT",430,7,"1200x900",600,0,600,400,"False",431,654,560,-94,94,1
"D10RT",431,96,"1200x900",600,1,600,400,"False",433,458,599,141,141,0
"D10RT",432,331,"1200x900",800,1,600,400,"False",240,620,471,-149,149,0
"D10RT",433,457,"1200x900",1000,0,600,400,"False",97,630,493,-137,137,1
"D10RT",434,371,"1200x900",800,2,600,400,"False",730,560,480,-80,80,0
"D10RT",435,644,"1200x900",1000,2,600,400,"False",495,486,559,73,73,0
"D10RT",436,246,"1200x900",800,0,600,400,"False",196,418,509,91,91,1
"D10RT",437,522,"1200x900",1000,1,600,400,"False",223,379,558,179,179,0
"D10RT",438,148,"1200x900",600,2,600,400,"False",907,330,197,-133,133,0
"D10RT",439,195,"1200x900",600,2,600,400,"True",942,249,339,90,90,0
"D10RT",440,151,"1200x900",600,2,600,400,"False",828,680,405,-275,275,0
"D10RT",441,436,"1200x900",1000,0,600,400,"False",82,617,408,-209,209,1
"D10RT",442,452,"1200x900",1000,0,600,400,"True",97,273,305,32,32,1
"D10RT",443,14,"1200x900",600,0,600,400,"True",399,224,243,19,19,1
"D10RT",444,160,"1200x900",600,2,600,400,"False",863,606,390,-216,216,0
"D10RT",445,617,"1200x900",1000,2,600,400,"False",294,180,439,259,259,0
"D10RT",446,289,"1200x900",800,1,600,400,"False",421,703,605,-98,98,1
"D10RT",447,287,"1200x900",800,0,600,400,"True",120,567,593,26,26,1
"D10RT",448,388,"1200x900",800,2,600,400,"False",930,320,598,278,278,0
"D10RT",449,451,"1200x900",1000,0,600,400,"False",110,702,591,-111,111,1
"D10RT",450,81,"1200x900",600,1,600,400,"False",696,225,331,106,106,0
"D10RT",451,377,"1200x900",800,2,600,400,"True",683,388,333,-55,55,0
"D10RT",452,8,"1200x900",600,0,600,400,"False",156,679,547,-132,132,0
"D10RT",453,595,"1200x900",1000,2,600,400,"False",687,640,521,-119,119,0
"D10RT",454,539,"1200x900",1000,1,600,400,"True",510,383,388,5,5,0
"D10RT",455,578,"1200x900",1000,2,600,400,"False",966,276,443,167,167,0
"D10RT",456,349,"1200x900",800,1,600,400,"False",402,665,422,-243,243,0
"D10RT",457,210,"1200x900",600,2,600,400,"False",835,506,417,-89,89,0
"D10RT",458,565,"1200x900",1000,1,600,400,"True",451,562,572,10,10,0
"D10RT",459,82,"1200x900",600,1,600,400,"False",108,213,330,117,117,0
"D10RT",460,220,"1200x900",800,0,600,400,"True",108,699,681,-18,18,1
"D10RT",461,389,"1200x900",800,2,600,400,"False",843,530,395,-135,135,0
"D10RT",462,136,"1200x900",600,1,600,400,"True",264,205,254,49,49,0
"D10RT",463,320,"1200x900",800,1,600,400,"True",644,376,373,-3,3,0
"D10RT",464,566,"1200x900",1000,1,600,400,"False",378,472,392,-80,80,1
"D10RT",465,637,"1200x900",1000,2,600,400,"False",750,460,578,118,118,0
"D10RT",466,159,"1200x900",600,2,600,400,"True",992,309,400,91,91,0
"D10RT",467,265,"1200x900",800,0,600,400,"True",229,353,393,40,40,1
"D10RT",468,254,"1200x900",800,0,600,400,"True",136,583,522,-61,61,1
"D10RT",469,85,"1200x900",600,1,600,400,"False",434,347,524,177,177,0
"D10RT",470,168,"1200x900",600,2,600,400,"True",1001,439,392,-47,47,0
"D10RT",471,517,"1200x900",1000,1,600,400,"True",548,182,232,50,50,0
"D10RT",472,640,"1200x900",1000,2,600,400,"True",361,334,332,-2,2,0
"D10RT",473,429,"1200x900",800,2,600,400,"False",682,692,434,-258,258,0
"D10RT",474,604,"1200x900",1000,2,600,400,"False",459,593,522,-71,71,0
"D10RT",476,36,"1200x900",600,0,600,400,"True",128,346,333,-13,13,1
"D10RT",477,589,"1200x900",1000,2,600,400,"True",856,418,419,1,1,0
"D10RT",478,296,"1200x900",800,1,600,400,"True",89,279,342,63,63,0
"D10RT",479,516,"1200x900",1000,1,600,400,"False",440,559,235,-324,324,0
"D10RT",480,643,"1200x900",1000,2,600,400,"True",740,325,363,38,38,0
"D10RT",481,127,"1200x900",600,1,600,400,"False",309,691,487,-204,204,0
"D10RT",482,646,"1200x900",1000,2,600,400,"False",829,227,409,182,182,1
"D10RT",483,505,"1200x900",1000,1,600,400,"True",191,484,518,34,34,1
"D10RT",484,172,"1200x900",600,2,600,400,"True",912,444,510,66,66,0
"D10RT",485,93,"1200x900",600,1,600,400,"True",139,540,509,-31,31,0
"D10RT",486,70,"1200x900",600,0,600,400,"True",309,703,706,3,3,1
"D10RT",487,546,"1200x900",1000,1,600,400,"True",305,374,352,-22,22,0
"D10RT",488,125,"1200x900",600,1,600,400,"True",750,531,496,-35,35,0
"D10RT",489,189,"1200x900",600,2,600,400,"True",881,397,385,-12,12,0
"D10RT",490,274,"1200x900",800,0,600,400,"True",146,497,491,-6,6,1
"D10RT",491,360,"1200x900",800,1,600,400,"False",203,608,430,-178,178,0
"D10RT",492,458,"1200x900",1000,0,600,400,"False",78,624,496,-128,128,1
"D10RT",493,570,"1200x900",1000,1,600,400,"False",315,352,560,208,208,0
"D10RT",494,497,"1200x900",1000,0,600,400,"False",106,696,576,-120,120,1
"D10RT",495,521,"1200x900",1000,1,600,400,"False",111,303,426,123,123,1
"D10RT",496,519,"1200x900",1000,1,600,400,"False",319,565,658,93,93,1
"D10RT",497,126,"1200x900",600,1,600,400,"False",849,354,499,145,145,0
"D10RT",498,535,"1200x900",1000,1,600,400,"True",372,410,443,33,33,0
"D10RT",499,35,"1200x900",600,0,600,400,"True",366,555,545,-10,10,1
"D10RT",500,207,"1200x900",600,2,600,400,"False",838,235,439,204,204,0
"D10RT",501,102,"1200x900",600,1,600,400,"False",861,603,480,-123,123,0
"D10RT",502,426,"1200x900",800,2,600,400,"True",830,263,334,71,71,0
"D10RT",503,439,"1200x900",1000,0,600,400,"True",110,229,250,21,21,1
"D10RT",504,31,"1200x900",600,0,600,400,"True",365,338,349,11,11,1
"D10RT",505,192,"1200x900",600,2,600,400,"False",1064,320,390,70,70,0
"D10RT",506,77,"1200x900",600,1,600,400,"True",780,525,565,40,40,0
"D10RT",507,584,"1200x900",1000,2,600,400,"True",731,413,457,44,44,0
"D10RT",508,203,"1200x900",600,2,600,400,"False",938,603,501,-102,102,0
"D10RT",509,80,"1200x900",600,1,600,400,"False",616,423,533,110,110,1
"D10RT",510,553,"1200x900",1000,1,600,400,"False",116,712,309,-403,403,0
"D10RT",511,304,"1200x900",800,1,600,400,"False",667,605,339,-266,266,0
"D10RT",512,124,"1200x900",600,1,600,400,"True",345,467,456,-11,11,0
"D10RT",513,63,"1200x900",600,0,600,400,"False",311,188,258,70,70,1
"D10RT",514,332,"1200x900",800,1,600,400,"False",260,699,537,-162,162,0
"D10RT",515,279,"1200x900",800,0,600,400,"False",252,202,563,361,361,1
"D10RT",516,420,"1200x900",800,2,600,400,"True",519,223,284,61,61,0
"D10RT",517,51,"1200x900",600,0,600,400,"True",272,181,249,68,68,1
"D10RT",518,642,"1200x900",1000,2,600,400,"False",776,316,414,98,98,0
"D10RT",519,75,"1200x900",600,1,600,400,"True",635,558,489,-69,69,0
"D10RT",520,607,"1200x900",1000,2,600,400,"True",900,573,576,3,3,1
"D10RT",524,23,"1200x900",600,0,600,400,"False",308,463,545,82,82,1
"D10RT",525,597,"1200x900",1000,2,600,400,"False",352,239,526,287,287,0
"D10RT",526,305,"1200x900",800,1,600,400,"False",471,716,586,-130,130,0
"D10RT",527,334,"1200x900",800,1,600,400,"True",481,665,667,2,2,0
"D10RT",528,501,"1200x900",1000,0,600,400,"False",96,323,417,94,94,1
"D10RT",529,561,"1200x900",1000,1,600,400,"False",231,406,563,157,157,0
"D10RT",530,641,"1200x900",1000,2,600,400,"False",897,272,527,255,255,0
"D10RT",531,42,"1200x900",600,0,600,400,"True",233,479,429,-50,50,0
"D10RT",532,596,"1200x900",1000,2,600,400,"True",706,513,506,-7,7,0
"D10RT",533,370,"1200x900",800,2,600,400,"True",874,336,354,18,18,0
"D10RT",534,467,"1200x900",1000,0,600,400,"False",74,712,494,-218,218,1
"D10RT",535,309,"1200x900",800,1,600,400,"False",186,225,612,387,387,0
"D10RT",536,361,"1200x900",800,2,600,400,"True",931,328,325,-3,3,0
"D10RT",537,462,"1200x900",1000,0,600,400,"False",102,672,403,-269,269,1
"D10RT",538,448,"1200x900",1000,0,600,400,"False",107,641,445,-196,196,1
"D10RT",539,258,"1200x900",800,0,600,400,"False",126,664,505,-159,159,1
"D10RT",540,162,"1200x900",600,2,600,400,"True",849,279,222,-57,57,0
"D10RT",541,105,"1200x900",600,1,600,400,"False",527,440,528,88,88,0
"D10RT",542,71,"1200x900",600,0,600,400,"False",219,248,378,130,130,0
"D10RT",543,368,"1200x900",800,2,600,400,"False",778,515,338,-177,177,0
"D10RT",544,149,"1200x900",600,2,600,400,"False",890,289,191,-98,98,0
"D10RT",545,442,"1200x900",1000,0,600,400,"False",87,183,366,183,183,1
"D10RT",546,347,"1200x900",800,1,600,400,"False",757,295,484,189,189,1
"D10RT",547,555,"1200x900",1000,1,600,400,"False",444,556,629,73,73,0
"D10RT",548,453,"1200x900",1000,0,600,400,"True",71,393,409,16,16,1
"D10RT",549,273,"1200x900",800,0,600,400,"True",180,309,351,42,42,1
"D10RT",550,79,"1200x900",600,1,600,400,"True",731,289,340,51,51,0
"D10RT",551,529,"1200x900",1000,1,600,400,"False",267,412,114,-298,298,1
"D10RT",552,164,"1200x900",600,2,600,400,"False",1051,268,126,-142,142,0
"D10RT",553,358,"1200x900",800,1,600,400,"False",263,635,210,-425,425,0
"D10RT",554,574,"1200x900",1000,1,600,400,"False",614,194,331,137,137,0
"D10RT",555,391,"1200x900",800,2,600,400,"False",895,521,449,-72,72,0
"D10RT",556,385,"1200x900",800,2,600,400,"True",740,456,503,47,47,0
"D10RT",557,263,"1200x900",800,0,600,400,"False",82,396,485,89,89,1
"D10RT",558,366,"1200x900",800,2,600,400,"False",931,464,363,-101,101,0
"D10RT",559,536,"1200x900",1000,1,600,400,"False",580,213,305,92,92,0
"D10RT",560,636,"1200x900",1000,2,600,400,"False",575,583,500,-83,83,0
"D10RT",561,478,"1200x900",1000,0,600,400,"False",79,672,510,-162,162,1
"D10RT",562,237,"1200x900",800,0,600,400,"True",204,481,531,50,50,1
"D10RT",563,583,"1200x900",1000,2,600,400,"True",949,284,340,56,56,1
"D10RT",564,601,"1200x900",1000,2,600,400,"False",735,697,363,-334,334,0
"D10RT",565,259,"1200x900",800,0,600,400,"True",156,180,202,22,22,1
"D10RT",566,224,"1200x900",800,0,600,400,"True",161,474,444,-30,30,1
"D10RT",567,464,"1200x900",1000,0,600,400,"False",82,222,302,80,80,1
"D10RT",568,585,"1200x900",1000,2,600,400,"True",698,688,656,-32,32,1
"D10RT",569,486,"1200x900",1000,0,600,400,"False",102,676,608,-68,68,1
"D10RT",570,98,"1200x900",600,1,600,400,"True",625,530,567,37,37,0
"D10RT",571,107,"1200x900",600,1,600,400,"True",878,678,668,-10,10,0
"D10RT",572,639,"1200x900",1000,2,600,400,"True",504,456,405,-51,51,0
"D10RT",573,99,"1200x900",600,1,600,400,"True",811,407,456,49,49,0
"D10RT",574,628,"1200x900",1000,2,600,400,"False",768,410,495,85,85,0
"D10RT",575,527,"1200x900",1000,1,600,400,"True",565,601,601,0,0,0
"D10RT",576,343,"1200x900",800,1,600,400,"False",407,557,422,-135,135,0
"D10RT",577,367,"1200x900",800,2,600,400,"True",613,464,473,9,9,0
"D10RT",578,630,"1200x900",1000,2,600,400,"False",754,559,451,-108,108,0
"D10RT",579,66,"1200x900",600,0,600,400,"False",155,673,582,-91,91,0
"D10RT",580,324,"1200x900",800,1,600,400,"False",719,712,434,-278,278,1
"D10RT",581,319,"1200x900",800,1,600,400,"False",494,587,404,-183,183,1
"D10RT",582,582,"1200x900",1000,2,600,400,"False",554,347,432,85,85,0
"D10RT",583,560,"1200x900",1000,1,600,400,"False",516,693,486,-207,207,0
"D10RT",584,215,"1200x900",600,2,600,400,"True",939,596,601,5,5,0
"D10RT",585,498,"1200x900",1000,0,600,400,"False",100,260,385,125,125,1
"D10RT",586,612,"1200x900",1000,2,600,400,"False",706,198,305,107,107,0
"D10RT",587,399,"1200x900",800,2,600,400,"False",603,602,511,-91,91,0
"D10RT",588,648,"1200x900",1000,2,600,400,"False",557,394,289,-105,105,0
"D10RT",589,284,"1200x900",800,0,600,400,"True",135,293,335,42,42,1
"D10RT",590,103,"1200x900",600,1,600,400,"True",528,320,308,-12,12,1
"D10RT",591,336,"1200x900",800,1,600,400,"False",251,587,495,-92,92,0
"D10RT",592,489,"1200x900",1000,0,600,400,"True",88,604,587,-17,17,1
"D10RT",593,615,"1200x900",1000,2,600,400,"True",736,634,665,31,31,0
"D10RT",594,50,"1200x900",600,0,600,400,"True",75,582,567,-15,15,0
"D10RT",595,509,"1200x900",1000,1,600,400,"True",509,434,469,35,35,0
"D10RT",596,593,"1200x900",1000,2,600,400,"True",246,719,675,-44,44,0
"D10RT",597,13,"1200x900",600,0,600,400,"True",296,211,252,41,41,1
"D10RT",598,496,"1200x900",1000,0,600,400,"False",70,639,560,-79,79,1
"D10RT",599,325,"1200x900",800,1,600,400,"False",105,394,336,-58,58,0
"D10RT",600,599,"1200x900",1000,2,600,400,"False",316,570,490,-80,80,0
"D10RT",601,427,"1200x900",800,2,600,400,"True",812,380,361,-19,19,0
"D10RT",602,256,"1200x900",800,0,600,400,"True",192,656,670,14,14,1
"D10RT",603,143,"1200x900",600,1,600,400,"True",479,284,328,44,44,1
"D10RT",604,90,"1200x900",600,1,600,400,"False",560,474,272,-202,202,0
"D10RT",605,20,"1200x900",600,0,600,400,"True",204,545,508,-37,37,1
"D10RT",606,323,"1200x900",800,1,600,400,"False",388,348,448,100,100,0
"D10RT",607,511,"1200x900",1000,1,600,400,"True",408,390,375,-15,15,1
"D10RT",608,225,"1200x900",800,0,600,400,"True",178,423,401,-22,22,1
"D10RT",609,261,"1200x900",800,0,600,400,"True",86,713,728,15,15,1
"D10RT",610,327,"1200x900",800,1,600,400,"True",152,339,385,46,46,0
"D10RT",611,405,"1200x900",800,2,600,400,"False",790,307,531,224,224,0
"D10RT",612,267,"1200x900",800,0,600,400,"True",145,665,654,-11,11,1
"D10RT",613,114,"1200x900",600,1,600,400,"False",183,697,820,123,123,0
"D10RT",614,491,"1200x900",1000,0,600,400,"False",108,198,324,126,126,1
"D10RT",615,294,"1200x900",800,1,600,400,"False",262,287,449,162,162,0
"D10RT",616,128,"1200x900",600,1,600,400,"False",661,258,131,-127,127,1
"D10RT",617,83,"1200x900",600,1,600,400,"False",763,568,439,-129,129,1
"D10RT",618,138,"1200x900",600,1,600,400,"False",844,580,688,108,108,1
"D10RT",619,475,"1200x900",1000,0,600,400,"True",101,715,722,7,7,1
"D10RT",620,48,"1200x900",600,0,600,400,"True",323,645,647,2,2,1
"D10RT",621,322,"1200x900",800,1,600,400,"False",703,206,449,243,243,1
"D10RT",622,133,"1200x900",600,1,600,400,"True",345,551,537,-14,14,0
"D10RT",623,563,"1200x900",1000,1,600,400,"True",201,696,715,19,19,0
"D10RT",624,533,"1200x900",1000,1,600,400,"False",355,483,618,135,135,0
"D10RT",625,345,"1200x900",800,1,600,400,"True",841,566,521,-45,45,1
"D10RT",626,247,"1200x900",800,0,600,400,"True",160,424,398,-26,26,1
"D10RT",627,425,"1200x900",800,2,600,400,"True",621,438,396,-42,42,0
"D10RT",628,157,"1200x900",600,2,600,400,"True",1016,323,268,-55,55,0
"D10RT",629,231,"1200x900",800,0,600,400,"False",251,718,566,-152,152,1
"D10RT",630,118,"1200x900",600,1,600,400,"False",190,588,667,79,79,0
"D10RT",631,17,"1200x900",600,0,600,400,"True",402,496,442,-54,54,1
"D10RT",632,510,"1200x900",1000,1,600,400,"False",486,338,177,-161,161,1
"D10RT",633,542,"1200x900",1000,1,600,400,"True",304,401,364,-37,37,0
"D10RT",634,131,"1200x900",600,1,600,400,"False",531,367,590,223,223,0
"D10RT",635,471,"1200x900",1000,0,600,400,"True",122,200,203,3,3,1
"D10RT",636,216,"1200x900",600,2,600,400,"False",1029,286,221,-65,65,0
"D10RT",637,317,"1200x900",800,1,600,400,"True",185,564,507,-57,57,0
"D10RT",638,606,"1200x900",1000,2,600,400,"False",653,627,534,-93,93,0
"D10RT",639,438,"1200x900",1000,0,600,400,"False",77,713,579,-134,134,1
"D10RT",640,217,"1200x900",800,0,600,400,"True",85,573,543,-30,30,1
"D10RT",642,363,"1200x900",800,2,600,400,"True",800,218,168,-50,50,0
"D10RT",643,576,"1200x900",1000,1,600,400,"False",376,713,512,-201,201,0
"D10RT",644,626,"1200x900",1000,2,600,400,"False",329,449,535,86,86,0
"D10RT",645,202,"1200x900",600,2,600,400,"False",966,460,346,-114,114,0
"D10RT",646,268,"1200x900",800,0,600,400,"True",148,400,347,-53,53,1
"D10RT",647,573,"1200x900",1000,1,600,400,"False",486,615,471,-144,144,0
"D10RT",648,514,"1200x900",1000,1,600,400,"False",539,690,602,-88,88,0
"D11DC",1,606,"1200x900",1000,2,600,400,"False",653,627,386,-241,241,0
"D11DC",2,214,"1200x900",600,2,600,400,"True",1046,305,322,17,17,0
"D11DC",3,596,"1200x900",1000,2,600,400,"True",706,513,507,-6,6,0
"D11DC",4,468,"1200x900",1000,0,600,400,"False",121,219,347,128,128,1
"D11DC",5,303,"1200x900",800,1,600,400,"False",241,431,359,-72,72,0
"D11DC",6,10,"1200x900",600,0,600,400,"True",400,499,469,-30,30,1
"D11DC",7,607,"1200x900",1000,2,600,400,"True",900,573,577,4,4,1
"D11DC",8,290,"1200x900",800,1,600,400,"True",789,603,644,41,41,0
"D11DC",9,425,"1200x900",800,2,600,400,"False",621,438,549,111,111,0
"D11DC",10,264,"1200x900",800,0,600,400,"False",198,660,489,-171,171,1
"D11DC",11,244,"1200x900",800,0,600,400,"True",194,203,177,-26,26,1
"D11DC",12,601,"1200x900",1000,2,600,400,"False",735,697,296,-401,401,0
"D11DC",13,226,"1200x900",800,0,600,400,"False",187,229,339,110,110,1
"D11DC",14,555,"1200x900",1000,1,600,400,"True",444,556,494,-62,62,0
"D11DC",15,507,"1200x900",1000,1,600,400,"True",608,583,546,-37,37,1
"D11DC",16,603,"1200x900",1000,2,600,400,"False",693,280,497,217,217,0
"D11DC",17,160,"1200x900",600,2,600,400,"False",863,606,420,-186,186,0
"D11DC",18,381,"1200x900",800,2,600,400,"True",705,408,436,28,28,0
"D11DC",19,285,"1200x900",800,0,600,400,"True",237,396,450,54,54,1
"D11DC",20,494,"1200x900",1000,0,600,400,"False",127,692,529,-163,163,1
"D11DC",21,330,"1200x900",800,1,600,400,"True",759,301,360,59,59,1
"D11DC",22,149,"1200x900",600,2,600,400,"False",890,289,413,124,124,0
"D11DC",23,203,"1200x900",600,2,600,400,"False",938,603,427,-176,176,0
"D11DC",24,115,"1200x900",600,1,600,400,"True",545,307,220,-87,87,0
"D11DC",25,313,"1200x900",800,1,600,400,"True",588,421,400,-21,21,0
"D11DC",26,24,"1200x900",600,0,600,400,"False",430,538,469,-69,69,1
"D11DC",27,238,"1200x900",800,0,600,400,"True",162,283,323,40,40,1
"D11DC",28,647,"1200x900",1000,2,600,400,"False",560,637,430,-207,207,0
"D11DC",29,242,"1200x900",800,0,600,400,"True",117,448,418,-30,30,1
"D11DC",30,553,"1200x900",1000,1,600,400,"False",116,712,338,-374,374,0
"D11DC",31,366,"1200x900",800,2,600,400,"True",931,464,459,-5,5,0
"D11DC",32,175,"1200x900",600,2,600,400,"True",1028,432,510,78,78,0
"D11DC",33,156,"1200x900",600,2,600,400,"False",913,197,461,264,264,0
"D11DC",34,592,"1200x900",1000,2,600,400,"False",492,392,582,190,190,0
"D11DC",35,255,"1200x900",800,0,600,400,"True",93,709,647,-62,62,1
"D11DC",36,479,"1200x900",1000,0,600,400,"False",74,705,547,-158,158,1
"D11DC",37,62,"1200x900",600,0,600,400,"True",345,346,377,31,31,1
"D11DC",38,32,"1200x900",600,0,600,400,"False",152,563,479,-84,84,1
"D11DC",39,333,"1200x900",800,1,600,400,"True",521,548,540,-8,8,0
"D11DC",40,179,"1200x900",600,2,600,400,"False",908,602,504,-98,98,0
"D11DC",41,406,"1200x900",800,2,600,400,"False",971,233,570,337,337,0
"D11DC",42,281,"1200x900",800,0,600,400,"False",112,611,497,-114,114,1
"D11DC",43,412,"1200x900",800,2,600,400,"False",842,280,433,153,153,0
"D11DC",44,576,"1200x900",1000,1,600,400,"False",376,713,621,-92,92,0
"D11DC",45,61,"1200x900",600,0,600,400,"False",272,670,593,-77,77,1
"D11DC",46,645,"1200x900",1000,2,600,400,"False",619,396,542,146,146,0
"D11DC",47,194,"1200x900",600,2,600,400,"False",896,236,404,168,168,0
"D11DC",48,50,"1200x900",600,0,600,400,"True",75,582,528,-54,54,0
"D11DC",49,64,"1200x900",600,0,600,400,"True",102,339,379,40,40,0
"D11DC",50,635,"1200x900",1000,2,600,400,"False",833,402,322,-80,80,0
"D11DC",51,97,"1200x900",600,1,600,400,"True",760,643,567,-76,76,1
"D11DC",52,196,"1200x900",600,2,600,400,"False",1030,397,523,126,126,0
"D11DC",53,118,"1200x900",600,1,600,400,"False",190,588,677,89,89,0
"D11DC",54,219,"1200x900",800,0,600,400,"True",202,502,488,-14,14,1
"D11DC",55,427,"1200x900",800,2,600,400,"False",812,380,483,103,103,0
"D11DC",56,163,"1200x900",600,2,600,400,"True",1046,665,566,-99,99,0
"D11DC",57,391,"1200x900",800,2,600,400,"True",895,521,583,62,62,0
"D11DC",58,216,"1200x900",600,2,600,400,"False",1029,286,673,387,387,0
"D11DC",59,533,"1200x900",1000,1,600,400,"True",355,483,538,55,55,0
"D11DC",60,159,"1200x900",600,2,600,400,"False",992,309,520,211,211,0
"D11DC",61,143,"1200x900",600,1,600,400,"False",479,284,479,195,195,1
"D11DC",62,513,"1200x900",1000,1,600,400,"False",235,602,490,-112,112,0
"D11DC",63,200,"1200x900",600,2,600,400,"False",897,302,605,303,303,0
"D11DC",64,532,"1200x900",1000,1,600,400,"False",215,207,435,228,228,0
"D11DC",65,120,"1200x900",600,1,600,400,"False",690,655,412,-243,243,0
"D11DC",66,569,"1200x900",1000,1,600,400,"False",494,720,494,-226,226,0
"D11DC",67,294,"1200x900",800,1,600,400,"False",262,287,449,162,162,0
"D11DC",68,525,"1200x900",1000,1,600,400,"False",123,690,372,-318,318,0
"D11DC",69,593,"1200x900",1000,2,600,400,"False",246,719,176,-543,543,0
"D11DC",70,338,"1200x900",800,1,600,400,"True",813,253,195,-58,58,1
"D11DC",71,102,"1200x900",600,1,600,400,"False",861,603,325,-278,278,0
"D11DC",72,482,"1200x900",1000,0,600,400,"False",79,686,618,-68,68,1
"D11DC",73,483,"1200x900",1000,0,600,400,"False",93,191,314,123,123,1
"D11DC",74,130,"1200x900",600,1,600,400,"True",741,428,420,-8,8,0
"D11DC",75,301,"1200x900",800,1,600,400,"False",162,574,423,-151,151,0
"D11DC",76,526,"1200x900",1000,1,600,400,"False",497,710,472,-238,238,0
"D11DC",78,110,"1200x900",600,1,600,400,"False",776,550,769,219,219,1
"D11DC",79,536,"1200x900",1000,1,600,400,"False",580,213,432,219,219,0
"D11DC",80,307,"1200x900",800,1,600,400,"True",716,247,294,47,47,0
"D11DC",81,121,"1200x900",600,1,600,400,"True",884,364,385,21,21,0
"D11DC",82,1,"1200x900",600,0,600,400,"True",136,502,486,-16,16,0
"D11DC",83,3,"1200x900",600,0,600,400,"True",298,443,422,-21,21,1
"D11DC",84,71,"1200x900",600,0,600,400,"True",219,248,285,37,37,0
"D11DC",85,487,"1200x900",1000,0,600,400,"True",78,670,608,-62,62,1
"D11DC",86,414,"1200x900",800,2,600,400,"False",831,592,456,-136,136,0
"D11DC",87,622,"1200x900",1000,2,600,400,"False",307,683,581,-102,102,0
"D11DC",88,429,"1200x900",800,2,600,400,"True",682,692,635,-57,57,0
"D11DC",89,335,"1200x900",800,1,600,400,"False",124,360,670,310,310,0
"D11DC",90,322,"1200x900",800,1,600,400,"False",703,206,478,272,272,1
"D11DC",91,436,"1200x900",1000,0,600,400,"False",82,617,460,-157,157,1
"D11DC",92,387,"1200x900",800,2,600,400,"True",990,444,437,-7,7,0
"D11DC",93,298,"1200x900",800,1,600,400,"True",311,457,404,-53,53,0
"D11DC",94,408,"1200x900",800,2,600,400,"False",758,567,411,-156,156,0
"D11DC",95,623,"1200x900",1000,2,600,400,"False",636,527,413,-114,114,0
"D11DC",96,15,"1200x900",600,0,600,400,"False",473,352,464,112,112,1
"D11DC",97,612,"1200x900",1000,2,600,400,"False",706,198,446,248,248,0
"D11DC",98,343,"1200x900",800,1,600,400,"True",407,557,544,-13,13,0
"D11DC",99,503,"1200x900",1000,0,600,400,"False",86,279,357,78,78,1
"D11DC",100,320,"1200x900",800,1,600,400,"False",644,376,449,73,73,0
"D11DC",101,602,"1200x900",1000,2,600,400,"True",865,452,483,31,31,0
"D11DC",102,315,"1200x900",800,1,600,400,"False",105,211,105,-106,106,0
"D11DC",103,262,"1200x900",800,0,600,400,"False",196,481,379,-102,102,1
"D11DC",104,180,"1200x900",600,2,600,400,"True",929,270,330,60,60,0
"D11DC",105,78,"1200x900",600,1,600,400,"False",885,684,579,-105,105,0
"D11DC",106,411,"1200x900",800,2,600,400,"False",805,361,502,141,141,0
"D11DC",107,181,"1200x900",600,2,600,400,"False",1018,223,412,189,189,0
"D11DC",108,284,"1200x900",800,0,600,400,"True",135,293,312,19,19,1
"D11DC",109,5,"1200x900",600,0,600,400,"True",228,587,545,-42,42,0
"D11DC",110,34,"1200x900",600,0,600,400,"True",361,242,266,24,24,1
"D11DC",111,337,"1200x900",800,1,600,400,"True",299,622,671,49,49,0
"D11DC",112,527,"1200x900",1000,1,600,400,"True",565,601,582,-19,19,0
"D11DC",113,171,"1200x900",600,2,600,400,"False",909,200,578,378,378,0
"D11DC",114,531,"1200x900",1000,1,600,400,"True",233,362,347,-15,15,0
"D11DC",115,577,"1200x900",1000,2,600,400,"False",455,420,357,-63,63,0
"D11DC",116,241,"1200x900",800,0,600,400,"False",129,227,296,69,69,1
"D11DC",117,462,"1200x900",1000,0,600,400,"False",102,672,521,-151,151,1
"D11DC",118,249,"1200x900",800,0,600,400,"True",126,306,296,-10,10,1
"D11DC",119,125,"1200x900",600,1,600,400,"False",750,531,463,-68,68,0
"D11DC",120,310,"1200x900",800,1,600,400,"True",559,592,521,-71,71,0
"D11DC",121,107,"1200x900",600,1,600,400,"True",878,678,676,-2,2,0
"D11DC",122,535,"1200x900",1000,1,600,400,"False",372,410,512,102,102,0
"D11DC",123,30,"1200x900",600,0,600,400,"True",107,353,395,42,42,0
"D11DC",124,573,"1200x900",1000,1,600,400,"False",486,615,470,-145,145,0
"D11DC",125,83,"1200x900",600,1,600,400,"False",763,568,437,-131,131,1
"D11DC",126,561,"1200x900",1000,1,600,400,"False",231,406,551,145,145,0
"D11DC",127,463,"1200x900",1000,0,600,400,"False",115,693,598,-95,95,1
"D11DC",128,410,"1200x900",800,2,600,400,"False",916,477,345,-132,132,0
"D11DC",129,224,"1200x900",800,0,600,400,"True",161,474,463,-11,11,1
"D11DC",130,279,"1200x900",800,0,600,400,"True",252,202,250,48,48,1
"D11DC",131,66,"1200x900",600,0,600,400,"True",155,673,712,39,39,0
"D11DC",132,362,"1200x900",800,2,600,400,"False",819,338,475,137,137,0
"D11DC",133,363,"1200x900",800,2,600,400,"False",800,218,511,293,293,0
"D11DC",134,434,"1200x900",1000,0,600,400,"False",89,657,475,-182,182,1
"D11DC",135,493,"1200x900",1000,0,600,400,"False",80,582,508,-74,74,1
"D11DC",136,12,"1200x900",600,0,600,400,"True",365,336,383,47,47,1
"D11DC",137,172,"1200x900",600,2,600,400,"True",912,444,415,-29,29,0
"D11DC",138,113,"1200x900",600,1,600,400,"False",897,657,557,-100,100,0
"D11DC",139,490,"1200x900",1000,0,600,400,"False",114,183,427,244,244,1
"D11DC",140,355,"1200x900",800,1,600,400,"False",77,386,719,333,333,0
"D11DC",141,498,"1200x900",1000,0,600,400,"True",100,260,266,6,6,1
"D11DC",142,63,"1200x900",600,0,600,400,"True",311,188,226,38,38,1
"D11DC",143,597,"1200x900",1000,2,600,400,"True",352,239,225,-14,14,0
"D11DC",144,453,"1200x900",1000,0,600,400,"True",71,393,383,-10,10,1
"D11DC",145,648,"1200x900",1000,2,600,400,"False",557,394,320,-74,74,0
"D11DC",146,293,"1200x900",800,1,600,400,"False",561,396,465,69,69,0
"D11DC",147,523,"1200x900",1000,1,600,400,"False",339,318,463,145,145,0
"D11DC",148,613,"1200x900",1000,2,600,400,"True",690,374,309,-65,65,0
"D11DC",149,474,"1200x900",1000,0,600,400,"True",85,339,394,55,55,1
"D11DC",150,476,"1200x900",1000,0,600,400,"True",76,359,399,40,40,1
"D11DC",151,376,"1200x900",800,2,600,400,"False",788,275,370,95,95,0
"D11DC",152,586,"1200x900",1000,2,600,400,"False",802,262,375,113,113,0
"D11DC",153,263,"1200x900",800,0,600,400,"False",82,396,493,97,97,1
"D11DC",154,431,"1200x900",800,2,600,400,"False",694,382,479,97,97,0
"D11DC",155,178,"1200x900",600,2,600,400,"False",1041,510,612,102,102,0
"D11DC",156,283,"1200x900",800,0,600,400,"True",90,264,301,37,37,1
"D11DC",157,529,"1200x900",1000,1,600,400,"True",267,412,365,-47,47,1
"D11DC",158,269,"1200x900",800,0,600,400,"False",160,295,364,69,69,1
"D11DC",159,628,"1200x900",1000,2,600,400,"True",768,410,387,-23,23,0
"D11DC",160,435,"1200x900",1000,0,600,400,"False",119,200,418,218,218,1
"D11DC",161,578,"1200x900",1000,2,600,400,"False",966,276,687,411,411,0
"D11DC",162,541,"1200x900",1000,1,600,400,"True",339,478,430,-48,48,0
"D11DC",163,201,"1200x900",600,2,600,400,"True",1005,462,480,18,18,0
"D11DC",164,443,"1200x900",1000,0,600,400,"False",99,651,481,-170,170,1
"D11DC",165,311,"1200x900",800,1,600,400,"False",710,261,562,301,301,0
"D11DC",166,640,"1200x900",1000,2,600,400,"False",361,334,533,199,199,0
"D11DC",167,79,"1200x900",600,1,600,400,"False",731,289,458,169,169,0
"D11DC",168,370,"1200x900",800,2,600,400,"True",874,336,381,45,45,0
"D11DC",169,358,"1200x900",800,1,600,400,"False",263,635,525,-110,110,0
"D11DC",170,472,"1200x900",1000,0,600,400,"False",77,685,594,-91,91,1
"D11DC",171,520,"1200x900",1000,1,600,400,"False",564,260,546,286,286,0
"D11DC",172,6,"1200x900",600,0,600,400,"True",217,689,686,-3,3,1
"D11DC",173,499,"1200x900",1000,0,600,400,"False",93,271,528,257,257,1
"D11DC",174,554,"1200x900",1000,1,600,400,"True",79,309,310,1,1,1
"D11DC",175,356,"1200x900",800,1,600,400,"True",123,484,487,3,3,0
"D11DC",176,537,"1200x900",1000,1,600,400,"False",621,412,484,72,72,1
"D11DC",177,528,"1200x900",1000,1,600,400,"False",839,227,426,199,199,1
"D11DC",178,484,"1200x900",1000,0,600,400,"False",100,223,293,70,70,1
"D11DC",179,126,"1200x900",600,1,600,400,"True",849,354,320,-34,34,0
"D11DC",180,518,"1200x900",1000,1,600,400,"False",583,717,317,-400,400,0
"D11DC",181,340,"1200x900",800,1,600,400,"False",226,240,330,90,90,0
"D11DC",182,395,"1200x900",800,2,600,400,"True",743,334,310,-24,24,0
"D11DC",183,55,"1200x900",600,0,600,400,"True",211,305,309,4,4,1
"D11DC",184,243,"1200x900",800,0,600,400,"True",114,332,292,-40,40,1
"D11DC",185,72,"1200x900",600,0,600,400,"False",158,537,466,-71,71,0
"D11DC",186,375,"1200x900",800,2,600,400,"True",716,384,369,-15,15,0
"D11DC",187,456,"1200x900",1000,0,600,400,"True",91,257,294,37,37,1
"D11DC",188,144,"1200x900",600,1,600,400,"True",718,371,376,5,5,0
"D11DC",189,461,"1200x900",1000,0,600,400,"False",95,711,521,-190,190,1
"D11DC",190,217,"1200x900",800,0,600,400,"True",85,573,527,-46,46,1
"D11DC",191,151,"1200x900",600,2,600,400,"True",828,680,609,-71,71,0
"D11DC",192,639,"1200x900",1000,2,600,400,"True",504,456,450,-6,6,0
"D11DC",193,240,"1200x900",800,0,600,400,"False",330,656,526,-130,130,1
"D11DC",194,17,"1200x900",600,0,600,400,"True",402,496,551,55,55,1
"D11DC",195,373,"1200x900",800,2,600,400,"False",694,326,563,237,237,0
"D11DC",196,371,"1200x900",800,2,600,400,"True",730,560,497,-63,63,0
"D11DC",197,53,"1200x900",600,0,600,400,"False",177,189,273,84,84,0
"D11DC",198,229,"1200x900",800,0,600,400,"False",117,697,772,75,75,1
"D11DC",199,309,"1200x900",800,1,600,400,"False",186,225,536,311,311,0
"D11DC",200,437,"1200x900",1000,0,600,400,"True",74,667,638,-29,29,1
"D11DC",201,266,"1200x900",800,0,600,400,"False",126,303,393,90,90,1
"D11DC",202,270,"1200x900",800,0,600,400,"False",192,418,492,74,74,1
"D11DC",203,199,"1200x900",600,2,600,400,"True",992,467,442,-25,25,0
"D11DC",204,398,"1200x900",800,2,600,400,"False",944,698,290,-408,408,0
"D11DC",205,514,"1200x900",1000,1,600,400,"False",539,690,425,-265,265,0
"D11DC",206,205,"1200x900",600,2,600,400,"True",1021,504,549,45,45,0
"D11DC",207,148,"1200x900",600,2,600,400,"False",907,330,466,136,136,0
"D11DC",208,245,"1200x900",800,0,600,400,"False",296,235,312,77,77,1
"D11DC",209,4,"1200x900",600,0,600,400,"False",602,200,284,84,84,1
"D11DC",210,442,"1200x900",1000,0,600,400,"True",87,183,245,62,62,1
"D11DC",211,39,"1200x900",600,0,600,400,"False",210,609,527,-82,82,0
"D11DC",212,510,"1200x900",1000,1,600,400,"False",486,338,575,237,237,1
"D11DC",213,458,"1200x900",1000,0,600,400,"False",78,624,504,-120,120,1
"D11DC",214,221,"1200x900",800,0,600,400,"True",132,520,533,13,13,1
"D11DC",216,401,"1200x900",800,2,600,400,"True",821,260,380,120,120,0
"D11DC",217,142,"1200x900",600,1,600,400,"True",286,474,454,-20,20,0
"D11DC",218,22,"1200x900",600,0,600,400,"True",398,591,539,-52,52,1
"D11DC",219,389,"1200x900",800,2,600,400,"True",843,530,523,-7,7,0
"D11DC",220,67,"1200x900",600,0,600,400,"True",289,308,370,62,62,1
"D11DC",221,492,"1200x900",1000,0,600,400,"True",76,692,651,-41,41,1
"D11DC",222,546,"1200x900",1000,1,600,400,"False",305,374,449,75,75,0
"D11DC",223,624,"1200x900",1000,2,600,400,"True",693,501,493,-8,8,0
"D11DC",225,7,"1200x900",600,0,600,400,"True",431,654,594,-60,60,1
"D11DC",226,321,"1200x900",800,1,600,400,"False",601,190,558,368,368,0
"D11DC",227,165,"1200x900",600,2,600,400,"False",912,554,439,-115,115,0
"D11DC",228,204,"1200x900",600,2,600,400,"True",1053,432,416,-16,16,0
"D11DC",229,87,"1200x900",600,1,600,400,"False",231,604,427,-177,177,0
"D11DC",230,633,"1200x900",1000,2,600,400,"False",564,253,391,138,138,0
"D11DC",231,167,"1200x900",600,2,600,400,"False",956,241,431,190,190,0
"D11DC",232,82,"1200x900",600,1,600,400,"False",108,213,67,-146,146,0
"D11DC",233,540,"1200x900",1000,1,600,400,"False",389,568,436,-132,132,1
"D11DC",234,574,"1200x900",1000,1,600,400,"False",614,194,490,296,296,0
"D11DC",235,247,"1200x900",800,0,600,400,"False",160,424,298,-126,126,1
"D11DC",236,485,"1200x900",1000,0,600,400,"True",121,694,659,-35,35,1
"D11DC",237,177,"1200x900",600,2,600,400,"False",912,236,489,253,253,0
"D11DC",238,438,"1200x900",1000,0,600,400,"False",77,713,588,-125,125,1
"D11DC",239,352,"1200x900",800,1,600,400,"False",235,717,799,82,82,0
"D11DC",240,69,"1200x900",600,0,600,400,"False",322,268,355,87,87,0
"D11DC",241,539,"1200x900",1000,1,600,400,"True",510,383,368,-15,15,0
"D11DC",242,566,"1200x900",1000,1,600,400,"False",378,472,270,-202,202,1
"D11DC",243,464,"1200x900",1000,0,600,400,"True",82,222,257,35,35,1
"D11DC",244,253,"1200x900",800,0,600,400,"False",177,424,159,-265,265,1
"D11DC",245,261,"1200x900",800,0,600,400,"False",86,713,793,80,80,1
"D11DC",246,360,"1200x900",800,1,600,400,"False",203,608,730,122,122,0
"D11DC",247,133,"1200x900",600,1,600,400,"False",345,551,621,70,70,0
"D11DC",248,342,"1200x900",800,1,600,400,"False",677,204,567,363,363,0
"D11DC",249,445,"1200x900",1000,0,600,400,"False",78,302,391,89,89,1
"D11DC",250,413,"1200x900",800,2,600,400,"False",849,506,417,-89,89,0
"D11DC",251,198,"1200x900",600,2,600,400,"True",976,500,455,-45,45,0
"D11DC",252,630,"1200x900",1000,2,600,400,"True",754,559,424,-135,135,0
"D11DC",253,392,"1200x900",800,2,600,400,"True",1031,618,610,-8,8,0
"D11DC",254,441,"1200x900",1000,0,600,400,"True",85,684,630,-54,54,1
"D11DC",255,491,"1200x900",1000,0,600,400,"False",108,198,262,64,64,1
"D11DC",256,94,"1200x900",600,1,600,400,"True",729,482,445,-37,37,0
"D11DC",257,129,"1200x900",600,1,600,400,"False",859,482,254,-228,228,1
"D11DC",258,231,"1200x900",800,0,600,400,"False",251,718,599,-119,119,1
"D11DC",259,629,"1200x900",1000,2,600,400,"False",681,257,362,105,105,0
"D11DC",260,534,"1200x900",1000,1,600,400,"False",328,504,652,148,148,1
"D11DC",261,147,"1200x900",600,2,600,400,"False",942,418,561,143,143,0
"D11DC",262,105,"1200x900",600,1,600,400,"True",527,440,574,134,134,0
"D11DC",263,475,"1200x900",1000,0,600,400,"False",101,715,564,-151,151,1
"D11DC",264,568,"1200x900",1000,1,600,400,"False",286,475,619,144,144,1
"D11DC",265,29,"1200x900",600,0,600,400,"True",385,533,585,52,52,1
"D11DC",266,215,"1200x900",600,2,600,400,"True",939,596,563,-33,33,0
"D11DC",267,361,"1200x900",800,2,600,400,"True",931,328,461,133,133,0
"D11DC",268,605,"1200x900",1000,2,600,400,"False",493,665,509,-156,156,0
"D11DC",269,544,"1200x900",1000,1,600,400,"False",602,620,535,-85,85,0
"D11DC",270,351,"1200x900",800,1,600,400,"False",122,581,765,184,184,0
"D11DC",271,202,"1200x900",600,2,600,400,"False",966,460,553,93,93,0
"D11DC",272,399,"1200x900",800,2,600,400,"False",603,602,443,-159,159,0
"D11DC",273,582,"1200x900",1000,2,600,400,"False",554,347,463,116,116,0
"D11DC",274,460,"1200x900",1000,0,600,400,"True",155,189,174,-15,15,1
"D11DC",275,197,"1200x900",600,2,600,400,"False",903,212,319,107,107,0
"D11DC",276,117,"1200x900",600,1,600,400,"False",711,456,219,-237,237,0
"D11DC",277,359,"1200x900",800,1,600,400,"False",653,241,452,211,211,0
"D11DC",278,182,"1200x900",600,2,600,400,"False",933,389,291,-98,98,0
"D11DC",279,134,"1200x900",600,1,600,400,"True",300,188,180,-8,8,0
"D11DC",280,158,"1200x900",600,2,600,400,"True",939,300,339,39,39,0
"D11DC",281,332,"1200x900",800,1,600,400,"False",260,699,505,-194,194,0
"D11DC",282,235,"1200x900",800,0,600,400,"True",146,646,643,-3,3,1
"D11DC",283,287,"1200x900",800,0,600,400,"True",120,567,569,2,2,1
"D11DC",284,405,"1200x900",800,2,600,400,"False",790,307,444,137,137,0
"D11DC",285,225,"1200x900",800,0,600,400,"True",178,423,426,3,3,1
"D11DC",286,190,"1200x900",600,2,600,400,"False",977,238,440,202,202,0
"D11DC",287,501,"1200x900",1000,0,600,400,"True",96,323,264,-59,59,1
"D11DC",288,379,"1200x900",800,2,600,400,"True",994,325,337,12,12,0
"D11DC",289,99,"1200x900",600,1,600,400,"True",811,407,370,-37,37,0
"D11DC",290,9,"1200x900",600,0,600,400,"False",509,654,580,-74,74,1
"D11DC",291,312,"1200x900",800,1,600,400,"True",238,683,600,-83,83,0
"D11DC",292,618,"1200x900",1000,2,600,400,"True",276,671,596,-75,75,0
"D11DC",293,208,"1200x900",600,2,600,400,"False",946,399,665,266,266,0
"D11DC",294,424,"1200x900",800,2,600,400,"True",903,545,542,-3,3,0
"D11DC",295,138,"1200x900",600,1,600,400,"False",844,580,705,125,125,1
"D11DC",296,278,"1200x900",800,0,600,400,"False",251,711,597,-114,114,1
"D11DC",297,551,"1200x900",1000,1,600,400,"True",146,445,437,-8,8,1
"D11DC",298,286,"1200x900",800,0,600,400,"True",105,378,333,-45,45,1
"D11DC",299,556,"1200x900",1000,1,600,400,"False",415,420,525,105,105,0
"D11DC",300,583,"1200x900",1000,2,600,400,"True",949,284,517,233,233,1
"D11DC",301,23,"1200x900",600,0,600,400,"True",308,463,389,-74,74,1
"D11DC",302,57,"1200x900",600,0,600,400,"True",354,508,568,60,60,1
"D11DC",303,341,"1200x900",800,1,600,400,"False",735,632,534,-98,98,1
"D11DC",304,48,"1200x900",600,0,600,400,"True",323,645,643,-2,2,1
"D11DC",305,420,"1200x900",800,2,600,400,"False",519,223,613,390,390,0
"D11DC",306,565,"1200x900",1000,1,600,400,"True",451,562,549,-13,13,0
"D11DC",307,275,"1200x900",800,0,600,400,"False",120,594,685,91,91,0
"D11DC",308,288,"1200x900",800,0,600,400,"True",180,547,610,63,63,1
"D11DC",309,481,"1200x900",1000,0,600,400,"False",80,185,528,343,343,1
"D11DC",310,195,"1200x900",600,2,600,400,"False",942,249,127,-122,122,0
"D11DC",311,423,"1200x900",800,2,600,400,"False",1051,710,457,-253,253,1
"D11DC",312,299,"1200x900",800,1,600,400,"False",779,274,523,249,249,0
"D11DC",313,75,"1200x900",600,1,600,400,"True",635,558,598,40,40,0
"D11DC",314,346,"1200x900",800,1,600,400,"True",269,635,646,11,11,0
"D11DC",315,93,"1200x900",600,1,600,400,"True",139,540,494,-46,46,0
"D11DC",316,547,"1200x900",1000,1,600,400,"False",369,384,654,270,270,1
"D11DC",317,116,"1200x900",600,1,600,400,"True",767,289,248,-41,41,0
"D11DC",318,374,"1200x900",800,2,600,400,"True",755,450,455,5,5,0
"D11DC",319,316,"1200x900",800,1,600,400,"False",362,319,588,269,269,0
"D11DC",320,473,"1200x900",1000,0,600,400,"False",75,323,146,-177,177,1
"D11DC",321,185,"1200x900",600,2,600,400,"False",907,212,512,300,300,0
"D11DC",322,166,"1200x900",600,2,600,400,"False",896,274,393,119,119,0
"D11DC",323,457,"1200x900",1000,0,600,400,"True",97,630,630,0,0,1
"D11DC",324,632,"1200x900",1000,2,600,400,"False",984,227,454,227,227,0
"D11DC",325,141,"1200x900",600,1,600,400,"True",671,582,561,-21,21,0
"D11DC",326,74,"1200x900",600,1,600,400,"True",115,358,473,115,115,0
"D11DC",327,588,"1200x900",1000,2,600,400,"False",585,350,290,-60,60,0
"D11DC",328,558,"1200x900",1000,1,600,400,"True",72,464,501,37,37,1
"D11DC",329,397,"1200x900",800,2,600,400,"True",817,692,664,-28,28,0
"D11DC",330,230,"1200x900",800,0,600,400,"True",99,678,734,56,56,1
"D11DC",331,627,"1200x900",1000,2,600,400,"False",760,510,293,-217,217,0
"D11DC",332,119,"1200x900",600,1,600,400,"True",168,563,407,-156,156,0
"D11DC",333,448,"1200x900",1000,0,600,400,"False",107,641,814,173,173,1
"D11DC",334,598,"1200x900",1000,2,600,400,"True",706,559,545,-14,14,0
"D11DC",335,419,"1200x900",800,2,600,400,"True",769,351,370,19,19,0
"D11DC",336,184,"1200x900",600,2,600,400,"True",1067,441,386,-55,55,0
"D11DC",337,319,"1200x900",800,1,600,400,"False",494,587,699,112,112,1
"D11DC",338,236,"1200x900",800,0,600,400,"False",162,350,240,-110,110,1
"D11DC",339,579,"1200x900",1000,2,600,400,"False",803,394,656,262,262,0
"D11DC",340,104,"1200x900",600,1,600,400,"True",448,584,500,-84,84,0
"D11DC",341,500,"1200x900",1000,0,600,400,"True",105,700,652,-48,48,1
"D11DC",342,112,"1200x900",600,1,600,400,"True",681,490,507,17,17,0
"D11DC",343,168,"1200x900",600,2,600,400,"False",1001,439,363,-76,76,0
"D11DC",344,256,"1200x900",800,0,600,400,"False",192,656,776,120,120,1
"D11DC",345,610,"1200x900",1000,2,600,400,"False",702,293,587,294,294,0
"D11DC",346,227,"1200x900",800,0,600,400,"True",196,551,516,-35,35,1
"D11DC",347,44,"1200x900",600,0,600,400,"True",305,554,558,4,4,1
"D11DC",348,591,"1200x900",1000,2,600,400,"False",698,336,488,152,152,0
"D11DC",349,89,"1200x900",600,1,600,400,"True",917,366,406,40,40,1
"D11DC",350,433,"1200x900",1000,0,600,400,"False",76,222,289,67,67,1
"D11DC",351,512,"1200x900",1000,1,600,400,"False",139,261,720,459,459,0
"D11DC",352,222,"1200x900",800,0,600,400,"False",152,206,306,100,100,1
"D11DC",353,41,"1200x900",600,0,600,400,"True",370,452,455,3,3,1
"D11DC",354,470,"1200x900",1000,0,600,400,"True",91,666,669,3,3,1
"D11DC",355,459,"1200x900",1000,0,600,400,"True",70,645,678,33,33,1
"D11DC",356,273,"1200x900",800,0,600,400,"False",180,309,390,81,81,1
"D11DC",357,18,"1200x900",600,0,600,400,"True",400,318,292,-26,26,1
"D11DC",358,616,"1200x900",1000,2,600,400,"True",854,357,389,32,32,1
"D11DC",359,183,"1200x900",600,2,600,400,"True",927,289,342,53,53,0
"D11DC",360,145,"1200x900",600,2,600,400,"False",1004,630,514,-116,116,0
"D11DC",361,538,"1200x900",1000,1,600,400,"False",308,457,217,-240,240,1
"D11DC",362,552,"1200x900",1000,1,600,400,"False",255,412,503,91,91,0
"D11DC",363,354,"1200x900",800,1,600,400,"True",118,236,373,137,137,0
"D11DC",364,365,"1200x900",800,2,600,400,"False",1055,305,585,280,280,0
"D11DC",365,599,"1200x900",1000,2,600,400,"False",316,570,483,-87,87,0
"D11DC",366,27,"1200x900",600,0,600,400,"True",373,309,294,-15,15,1
"D11DC",367,127,"1200x900",600,1,600,400,"False",309,691,559,-132,132,0
"D11DC",368,377,"1200x900",800,2,600,400,"False",683,388,558,170,170,0
"D11DC",369,471,"1200x900",1000,0,600,400,"False",122,200,314,114,114,1
"D11DC",370,267,"1200x900",800,0,600,400,"True",145,665,666,1,1,1
"D11DC",371,282,"1200x900",800,0,600,400,"True",109,246,275,29,29,1
"D11DC",372,157,"1200x900",600,2,600,400,"False",1016,323,472,149,149,0
"D11DC",373,176,"1200x900",600,2,600,400,"True",1033,281,361,80,80,0
"D11DC",375,95,"1200x900",600,1,600,400,"False",749,425,321,-104,104,1
"D11DC",376,396,"1200x900",800,2,600,400,"False",678,663,364,-299,299,0
"D11DC",377,328,"1200x900",800,1,600,400,"True",104,649,662,13,13,0
"D11DC",378,8,"1200x900",600,0,600,400,"True",156,679,655,-24,24,0
"D11DC",379,589,"1200x900",1000,2,600,400,"False",856,418,560,142,142,0
"D11DC",380,31,"1200x900",600,0,600,400,"True",365,338,327,-11,11,1
"D11DC",381,111,"1200x900",600,1,600,400,"False",922,552,411,-141,141,1
"D11DC",382,191,"1200x900",600,2,600,400,"False",962,396,550,154,154,0
"D11DC",383,91,"1200x900",600,1,600,400,"False",417,630,522,-108,108,1
"D11DC",384,276,"1200x900",800,0,600,400,"True",281,217,259,42,42,1
"D11DC",385,604,"1200x900",1000,2,600,400,"False",459,593,459,-134,134,0
"D11DC",386,20,"1200x900",600,0,600,400,"True",204,545,523,-22,22,1
"D11DC",387,480,"1200x900",1000,0,600,400,"True",100,231,265,34,34,1
"D11DC",388,415,"1200x900",800,2,600,400,"False",823,684,473,-211,211,0
"D11DC",389,43,"1200x900",600,0,600,400,"False",277,446,570,124,124,1
"D11DC",390,154,"1200x900",600,2,600,400,"True",941,454,515,61,61,0
"D11DC",391,131,"1200x900",600,1,600,400,"False",531,367,578,211,211,0
"D11DC",392,478,"1200x900",1000,0,600,400,"True",79,672,721,49,49,1
"D11DC",393,124,"1200x900",600,1,600,400,"False",345,467,614,147,147,0
"D11DC",394,300,"1200x900",800,1,600,400,"False",620,693,578,-115,115,0
"D11DC",395,581,"1200x900",1000,2,600,400,"False",310,357,588,231,231,0
"D11DC",396,636,"1200x900",1000,2,600,400,"False",575,583,291,-292,292,0
"D11DC",397,35,"1200x900",600,0,600,400,"False",366,555,649,94,94,1
"D11DC",398,223,"1200x900",800,0,600,400,"True",179,191,141,-50,50,1
"D11DC",399,314,"1200x900",800,1,600,400,"True",277,616,569,-47,47,1
"D11DC",400,36,"1200x900",600,0,600,400,"True",128,346,376,30,30,1
"D11DC",401,446,"1200x900",1000,0,600,400,"True",72,298,257,-41,41,1
"D11DC",402,489,"1200x900",1000,0,600,400,"False",88,604,464,-140,140,1
"D11DC",403,325,"1200x900",800,1,600,400,"False",105,394,487,93,93,0
"D11DC",404,393,"1200x900",800,2,600,400,"False",657,620,445,-175,175,0
"D11DC",405,88,"1200x900",600,1,600,400,"True",186,554,522,-32,32,0
"D11DC",406,580,"1200x900",1000,2,600,400,"False",651,267,347,80,80,0
"D11DC",407,98,"1200x900",600,1,600,400,"False",625,530,460,-70,70,0
"D11DC",408,542,"1200x900",1000,1,600,400,"False",304,401,223,-178,178,0
"D11DC",409,258,"1200x900",800,0,600,400,"True",126,664,713,49,49,1
"D11DC",410,509,"1200x900",1000,1,600,400,"False",509,434,588,154,154,0
"D11DC",411,367,"1200x900",800,2,600,400,"True",613,464,442,-22,22,0
"D11DC",412,213,"1200x900",600,2,600,400,"False",822,275,198,-77,77,0
"D11DC",413,590,"1200x900",1000,2,600,400,"True",636,278,413,135,135,0
"D11DC",414,496,"1200x900",1000,0,600,400,"True",70,639,606,-33,33,1
"D11DC",415,530,"1200x900",1000,1,600,400,"False",584,405,264,-141,141,1
"D11DC",416,260,"1200x900",800,0,600,400,"True",103,525,501,-24,24,1
"D11DC",417,46,"1200x900",600,0,600,400,"True",193,355,341,-14,14,1
"D11DC",418,25,"1200x900",600,0,600,400,"True",263,403,442,39,39,1
"D11DC",419,403,"1200x900",800,2,600,400,"False",625,704,362,-342,342,0
"D11DC",420,211,"1200x900",600,2,600,400,"True",986,407,413,6,6,0
"D11DC",421,642,"1200x900",1000,2,600,400,"True",776,316,360,44,44,0
"D11DC",422,524,"1200x900",1000,1,600,400,"False",534,470,621,151,151,0
"D11DC",423,345,"1200x900",800,1,600,400,"True",841,566,603,37,37,1
"D11DC",424,505,"1200x900",1000,1,600,400,"False",191,484,403,-81,81,1
"D11DC",425,450,"1200x900",1000,0,600,400,"False",130,204,273,69,69,1
"D11DC",426,469,"1200x900",1000,0,600,400,"False",73,227,63,-164,164,1
"D11DC",427,206,"1200x900",600,2,600,400,"True",975,223,308,85,85,0
"D11DC",428,56,"1200x900",600,0,600,400,"False",148,491,380,-111,111,0
"D11DC",429,430,"1200x900",800,2,600,400,"False",922,254,388,134,134,0
"D11DC",430,234,"1200x900",800,0,600,400,"True",72,344,288,-56,56,1
"D11DC",431,567,"1200x900",1000,1,600,400,"True",655,297,289,-8,8,1
"D11DC",432,382,"1200x900",800,2,600,400,"False",870,523,432,-91,91,0
"D11DC",433,306,"1200x900",800,1,600,400,"False",164,524,355,-169,169,0
"D11DC",434,570,"1200x900",1000,1,600,400,"True",315,352,422,70,70,0
"D11DC",435,488,"1200x900",1000,0,600,400,"False",129,687,423,-264,264,1
"D11DC",437,454,"1200x900",1000,0,600,400,"False",78,687,487,-200,200,1
"D11DC",438,45,"1200x900",600,0,600,400,"False",487,678,540,-138,138,1
"D11DC",439,511,"1200x900",1000,1,600,400,"False",408,390,661,271,271,1
"D11DC",440,85,"1200x900",600,1,600,400,"True",434,347,199,-148,148,0
"D11DC",441,162,"1200x900",600,2,600,400,"True",849,279,179,-100,100,0
"D11DC",442,73,"1200x900",600,1,600,400,"False",94,665,778,113,113,0
"D11DC",443,305,"1200x900",800,1,600,400,"False",471,716,571,-145,145,0
"D11DC",444,609,"1200x900",1000,2,600,400,"True",697,627,643,16,16,0
"D11DC",445,13,"1200x900",600,0,600,400,"False",296,211,274,63,63,1
"D11DC",446,271,"1200x900",800,0,600,400,"False",74,360,472,112,112,1
"D11DC",447,444,"1200x900",1000,0,600,400,"False",101,714,615,-99,99,1
"D11DC",448,150,"1200x900",600,2,600,400,"False",897,345,525,180,180,0
"D11DC",449,139,"1200x900",600,1,600,400,"True",192,695,651,-44,44,0
"D11DC",450,344,"1200x900",800,1,600,400,"True",589,408,536,128,128,0
"D11DC",451,466,"1200x900",1000,0,600,400,"True",82,205,232,27,27,1
"D11DC",452,37,"1200x900",600,0,600,400,"True",258,403,419,16,16,1
"D11DC",453,407,"1200x900",800,2,600,400,"True",989,340,285,-55,55,0
"D11DC",454,323,"1200x900",800,1,600,400,"False",388,348,440,92,92,0
"D11DC",455,611,"1200x900",1000,2,600,400,"True",414,511,532,21,21,0
"D11DC",456,80,"1200x900",600,1,600,400,"False",616,423,536,113,113,1
"D11DC",457,103,"1200x900",600,1,600,400,"False",528,320,210,-110,110,1
"D11DC",458,232,"1200x900",800,0,600,400,"True",84,511,449,-62,62,1
"D11DC",459,257,"1200x900",800,0,600,400,"True",97,219,176,-43,43,1
"D11DC",460,329,"1200x900",800,1,600,400,"False",517,239,356,117,117,0
"D11DC",461,575,"1200x900",1000,1,600,400,"False",272,693,332,-361,361,0
"D11DC",463,502,"1200x900",1000,0,600,400,"False",111,639,449,-190,190,1
"D11DC",464,404,"1200x900",800,2,600,400,"True",842,396,389,-7,7,0
"D11DC",465,584,"1200x900",1000,2,600,400,"True",731,413,401,-12,12,0
"D11DC",466,114,"1200x900",600,1,600,400,"True",183,697,673,-24,24,0
"D11DC",467,164,"1200x900",600,2,600,400,"True",1051,268,258,-10,10,0
"D11DC",468,292,"1200x900",800,1,600,400,"True",88,565,588,23,23,0
"D11DC",469,390,"1200x900",800,2,600,400,"False",982,674,514,-160,160,1
"D11DC",470,81,"1200x900",600,1,600,400,"False",696,225,328,103,103,0
"D11DC",471,122,"1200x900",600,1,600,400,"False",817,709,413,-296,296,0
"D11DC",472,384,"1200x900",800,2,600,400,"False",821,707,375,-332,332,0
"D11DC",473,439,"1200x900",1000,0,600,400,"True",110,229,203,-26,26,1
"D11DC",474,70,"1200x900",600,0,600,400,"True",309,703,644,-59,59,1
"D11DC",475,625,"1200x900",1000,2,600,400,"False",279,228,543,315,315,0
"D11DC",476,33,"1200x900",600,0,600,400,"True",198,533,542,9,9,1
"D11DC",477,519,"1200x900",1000,1,600,400,"True",319,565,610,45,45,1
"D11DC",478,84,"1200x900",600,1,600,400,"True",144,184,200,16,16,0
"D11DC",479,349,"1200x900",800,1,600,400,"False",402,665,507,-158,158,0
"D11DC",480,615,"1200x900",1000,2,600,400,"True",736,634,572,-62,62,0
"D11DC",481,545,"1200x900",1000,1,600,400,"True",358,562,556,-6,6,0
"D11DC",482,128,"1200x900",600,1,600,400,"False",661,258,417,159,159,1
"D11DC",483,594,"1200x900",1000,2,600,400,"False",537,637,301,-336,336,0
"D11DC",484,426,"1200x900",800,2,600,400,"True",830,263,414,151,151,0
"D11DC",485,495,"1200x900",1000,0,600,400,"False",93,692,549,-143,143,1
"D11DC",486,212,"1200x900",600,2,600,400,"False",841,206,462,256,256,0
"D11DC",487,447,"1200x900",1000,0,600,400,"True",71,339,378,39,39,1
"D11DC",488,378,"1200x900",800,2,600,400,"False",1018,708,574,-134,134,0
"D11DC",489,308,"1200x900",800,1,600,400,"False",437,425,728,303,303,0
"D11DC",490,14,"1200x900",600,0,600,400,"True",399,224,277,53,53,1
"D11DC",491,465,"1200x900",1000,0,600,400,"False",85,203,275,72,72,1
"D11DC",492,59,"1200x900",600,0,600,400,"True",391,692,726,34,34,1
"D11DC",493,265,"1200x900",800,0,600,400,"False",229,353,587,234,234,1
"D11DC",494,251,"1200x900",800,0,600,400,"True",88,352,295,-57,57,1
"D11DC",495,643,"1200x900",1000,2,600,400,"False",740,325,472,147,147,0
"D11DC",496,51,"1200x900",600,0,600,400,"False",272,181,265,84,84,1
"D11DC",497,96,"1200x900",600,1,600,400,"True",433,458,414,-44,44,0
"D11DC",498,47,"1200x900",600,0,600,400,"True",303,499,510,11,11,1
"D11DC",499,331,"1200x900",800,1,600,400,"False",240,620,711,91,91,0
"D11DC",500,210,"1200x900",600,2,600,400,"False",835,506,609,103,103,0
"D11DC",501,188,"1200x900",600,2,600,400,"True",900,195,273,78,78,0
"D11DC",502,189,"1200x900",600,2,600,400,"True",881,397,348,-49,49,0
"D11DC",503,90,"1200x900",600,1,600,400,"True",560,474,616,142,142,0
"D11DC",504,638,"1200x900",1000,2,600,400,"False",385,198,503,305,305,0
"D11DC",505,452,"1200x900",1000,0,600,400,"True",97,273,348,75,75,1
"D11DC",506,291,"1200x900",800,1,600,400,"False",522,694,530,-164,164,0
"D11DC",507,209,"1200x900",600,2,600,400,"True",937,637,580,-57,57,0
"D11DC",508,560,"1200x900",1000,1,600,400,"False",516,693,525,-168,168,0
"D11DC",509,42,"1200x900",600,0,600,400,"True",233,479,455,-24,24,0
"D11DC",510,16,"1200x900",600,0,600,400,"False",297,514,434,-80,80,1
"D11DC",511,252,"1200x900",800,0,600,400,"True",224,673,616,-57,57,1
"D11DC",512,385,"1200x900",800,2,600,400,"True",740,456,389,-67,67,0
"D11DC",513,339,"1200x900",800,1,600,400,"True",273,545,594,49,49,1
"D11DC",514,563,"1200x900",1000,1,600,400,"False",201,696,555,-141,141,0
"D11DC",515,136,"1200x900",600,1,600,400,"False",264,205,624,419,419,0
"D11DC",516,388,"1200x900",800,2,600,400,"False",930,320,613,293,293,0
"D11DC",517,543,"1200x900",1000,1,600,400,"False",88,202,544,342,342,0
"D11DC",518,220,"1200x900",800,0,600,400,"True",108,699,696,-3,3,1
"D11DC",519,161,"1200x900",600,2,600,400,"False",939,553,634,81,81,0
"D11DC",520,522,"1200x900",1000,1,600,400,"False",223,379,612,233,233,0
"D11DC",521,239,"1200x900",800,0,600,400,"False",114,231,390,159,159,1
"D11DC",522,186,"1200x900",600,2,600,400,"False",997,197,328,131,131,0
"D11DC",523,521,"1200x900",1000,1,600,400,"True",111,303,270,-33,33,1
"D11DC",524,451,"1200x900",1000,0,600,400,"False",110,702,565,-137,137,1
"D11DC",525,19,"1200x900",600,0,600,400,"True",286,686,671,-15,15,0
"D11DC",526,353,"1200x900",800,1,600,400,"False",90,476,669,193,193,0
"D11DC",527,193,"1200x900",600,2,600,400,"False",874,588,724,136,136,0
"D11DC",528,400,"1200x900",800,2,600,400,"False",733,297,468,171,171,0
"D11DC",529,153,"1200x900",600,2,600,400,"False",1037,601,697,96,96,0
"D11DC",530,101,"1200x900",600,1,600,400,"True",541,656,650,-6,6,0
"D11DC",531,549,"1200x900",1000,1,600,400,"False",657,366,541,175,175,0
"D11DC",532,621,"1200x900",1000,2,600,400,"True",540,478,435,-43,43,0
"D11DC",533,619,"1200x900",1000,2,600,400,"False",803,247,306,59,59,0
"D11DC",534,506,"1200x900",1000,1,600,400,"False",559,567,203,-364,364,1
"D11DC",535,173,"1200x900",600,2,600,400,"True",948,693,698,5,5,0
"D11DC",536,228,"1200x900",800,0,600,400,"False",174,687,607,-80,80,1
"D11DC",537,608,"1200x900",1000,2,600,400,"False",742,250,495,245,245,0
"D11DC",538,280,"1200x900",800,0,600,400,"True",104,302,354,52,52,1
"D11DC",539,233,"1200x900",800,0,600,400,"True",164,700,724,24,24,1
"D11DC",540,517,"1200x900",1000,1,600,400,"False",548,182,418,236,236,0
"D11DC",541,418,"1200x900",800,2,600,400,"False",754,507,352,-155,155,0
"D11DC",542,140,"1200x900",600,1,600,400,"True",700,523,514,-9,9,0
"D11DC",543,559,"1200x900",1000,1,600,400,"False",641,244,391,147,147,0
"D11DC",544,152,"1200x900",600,2,600,400,"True",971,399,476,77,77,0
"D11DC",545,380,"1200x900",800,2,600,400,"False",942,228,444,216,216,0
"D11DC",546,562,"1200x900",1000,1,600,400,"True",347,540,579,39,39,0
"D11DC",547,272,"1200x900",800,0,600,400,"False",200,181,438,257,257,1
"D11DC",548,394,"1200x900",800,2,600,400,"False",847,292,669,377,377,0
"D11DC",549,11,"1200x900",600,0,600,400,"True",372,670,725,55,55,1
"D11DC",550,52,"1200x900",600,0,600,400,"False",171,188,300,112,112,0
"D11DC",551,38,"1200x900",600,0,600,400,"True",120,628,595,-33,33,1
"D11DC",552,169,"1200x900",600,2,600,400,"True",924,290,263,-27,27,0
"D11DC",553,357,"1200x900",800,1,600,400,"False",109,594,655,61,61,0
"D11DC",554,326,"1200x900",800,1,600,400,"False",103,482,625,143,143,0
"D11DC",555,302,"1200x900",800,1,600,400,"False",479,467,536,69,69,1
"D11DC",556,467,"1200x900",1000,0,600,400,"True",74,712,705,-7,7,1
"D11DC",557,634,"1200x900",1000,2,600,400,"False",735,313,663,350,350,0
"D11DC",558,497,"1200x900",1000,0,600,400,"False",106,696,549,-147,147,1
"D11DC",559,449,"1200x900",1000,0,600,400,"False",105,683,790,107,107,1
"D11DC",560,318,"1200x900",800,1,600,400,"True",788,534,549,15,15,0
"D11DC",561,21,"1200x900",600,0,600,400,"False",314,383,459,76,76,1
"D11DC",562,364,"1200x900",800,2,600,400,"False",1018,204,547,343,343,0
"D11DC",563,486,"1200x900",1000,0,600,400,"True",102,676,706,30,30,1
"D11DC",564,383,"1200x900",800,2,600,400,"True",855,407,469,62,62,0
"D11DC",565,421,"1200x900",800,2,600,400,"True",898,394,347,-47,47,0
"D11DC",566,428,"1200x900",800,2,600,400,"False",732,665,575,-90,90,0
"D11DC",567,626,"1200x900",1000,2,600,400,"True",329,449,505,56,56,0
"D11DC",568,295,"1200x900",800,1,600,400,"True",471,334,267,-67,67,0
"D11DC",569,455,"1200x900",1000,0,600,400,"True",107,718,686,-32,32,1
"D11DC",570,268,"1200x900",800,0,600,400,"True",148,400,418,18,18,1
"D11DC",571,218,"1200x900",800,0,600,400,"True",106,397,398,1,1,1
"D11DC",572,192,"1200x900",600,2,600,400,"False",1064,320,660,340,340,0
"D11DC",573,348,"1200x900",800,1,600,400,"False",764,294,385,91,91,0
"D11DC",574,54,"1200x900",600,0,600,400,"True",474,564,599,35,35,1
"D11DC",575,386,"1200x900",800,2,600,400,"False",774,301,562,261,261,0
"D11DC",576,572,"1200x900",1000,1,600,400,"False",302,260,430,170,170,0
"D11DC",577,416,"1200x900",800,2,600,400,"False",748,617,500,-117,117,0
"D11DC",578,548,"1200x900",1000,1,600,400,"False",103,278,338,60,60,0
"D11DC",579,646,"1200x900",1000,2,600,400,"True",829,227,400,173,173,1
"D11DC",580,557,"1200x900",1000,1,600,400,"True",677,505,484,-21,21,1
"D11DC",581,317,"1200x900",800,1,600,400,"True",185,564,427,-137,137,0
"D11DC",582,600,"1200x900",1000,2,600,400,"False",765,207,500,293,293,0
"D11DC",583,108,"1200x900",600,1,600,400,"True",830,239,240,1,1,0
"D11DC",584,402,"1200x900",800,2,600,400,"True",878,234,333,99,99,0
"D11DC",585,155,"1200x900",600,2,600,400,"True",940,269,310,41,41,0
"D11DC",586,2,"1200x900",600,0,600,400,"True",159,323,280,-43,43,0
"D11DC",587,254,"1200x900",800,0,600,400,"True",136,583,542,-41,41,1
"D11DC",588,274,"1200x900",800,0,600,400,"False",146,497,604,107,107,1
"D11DC",589,417,"1200x900",800,2,600,400,"True",750,280,232,-48,48,0
"D11DC",590,135,"1200x900",600,1,600,400,"True",759,569,589,20,20,0
"D11DC",591,327,"1200x900",800,1,600,400,"True",152,339,341,2,2,0
"D11DC",592,40,"1200x900",600,0,600,400,"True",143,513,555,42,42,0
"D11DC",593,207,"1200x900",600,2,600,400,"False",838,235,389,154,154,0
"D11DC",594,587,"1200x900",1000,2,600,400,"False",741,686,342,-344,344,0
"D11DC",595,289,"1200x900",800,1,600,400,"False",421,703,531,-172,172,1
"D11DC",596,347,"1200x900",800,1,600,400,"False",757,295,593,298,298,1
"D11DC",597,100,"1200x900",600,1,600,400,"False",453,511,361,-150,150,0
"D11DC",598,296,"1200x900",800,1,600,400,"True",89,279,265,-14,14,0
"D11DC",599,65,"1200x900",600,0,600,400,"False",442,645,750,105,105,1
"D11DC",600,637,"1200x900",1000,2,600,400,"True",750,460,510,50,50,0
"D11DC",601,617,"1200x900",1000,2,600,400,"False",294,180,512,332,332,0
"D11DC",602,422,"1200x900",800,2,600,400,"False",712,558,455,-103,103,0
"D11DC",603,334,"1200x900",800,1,600,400,"True",481,665,659,-6,6,0
"D11DC",604,146,"1200x900",600,2,600,400,"False",989,492,696,204,204,0
"D11DC",605,336,"1200x900",800,1,600,400,"False",251,587,650,63,63,0
"D11DC",606,644,"1200x900",1000,2,600,400,"True",495,486,545,59,59,0
"D11DC",607,92,"1200x900",600,1,600,400,"True",624,605,566,-39,39,0
"D11DC",608,614,"1200x900",1000,2,600,400,"True",823,563,517,-46,46,0
"D11DC",609,550,"1200x900",1000,1,600,400,"True",301,459,493,34,34,0
"D11DC",610,440,"1200x900",1000,0,600,400,"True",71,237,284,47,47,1
"D11DC",612,504,"1200x900",1000,0,600,400,"True",107,699,706,7,7,1
"D11DC",613,477,"1200x900",1000,0,600,400,"True",88,640,684,44,44,1
"D11DC",614,641,"1200x900",1000,2,600,400,"False",897,272,388,116,116,0
"D11DC",615,369,"1200x900",800,2,600,400,"False",903,594,840,246,246,0
"D11DC",616,372,"1200x900",800,2,600,400,"False",833,620,257,-363,363,0
"D11DC",617,49,"1200x900",600,0,600,400,"True",109,380,379,-1,1,0
"D11DC",618,58,"1200x900",600,0,600,400,"True",353,655,622,-33,33,1
"D11DC",619,77,"1200x900",600,1,600,400,"True",780,525,511,-14,14,0
"D11DC",620,174,"1200x900",600,2,600,400,"True",998,457,435,-22,22,0
"D11DC",621,259,"1200x900",800,0,600,400,"True",156,180,132,-48,48,1
"D11DC",622,515,"1200x900",1000,1,600,400,"False",307,217,300,83,83,0
"D11DC",623,595,"1200x900",1000,2,600,400,"False",687,640,294,-346,346,0
"D11DC",624,187,"1200x900",600,2,600,400,"False",857,639,421,-218,218,0
"D11DC",625,564,"1200x900",1000,1,600,400,"False",215,264,377,113,113,0
"D11DC",626,508,"1200x900",1000,1,600,400,"True",596,485,432,-53,53,0
"D11DC",627,631,"1200x900",1000,2,600,400,"True",699,479,444,-35,35,0
"D11DC",628,248,"1200x900",800,0,600,400,"False",94,240,317,77,77,1
"D11DC",629,324,"1200x900",800,1,600,400,"False",719,712,330,-382,382,1
"D11DC",630,571,"1200x900",1000,1,600,400,"False",239,522,762,240,240,1
"D11DC",631,86,"1200x900",600,1,600,400,"False",692,388,456,68,68,1
"D11DC",632,350,"1200x900",800,1,600,400,"True",182,566,565,-1,1,0
"D11DC",633,132,"1200x900",600,1,600,400,"False",333,185,124,-61,61,0
"D11DC",634,28,"1200x900",600,0,600,400,"True",336,410,416,6,6,1
"D11DC",635,409,"1200x900",800,2,600,400,"False",501,659,356,-303,303,0
"D11DC",636,246,"1200x900",800,0,600,400,"True",196,418,416,-2,2,1
"D11DC",637,620,"1200x900",1000,2,600,400,"False",832,649,586,-63,63,0
"D11DC",638,585,"1200x900",1000,2,600,400,"False",698,688,528,-160,160,1
"D11DC",639,368,"1200x900",800,2,600,400,"False",778,515,626,111,111,0
"D11DC",640,60,"1200x900",600,0,600,400,"True",365,213,142,-71,71,1
"D11DC",641,137,"1200x900",600,1,600,400,"False",789,577,485,-92,92,0
"D11DC",642,304,"1200x900",800,1,600,400,"False",667,605,419,-186,186,0
"D11DC",643,76,"1200x900",600,1,600,400,"False",647,614,704,90,90,0
"D11DC",644,277,"1200x900",800,0,600,400,"False",140,310,181,-129,129,1
"D11DC",645,170,"1200x900",600,2,600,400,"False",996,468,287,-181,181,0
"D11DC",646,26,"1200x900",600,0,600,400,"True",70,712,667,-45,45,0
"D11DC",647,516,"1200x900",1000,1,600,400,"True",440,559,566,7,7,0
"D11DC",648,109,"1200x900",600,1,600,400,"False",691,589,385,-204,204,0
"D12KH",1,142,"1200x900",600,1,600,400,"False",286,474,614,140,140,0
"D12KH",2,436,"1200x900",1000,0,600,400,"False",82,617,485,-132,132,1
"D12KH",3,359,"1200x900",800,1,600,400,"True",653,241,304,63,63,0
"D12KH",4,46,"1200x900",600,0,600,400,"True",193,355,342,-13,13,1
"D12KH",5,160,"1200x900",600,2,600,400,"True",863,606,569,-37,37,0
"D12KH",6,32,"1200x900",600,0,600,400,"False",152,563,486,-77,77,1
"D12KH",7,458,"1200x900",1000,0,600,400,"False",78,624,529,-95,95,1
"D12KH",8,334,"1200x900",800,1,600,400,"True",481,665,610,-55,55,0
"D12KH",9,404,"1200x900",800,2,600,400,"False",842,396,272,-124,124,0
"D12KH",10,275,"1200x900",800,0,600,400,"True",120,594,533,-61,61,0
"D12KH",11,228,"1200x900",800,0,600,400,"False",174,687,613,-74,74,1
"D12KH",12,277,"1200x900",800,0,600,400,"True",140,310,274,-36,36,1
"D12KH",13,350,"1200x900",800,1,600,400,"False",182,566,363,-203,203,0
"D12KH",14,379,"1200x900",800,2,600,400,"False",994,325,599,274,274,0
"D12KH",15,599,"1200x900",1000,2,600,400,"False",316,570,288,-282,282,0
"D12KH",16,171,"1200x900",600,2,600,400,"True",909,200,270,70,70,0
"D12KH",17,95,"1200x900",600,1,600,400,"True",749,425,354,-71,71,1
"D12KH",18,576,"1200x900",1000,1,600,400,"False",376,713,608,-105,105,0
"D12KH",19,225,"1200x900",800,0,600,400,"True",178,423,366,-57,57,1
"D12KH",20,299,"1200x900",800,1,600,400,"False",779,274,651,377,377,0
"D12KH",21,617,"1200x900",1000,2,600,400,"False",294,180,409,229,229,0
"D12KH",22,38,"1200x900",600,0,600,400,"True",120,628,590,-38,38,1
"D12KH",23,84,"1200x900",600,1,600,400,"True",144,184,177,-7,7,0
"D12KH",24,218,"1200x900",800,0,600,400,"True",106,397,348,-49,49,1
"D12KH",25,154,"1200x900",600,2,600,400,"False",941,454,295,-159,159,0
"D12KH",26,555,"1200x900",1000,1,600,400,"False",444,556,642,86,86,0
"D12KH",27,159,"1200x900",600,2,600,400,"True",992,309,255,-54,54,0
"D12KH",28,367,"1200x900",800,2,600,400,"True",613,464,398,-66,66,0
"D12KH",29,124,"1200x900",600,1,600,400,"False",345,467,399,-68,68,0
"D12KH",30,517,"1200x900",1000,1,600,400,"True",548,182,233,51,51,0
"D12KH",31,289,"1200x900",800,1,600,400,"True",421,703,701,-2,2,1
"D12KH",32,134,"1200x900",600,1,600,400,"True",300,188,185,-3,3,0
"D12KH",33,235,"1200x900",800,0,600,400,"False",146,646,481,-165,165,1
"D12KH",34,595,"1200x900",1000,2,600,400,"False",687,640,350,-290,290,0
"D12KH",35,504,"1200x900",1000,0,600,400,"False",107,699,626,-73,73,1
"D12KH",36,543,"1200x900",1000,1,600,400,"False",88,202,378,176,176,0
"D12KH",37,365,"1200x900",800,2,600,400,"False",1055,305,543,238,238,0
"D12KH",38,579,"1200x900",1000,2,600,400,"False",803,394,542,148,148,0
"D12KH",39,503,"1200x900",1000,0,600,400,"True",86,279,268,-11,11,1
"D12KH",40,280,"1200x900",800,0,600,400,"True",104,302,267,-35,35,1
"D12KH",41,101,"1200x900",600,1,600,400,"True",541,656,601,-55,55,0
"D12KH",42,463,"1200x900",1000,0,600,400,"False",115,693,559,-134,134,1
"D12KH",43,279,"1200x900",800,0,600,400,"True",252,202,158,-44,44,1
"D12KH",44,546,"1200x900",1000,1,600,400,"True",305,374,350,-24,24,0
"D12KH",45,647,"1200x900",1000,2,600,400,"False",560,637,373,-264,264,0
"D12KH",46,605,"1200x900",1000,2,600,400,"True",493,665,596,-69,69,0
"D12KH",47,352,"1200x900",800,1,600,400,"True",235,717,770,53,53,0
"D12KH",48,117,"1200x900",600,1,600,400,"False",711,456,271,-185,185,0
"D12KH",49,184,"1200x900",600,2,600,400,"False",1067,441,714,273,273,0
"D12KH",50,140,"1200x900",600,1,600,400,"True",700,523,527,4,4,0
"D12KH",51,616,"1200x900",1000,2,600,400,"True",854,357,300,-57,57,1
"D12KH",52,31,"1200x900",600,0,600,400,"True",365,338,332,-6,6,1
"D12KH",53,395,"1200x900",800,2,600,400,"True",743,334,395,61,61,0
"D12KH",54,598,"1200x900",1000,2,600,400,"False",706,559,691,132,132,0
"D12KH",55,583,"1200x900",1000,2,600,400,"False",949,284,412,128,128,1
"D12KH",56,161,"1200x900",600,2,600,400,"True",939,553,528,-25,25,0
"D12KH",57,217,"1200x900",800,0,600,400,"True",85,573,548,-25,25,1
"D12KH",58,360,"1200x900",800,1,600,400,"True",203,608,591,-17,17,0
"D12KH",59,204,"1200x900",600,2,600,400,"False",1053,432,260,-172,172,0
"D12KH",60,466,"1200x900",1000,0,600,400,"True",82,205,246,41,41,1
"D12KH",61,12,"1200x900",600,0,600,400,"False",365,336,230,-106,106,1
"D12KH",62,3,"1200x900",600,0,600,400,"True",298,443,496,53,53,1
"D12KH",63,327,"1200x900",800,1,600,400,"False",152,339,215,-124,124,0
"D12KH",64,239,"1200x900",800,0,600,400,"True",114,231,189,-42,42,1
"D12KH",65,544,"1200x900",1000,1,600,400,"True",602,620,594,-26,26,0
"D12KH",66,381,"1200x900",800,2,600,400,"False",705,408,248,-160,160,0
"D12KH",67,438,"1200x900",1000,0,600,400,"False",77,713,517,-196,196,1
"D12KH",68,558,"1200x900",1000,1,600,400,"False",72,464,316,-148,148,1
"D12KH",69,48,"1200x900",600,0,600,400,"False",323,645,574,-71,71,1
"D12KH",70,165,"1200x900",600,2,600,400,"True",912,554,525,-29,29,0
"D12KH",71,111,"1200x900",600,1,600,400,"True",922,552,562,10,10,1
"D12KH",72,293,"1200x900",800,1,600,400,"True",561,396,424,28,28,0
"D12KH",73,208,"1200x900",600,2,600,400,"True",946,399,399,0,0,0
"D12KH",74,426,"1200x900",800,2,600,400,"False",830,263,358,95,95,0
"D12KH",75,230,"1200x900",800,0,600,400,"True",99,678,652,-26,26,1
"D12KH",76,621,"1200x900",1000,2,600,400,"False",540,478,314,-164,164,0
"D12KH",77,585,"1200x900",1000,2,600,400,"False",698,688,580,-108,108,1
"D12KH",78,398,"1200x900",800,2,600,400,"True",944,698,666,-32,32,0
"D12KH",79,80,"1200x900",600,1,600,400,"False",616,423,622,199,199,1
"D12KH",80,386,"1200x900",800,2,600,400,"False",774,301,455,154,154,0
"D12KH",81,366,"1200x900",800,2,600,400,"False",931,464,282,-182,182,0
"D12KH",82,341,"1200x900",800,1,600,400,"True",735,632,575,-57,57,1
"D12KH",83,211,"1200x900",600,2,600,400,"False",986,407,251,-156,156,0
"D12KH",84,448,"1200x900",1000,0,600,400,"True",107,641,600,-41,41,1
"D12KH",85,419,"1200x900",800,2,600,400,"True",769,351,387,36,36,0
"D12KH",86,415,"1200x900",800,2,600,400,"False",823,684,456,-228,228,0
"D12KH",87,344,"1200x900",800,1,600,400,"True",589,408,470,62,62,0
"D12KH",88,563,"1200x900",1000,1,600,400,"True",201,696,702,6,6,0
"D12KH",89,216,"1200x900",600,2,600,400,"True",1029,286,269,-17,17,0
"D12KH",90,163,"1200x900",600,2,600,400,"True",1046,665,719,54,54,0
"D12KH",91,263,"1200x900",800,0,600,400,"False",82,396,474,78,78,1
"D12KH",92,36,"1200x900",600,0,600,400,"True",128,346,383,37,37,1
"D12KH",93,635,"1200x900",1000,2,600,400,"False",833,402,283,-119,119,0
"D12KH",94,237,"1200x900",800,0,600,400,"True",204,481,419,-62,62,1
"D12KH",95,343,"1200x900",800,1,600,400,"False",407,557,434,-123,123,0
"D12KH",96,173,"1200x900",600,2,600,400,"True",948,693,637,-56,56,0
"D12KH",97,462,"1200x900",1000,0,600,400,"False",102,672,601,-71,71,1
"D12KH",98,589,"1200x900",1000,2,600,400,"False",856,418,566,148,148,0
"D12KH",99,331,"1200x900",800,1,600,400,"False",240,620,675,55,55,0
"D12KH",100,115,"1200x900",600,1,600,400,"False",545,307,134,-173,173,0
"D12KH",101,439,"1200x900",1000,0,600,400,"False",110,229,300,71,71,1
"D12KH",102,425,"1200x900",800,2,600,400,"True",621,438,395,-43,43,0
"D12KH",103,116,"1200x900",600,1,600,400,"False",767,289,181,-108,108,0
"D12KH",104,417,"1200x900",800,2,600,400,"True",750,280,264,-16,16,0
"D12KH",105,150,"1200x900",600,2,600,400,"True",897,345,374,29,29,0
"D12KH",106,119,"1200x900",600,1,600,400,"False",168,563,639,76,76,0
"D12KH",107,522,"1200x900",1000,1,600,400,"False",223,379,526,147,147,0
"D12KH",108,353,"1200x900",800,1,600,400,"True",90,476,469,-7,7,0
"D12KH",109,35,"1200x900",600,0,600,400,"True",366,555,536,-19,19,1
"D12KH",110,518,"1200x900",1000,1,600,400,"False",583,717,643,-74,74,0
"D12KH",111,394,"1200x900",800,2,600,400,"True",847,292,335,43,43,0
"D12KH",112,512,"1200x900",1000,1,600,400,"False",139,261,385,124,124,0
"D12KH",113,486,"1200x900",1000,0,600,400,"False",102,676,565,-111,111,1
"D12KH",114,155,"1200x900",600,2,600,400,"False",940,269,613,344,344,0
"D12KH",115,178,"1200x900",600,2,600,400,"False",1041,510,686,176,176,0
"D12KH",116,291,"1200x900",800,1,600,400,"False",522,694,561,-133,133,0
"D12KH",117,566,"1200x900",1000,1,600,400,"False",378,472,283,-189,189,1
"D12KH",118,601,"1200x900",1000,2,600,400,"False",735,697,464,-233,233,0
"D12KH",119,236,"1200x900",800,0,600,400,"True",162,350,340,-10,10,1
"D12KH",120,186,"1200x900",600,2,600,400,"True",997,197,257,60,60,0
"D12KH",121,500,"1200x900",1000,0,600,400,"False",105,700,586,-114,114,1
"D12KH",122,584,"1200x900",1000,2,600,400,"True",731,413,376,-37,37,0
"D12KH",123,29,"1200x900",600,0,600,400,"True",385,533,517,-16,16,1
"D12KH",124,586,"1200x900",1000,2,600,400,"False",802,262,391,129,129,0
"D12KH",125,260,"1200x900",800,0,600,400,"True",103,525,512,-13,13,1
"D12KH",126,65,"1200x900",600,0,600,400,"False",442,645,571,-74,74,1
"D12KH",127,401,"1200x900",800,2,600,400,"False",821,260,385,125,125,0
"D12KH",128,294,"1200x900",800,1,600,400,"False",262,287,561,274,274,0
"D12KH",129,416,"1200x900",800,2,600,400,"False",748,617,406,-211,211,0
"D12KH",130,214,"1200x900",600,2,600,400,"True",1046,305,345,40,40,0
"D12KH",131,144,"1200x900",600,1,600,400,"True",718,371,439,68,68,0
"D12KH",132,287,"1200x900",800,0,600,400,"True",120,567,561,-6,6,1
"D12KH",133,393,"1200x900",800,2,600,400,"True",657,620,614,-6,6,0
"D12KH",134,24,"1200x900",600,0,600,400,"True",430,538,547,9,9,1
"D12KH",135,113,"1200x900",600,1,600,400,"True",897,657,695,38,38,0
"D12KH",136,15,"1200x900",600,0,600,400,"True",473,352,366,14,14,1
"D12KH",137,363,"1200x900",800,2,600,400,"False",800,218,338,120,120,0
"D12KH",138,492,"1200x900",1000,0,600,400,"True",76,692,736,44,44,1
"D12KH",139,257,"1200x900",800,0,600,400,"True",97,219,213,-6,6,1
"D12KH",140,264,"1200x900",800,0,600,400,"False",198,660,571,-89,89,1
"D12KH",141,410,"1200x900",800,2,600,400,"True",916,477,454,-23,23,0
"D12KH",142,614,"1200x900",1000,2,600,400,"False",823,563,475,-88,88,0
"D12KH",143,630,"1200x900",1000,2,600,400,"True",754,559,557,-2,2,0
"D12KH",144,309,"1200x900",800,1,600,400,"False",186,225,524,299,299,0
"D12KH",145,345,"1200x900",800,1,600,400,"True",841,566,494,-72,72,1
"D12KH",146,620,"1200x900",1000,2,600,400,"False",832,649,314,-335,335,0
"D12KH",147,224,"1200x900",800,0,600,400,"True",161,474,455,-19,19,1
"D12KH",148,222,"1200x900",800,0,600,400,"True",152,206,170,-36,36,1
"D12KH",149,7,"1200x900",600,0,600,400,"False",431,654,584,-70,70,1
"D12KH",150,242,"1200x900",800,0,600,400,"True",117,448,451,3,3,1
"D12KH",151,53,"1200x900",600,0,600,400,"True",177,189,252,63,63,0
"D12KH",152,597,"1200x900",1000,2,600,400,"True",352,239,201,-38,38,0
"D12KH",153,190,"1200x900",600,2,600,400,"True",977,238,325,87,87,0
"D12KH",154,64,"1200x900",600,0,600,400,"True",102,339,234,-105,105,0
"D12KH",155,497,"1200x900",1000,0,600,400,"True",106,696,606,-90,90,1
"D12KH",156,284,"1200x900",800,0,600,400,"True",135,293,388,95,95,1
"D12KH",157,335,"1200x900",800,1,600,400,"False",124,360,436,76,76,0
"D12KH",158,554,"1200x900",1000,1,600,400,"True",79,309,365,56,56,1
"D12KH",159,488,"1200x900",1000,0,600,400,"False",129,687,565,-122,122,1
"D12KH",160,559,"1200x900",1000,1,600,400,"True",641,244,259,15,15,0
"D12KH",161,541,"1200x900",1000,1,600,400,"True",339,478,426,-52,52,0
"D12KH",162,136,"1200x900",600,1,600,400,"True",264,205,226,21,21,0
"D12KH",163,240,"1200x900",800,0,600,400,"False",330,656,515,-141,141,1
"D12KH",164,471,"1200x900",1000,0,600,400,"False",122,200,300,100,100,1
"D12KH",165,525,"1200x900",1000,1,600,400,"False",123,690,468,-222,222,0
"D12KH",166,194,"1200x900",600,2,600,400,"True",896,236,196,-40,40,0
"D12KH",167,133,"1200x900",600,1,600,400,"True",345,551,624,73,73,0
"D12KH",168,141,"1200x900",600,1,600,400,"True",671,582,522,-60,60,0
"D12KH",169,90,"1200x900",600,1,600,400,"False",560,474,336,-138,138,0
"D12KH",170,311,"1200x900",800,1,600,400,"False",710,261,743,482,482,0
"D12KH",171,75,"1200x900",600,1,600,400,"True",635,558,597,39,39,0
"D12KH",172,22,"1200x900",600,0,600,400,"True",398,591,631,40,40,1
"D12KH",173,9,"1200x900",600,0,600,400,"False",509,654,577,-77,77,1
"D12KH",174,431,"1200x900",800,2,600,400,"False",694,382,227,-155,155,0
"D12KH",175,98,"1200x900",600,1,600,400,"True",625,530,536,6,6,0
"D12KH",176,465,"1200x900",1000,0,600,400,"True",85,203,236,33,33,1
"D12KH",177,641,"1200x900",1000,2,600,400,"False",897,272,568,296,296,0
"D12KH",178,298,"1200x900",800,1,600,400,"False",311,457,165,-292,292,0
"D12KH",179,278,"1200x900",800,0,600,400,"False",251,711,615,-96,96,1
"D12KH",180,396,"1200x900",800,2,600,400,"False",678,663,370,-293,293,0
"D12KH",181,571,"1200x900",1000,1,600,400,"False",239,522,733,211,211,1
"D12KH",182,180,"1200x900",600,2,600,400,"True",929,270,199,-71,71,0
"D12KH",183,358,"1200x900",800,1,600,400,"False",263,635,358,-277,277,0
"D12KH",184,40,"1200x900",600,0,600,400,"True",143,513,490,-23,23,0
"D12KH",185,326,"1200x900",800,1,600,400,"False",103,482,573,91,91,0
"D12KH",186,578,"1200x900",1000,2,600,400,"False",966,276,481,205,205,0
"D12KH",187,285,"1200x900",800,0,600,400,"True",237,396,456,60,60,1
"D12KH",188,470,"1200x900",1000,0,600,400,"True",91,666,693,27,27,1
"D12KH",189,606,"1200x900",1000,2,600,400,"True",653,627,578,-49,49,0
"D12KH",190,454,"1200x900",1000,0,600,400,"True",78,687,587,-100,100,1
"D12KH",191,37,"1200x900",600,0,600,400,"True",258,403,391,-12,12,1
"D12KH",192,67,"1200x900",600,0,600,400,"True",289,308,292,-16,16,1
"D12KH",193,406,"1200x900",800,2,600,400,"True",971,233,397,164,164,0
"D12KH",194,325,"1200x900",800,1,600,400,"False",105,394,281,-113,113,0
"D12KH",195,441,"1200x900",1000,0,600,400,"True",85,684,661,-23,23,1
"D12KH",196,536,"1200x900",1000,1,600,400,"True",580,213,204,-9,9,0
"D12KH",197,6,"1200x900",600,0,600,400,"True",217,689,651,-38,38,1
"D12KH",198,17,"1200x900",600,0,600,400,"True",402,496,467,-29,29,1
"D12KH",199,385,"1200x900",800,2,600,400,"True",740,456,426,-30,30,0
"D12KH",200,575,"1200x900",1000,1,600,400,"False",272,693,599,-94,94,0
"D12KH",201,220,"1200x900",800,0,600,400,"True",108,699,654,-45,45,1
"D12KH",202,43,"1200x900",600,0,600,400,"True",277,446,491,45,45,1
"D12KH",204,408,"1200x900",800,2,600,400,"True",758,567,537,-30,30,0
"D12KH",205,120,"1200x900",600,1,600,400,"True",690,655,668,13,13,0
"D12KH",206,531,"1200x900",1000,1,600,400,"False",233,362,477,115,115,0
"D12KH",207,637,"1200x900",1000,2,600,400,"True",750,460,278,-182,182,0
"D12KH",208,528,"1200x900",1000,1,600,400,"False",839,227,602,375,375,1
"D12KH",209,552,"1200x900",1000,1,600,400,"True",255,412,375,-37,37,0
"D12KH",210,114,"1200x900",600,1,600,400,"True",183,697,637,-60,60,0
"D12KH",211,332,"1200x900",800,1,600,400,"True",260,699,662,-37,37,0
"D12KH",212,34,"1200x900",600,0,600,400,"True",361,242,229,-13,13,1
"D12KH",213,473,"1200x900",1000,0,600,400,"False",75,323,238,-85,85,1
"D12KH",214,569,"1200x900",1000,1,600,400,"False",494,720,421,-299,299,0
"D12KH",215,254,"1200x900",800,0,600,400,"True",136,583,638,55,55,1
"D12KH",216,346,"1200x900",800,1,600,400,"True",269,635,641,6,6,0
"D12KH",217,256,"1200x900",800,0,600,400,"True",192,656,648,-8,8,1
"D12KH",218,316,"1200x900",800,1,600,400,"False",362,319,692,373,373,0
"D12KH",219,388,"1200x900",800,2,600,400,"False",930,320,400,80,80,0
"D12KH",220,402,"1200x900",800,2,600,400,"False",878,234,323,89,89,0
"D12KH",221,145,"1200x900",600,2,600,400,"False",1004,630,285,-345,345,0
"D12KH",222,623,"1200x900",1000,2,600,400,"False",636,527,456,-71,71,0
"D12KH",223,20,"1200x900",600,0,600,400,"False",204,545,395,-150,150,1
"D12KH",224,460,"1200x900",1000,0,600,400,"True",155,189,195,6,6,1
"D12KH",225,423,"1200x900",800,2,600,400,"True",1051,710,725,15,15,1
"D12KH",226,88,"1200x900",600,1,600,400,"False",186,554,642,88,88,0
"D12KH",227,23,"1200x900",600,0,600,400,"True",308,463,430,-33,33,1
"D12KH",228,440,"1200x900",1000,0,600,400,"True",71,237,254,17,17,1
"D12KH",229,47,"1200x900",600,0,600,400,"True",303,499,493,-6,6,1
"D12KH",230,382,"1200x900",800,2,600,400,"False",870,523,347,-176,176,0
"D12KH",231,609,"1200x900",1000,2,600,400,"True",697,627,765,138,138,0
"D12KH",232,103,"1200x900",600,1,600,400,"True",528,320,382,62,62,1
"D12KH",233,253,"1200x900",800,0,600,400,"True",177,424,377,-47,47,1
"D12KH",234,192,"1200x900",600,2,600,400,"True",1064,320,553,233,233,0
"D12KH",235,143,"1200x900",600,1,600,400,"True",479,284,381,97,97,1
"D12KH",236,320,"1200x900",800,1,600,400,"False",644,376,586,210,210,0
"D12KH",237,375,"1200x900",800,2,600,400,"True",716,384,291,-93,93,0
"D12KH",238,496,"1200x900",1000,0,600,400,"False",70,639,563,-76,76,1
"D12KH",239,574,"1200x900",1000,1,600,400,"False",614,194,423,229,229,0
"D12KH",240,169,"1200x900",600,2,600,400,"True",924,290,355,65,65,0
"D12KH",241,71,"1200x900",600,0,600,400,"True",219,248,259,11,11,0
"D12KH",242,30,"1200x900",600,0,600,400,"False",107,353,420,67,67,0
"D12KH",243,210,"1200x900",600,2,600,400,"True",835,506,542,36,36,0
"D12KH",244,28,"1200x900",600,0,600,400,"True",336,410,408,-2,2,1
"D12KH",245,219,"1200x900",800,0,600,400,"False",202,502,392,-110,110,1
"D12KH",246,547,"1200x900",1000,1,600,400,"True",369,384,447,63,63,1
"D12KH",247,476,"1200x900",1000,0,600,400,"True",76,359,364,5,5,1
"D12KH",248,487,"1200x900",1000,0,600,400,"True",78,670,600,-70,70,1
"D12KH",249,451,"1200x900",1000,0,600,400,"True",110,702,650,-52,52,1
"D12KH",250,250,"1200x900",800,0,600,400,"False",290,248,326,78,78,1
"D12KH",251,295,"1200x900",800,1,600,400,"True",471,334,297,-37,37,0
"D12KH",252,132,"1200x900",600,1,600,400,"True",333,185,175,-10,10,0
"D12KH",253,246,"1200x900",800,0,600,400,"True",196,418,391,-27,27,1
"D12KH",254,310,"1200x900",800,1,600,400,"True",559,592,586,-6,6,0
"D12KH",255,104,"1200x900",600,1,600,400,"False",448,584,717,133,133,0
"D12KH",256,318,"1200x900",800,1,600,400,"False",788,534,784,250,250,0
"D12KH",257,615,"1200x900",1000,2,600,400,"True",736,634,618,-16,16,0
"D12KH",258,148,"1200x900",600,2,600,400,"True",907,330,304,-26,26,0
"D12KH",259,516,"1200x900",1000,1,600,400,"True",440,559,584,25,25,0
"D12KH",260,469,"1200x900",1000,0,600,400,"True",73,227,330,103,103,1
"D12KH",261,494,"1200x900",1000,0,600,400,"False",127,692,494,-198,198,1
"D12KH",262,339,"1200x900",800,1,600,400,"False",273,545,648,103,103,1
"D12KH",263,297,"1200x900",800,1,600,400,"False",625,244,441,197,197,0
"D12KH",264,188,"1200x900",600,2,600,400,"False",900,195,391,196,196,0
"D12KH",265,582,"1200x900",1000,2,600,400,"True",554,347,373,26,26,0
"D12KH",266,449,"1200x900",1000,0,600,400,"False",105,683,501,-182,182,1
"D12KH",267,553,"1200x900",1000,1,600,400,"False",116,712,351,-361,361,0
"D12KH",268,397,"1200x900",800,2,600,400,"True",817,692,673,-19,19,0
"D12KH",269,189,"1200x900",600,2,600,400,"True",881,397,430,33,33,0
"D12KH",270,203,"1200x900",600,2,600,400,"True",938,603,576,-27,27,0
"D12KH",271,537,"1200x900",1000,1,600,400,"True",621,412,435,23,23,1
"D12KH",272,202,"1200x900",600,2,600,400,"False",966,460,359,-101,101,0
"D12KH",273,424,"1200x900",800,2,600,400,"False",903,545,482,-63,63,0
"D12KH",274,229,"1200x900",800,0,600,400,"True",117,697,646,-51,51,1
"D12KH",275,93,"1200x900",600,1,600,400,"True",139,540,513,-27,27,0
"D12KH",276,54,"1200x900",600,0,600,400,"True",474,564,573,9,9,1
"D12KH",277,146,"1200x900",600,2,600,400,"True",989,492,497,5,5,0
"D12KH",278,82,"1200x900",600,1,600,400,"True",108,213,247,34,34,0
"D12KH",279,413,"1200x900",800,2,600,400,"False",849,506,373,-133,133,0
"D12KH",280,156,"1200x900",600,2,600,400,"False",913,197,285,88,88,0
"D12KH",281,430,"1200x900",800,2,600,400,"False",922,254,384,130,130,0
"D12KH",282,535,"1200x900",1000,1,600,400,"True",372,410,398,-12,12,0
"D12KH",283,349,"1200x900",800,1,600,400,"True",402,665,688,23,23,0
"D12KH",284,8,"1200x900",600,0,600,400,"True",156,679,647,-32,32,0
"D12KH",285,354,"1200x900",800,1,600,400,"False",118,236,602,366,366,0
"D12KH",286,290,"1200x900",800,1,600,400,"False",789,603,469,-134,134,0
"D12KH",287,329,"1200x900",800,1,600,400,"False",517,239,343,104,104,0
"D12KH",288,324,"1200x900",800,1,600,400,"False",719,712,588,-124,124,1
"D12KH",289,81,"1200x900",600,1,600,400,"False",696,225,351,126,126,0
"D12KH",290,477,"1200x900",1000,0,600,400,"False",88,640,504,-136,136,1
"D12KH",291,21,"1200x900",600,0,600,400,"False",314,383,285,-98,98,1
"D12KH",292,370,"1200x900",800,2,600,400,"True",874,336,419,83,83,0
"D12KH",293,68,"1200x900",600,0,600,400,"False",165,367,271,-96,96,0
"D12KH",294,302,"1200x900",800,1,600,400,"False",479,467,527,60,60,1
"D12KH",295,247,"1200x900",800,0,600,400,"False",160,424,342,-82,82,1
"D12KH",296,495,"1200x900",1000,0,600,400,"True",93,692,642,-50,50,1
"D12KH",297,407,"1200x900",800,2,600,400,"False",989,340,234,-106,106,0
"D12KH",298,172,"1200x900",600,2,600,400,"True",912,444,480,36,36,0
"D12KH",299,429,"1200x900",800,2,600,400,"False",682,692,603,-89,89,0
"D12KH",300,152,"1200x900",600,2,600,400,"False",971,399,242,-157,157,0
"D12KH",301,77,"1200x900",600,1,600,400,"False",780,525,340,-185,185,0
"D12KH",302,102,"1200x900",600,1,600,400,"True",861,603,580,-23,23,0
"D12KH",303,282,"1200x900",800,0,600,400,"True",109,246,216,-30,30,1
"D12KH",304,231,"1200x900",800,0,600,400,"True",251,718,681,-37,37,1
"D12KH",305,243,"1200x900",800,0,600,400,"False",114,332,258,-74,74,1
"D12KH",306,481,"1200x900",1000,0,600,400,"True",80,185,245,60,60,1
"D12KH",307,508,"1200x900",1000,1,600,400,"True",596,485,463,-22,22,0
"D12KH",308,199,"1200x900",600,2,600,400,"False",992,467,321,-146,146,0
"D12KH",309,506,"1200x900",1000,1,600,400,"False",559,567,362,-205,205,1
"D12KH",310,109,"1200x900",600,1,600,400,"True",691,589,636,47,47,0
"D12KH",311,507,"1200x900",1000,1,600,400,"False",608,583,416,-167,167,1
"D12KH",312,446,"1200x900",1000,0,600,400,"False",72,298,190,-108,108,1
"D12KH",313,455,"1200x900",1000,0,600,400,"False",107,718,589,-129,129,1
"D12KH",314,364,"1200x900",800,2,600,400,"False",1018,204,290,86,86,0
"D12KH",315,480,"1200x900",1000,0,600,400,"False",100,231,54,-177,177,1
"D12KH",316,259,"1200x900",800,0,600,400,"True",156,180,104,-76,76,1
"D12KH",317,157,"1200x900",600,2,600,400,"True",1016,323,357,34,34,0
"D12KH",318,383,"1200x900",800,2,600,400,"True",855,407,344,-63,63,0
"D12KH",319,505,"1200x900",1000,1,600,400,"True",191,484,409,-75,75,1
"D12KH",320,456,"1200x900",1000,0,600,400,"True",91,257,304,47,47,1
"D12KH",321,452,"1200x900",1000,0,600,400,"True",97,273,310,37,37,1
"D12KH",322,153,"1200x900",600,2,600,400,"True",1037,601,756,155,155,0
"D12KH",323,593,"1200x900",1000,2,600,400,"True",246,719,678,-41,41,0
"D12KH",324,89,"1200x900",600,1,600,400,"False",917,366,474,108,108,1
"D12KH",325,604,"1200x900",1000,2,600,400,"False",459,593,445,-148,148,0
"D12KH",326,539,"1200x900",1000,1,600,400,"False",510,383,497,114,114,0
"D12KH",327,475,"1200x900",1000,0,600,400,"False",101,715,528,-187,187,1
"D12KH",328,587,"1200x900",1000,2,600,400,"False",741,686,540,-146,146,0
"D12KH",329,421,"1200x900",800,2,600,400,"False",898,394,273,-121,121,0
"D12KH",330,61,"1200x900",600,0,600,400,"True",272,670,700,30,30,1
"D12KH",331,638,"1200x900",1000,2,600,400,"False",385,198,398,200,200,0
"D12KH",332,130,"1200x900",600,1,600,400,"True",741,428,363,-65,65,0
"D12KH",333,26,"1200x900",600,0,600,400,"True",70,712,669,-43,43,0
"D12KH",334,588,"1200x900",1000,2,600,400,"False",585,350,487,137,137,0
"D12KH",335,209,"1200x900",600,2,600,400,"False",937,637,527,-110,110,0
"D12KH",336,570,"1200x900",1000,1,600,400,"True",315,352,406,54,54,0
"D12KH",337,640,"1200x900",1000,2,600,400,"True",361,334,307,-27,27,0
"D12KH",338,610,"1200x900",1000,2,600,400,"False",702,293,400,107,107,0
"D12KH",339,85,"1200x900",600,1,600,400,"False",434,347,546,199,199,0
"D12KH",340,137,"1200x900",600,1,600,400,"True",789,577,563,-14,14,0
"D12KH",341,561,"1200x900",1000,1,600,400,"True",231,406,427,21,21,0
"D12KH",342,550,"1200x900",1000,1,600,400,"True",301,459,447,-12,12,0
"D12KH",343,168,"1200x900",600,2,600,400,"True",1001,439,386,-53,53,0
"D12KH",344,312,"1200x900",800,1,600,400,"False",238,683,569,-114,114,0
"D12KH",345,267,"1200x900",800,0,600,400,"True",145,665,634,-31,31,1
"D12KH",346,368,"1200x900",800,2,600,400,"False",778,515,455,-60,60,0
"D12KH",347,577,"1200x900",1000,2,600,400,"False",455,420,509,89,89,0
"D12KH",348,489,"1200x900",1000,0,600,400,"True",88,604,534,-70,70,1
"D12KH",349,166,"1200x900",600,2,600,400,"True",896,274,285,11,11,0
"D12KH",350,444,"1200x900",1000,0,600,400,"False",101,714,618,-96,96,1
"D12KH",351,74,"1200x900",600,1,600,400,"False",115,358,264,-94,94,0
"D12KH",352,549,"1200x900",1000,1,600,400,"True",657,366,370,4,4,0
"D12KH",353,607,"1200x900",1000,2,600,400,"True",900,573,429,-144,144,1
"D12KH",354,362,"1200x900",800,2,600,400,"True",819,338,396,58,58,0
"D12KH",355,380,"1200x900",800,2,600,400,"True",942,228,260,32,32,0
"D12KH",356,482,"1200x900",1000,0,600,400,"False",79,686,516,-170,170,1
"D12KH",357,25,"1200x900",600,0,600,400,"True",263,403,352,-51,51,1
"D12KH",358,625,"1200x900",1000,2,600,400,"True",279,228,280,52,52,0
"D12KH",359,520,"1200x900",1000,1,600,400,"True",564,260,279,19,19,0
"D12KH",360,41,"1200x900",600,0,600,400,"True",370,452,412,-40,40,1
"D12KH",361,51,"1200x900",600,0,600,400,"True",272,181,176,-5,5,1
"D12KH",362,261,"1200x900",800,0,600,400,"True",86,713,643,-70,70,1
"D12KH",363,369,"1200x900",800,2,600,400,"False",903,594,260,-334,334,0
"D12KH",364,328,"1200x900",800,1,600,400,"False",104,649,754,105,105,0
"D12KH",365,33,"1200x900",600,0,600,400,"True",198,533,542,9,9,1
"D12KH",366,72,"1200x900",600,0,600,400,"True",158,537,543,6,6,0
"D12KH",367,459,"1200x900",1000,0,600,400,"False",70,645,548,-97,97,1
"D12KH",368,442,"1200x900",1000,0,600,400,"True",87,183,154,-29,29,1
"D12KH",369,248,"1200x900",800,0,600,400,"False",94,240,101,-139,139,1
"D12KH",370,453,"1200x900",1000,0,600,400,"False",71,393,262,-131,131,1
"D12KH",371,258,"1200x900",800,0,600,400,"True",126,664,647,-17,17,1
"D12KH",372,376,"1200x900",800,2,600,400,"False",788,275,412,137,137,0
"D12KH",373,58,"1200x900",600,0,600,400,"True",353,655,742,87,87,1
"D12KH",374,530,"1200x900",1000,1,600,400,"False",584,405,296,-109,109,1
"D12KH",375,63,"1200x900",600,0,600,400,"True",311,188,155,-33,33,1
"D12KH",376,170,"1200x900",600,2,600,400,"False",996,468,275,-193,193,0
"D12KH",377,521,"1200x900",1000,1,600,400,"True",111,303,264,-39,39,1
"D12KH",378,177,"1200x900",600,2,600,400,"False",912,236,394,158,158,0
"D12KH",379,485,"1200x900",1000,0,600,400,"False",121,694,564,-130,130,1
"D12KH",380,131,"1200x900",600,1,600,400,"False",531,367,704,337,337,0
"D12KH",381,611,"1200x900",1000,2,600,400,"False",414,511,599,88,88,0
"D12KH",382,414,"1200x900",800,2,600,400,"False",831,592,674,82,82,0
"D12KH",383,371,"1200x900",800,2,600,400,"True",730,560,587,27,27,0
"D12KH",384,545,"1200x900",1000,1,600,400,"True",358,562,544,-18,18,0
"D12KH",385,483,"1200x900",1000,0,600,400,"False",93,191,314,123,123,1
"D12KH",386,412,"1200x900",800,2,600,400,"True",842,280,253,-27,27,0
"D12KH",387,164,"1200x900",600,2,600,400,"False",1051,268,199,-69,69,0
"D12KH",388,308,"1200x900",800,1,600,400,"False",437,425,537,112,112,0
"D12KH",389,409,"1200x900",800,2,600,400,"True",501,659,640,-19,19,0
"D12KH",390,634,"1200x900",1000,2,600,400,"False",735,313,550,237,237,0
"D12KH",391,467,"1200x900",1000,0,600,400,"True",74,712,657,-55,55,1
"D12KH",392,387,"1200x900",800,2,600,400,"False",990,444,346,-98,98,0
"D12KH",393,645,"1200x900",1000,2,600,400,"False",619,396,321,-75,75,0
"D12KH",394,532,"1200x900",1000,1,600,400,"True",215,207,157,-50,50,0
"D12KH",395,474,"1200x900",1000,0,600,400,"False",85,339,200,-139,139,1
"D12KH",396,420,"1200x900",800,2,600,400,"True",519,223,287,64,64,0
"D12KH",397,198,"1200x900",600,2,600,400,"True",976,500,395,-105,105,0
"D12KH",398,70,"1200x900",600,0,600,400,"True",309,703,670,-33,33,1
"D12KH",399,464,"1200x900",1000,0,600,400,"True",82,222,271,49,49,1
"D12KH",400,378,"1200x900",800,2,600,400,"False",1018,708,404,-304,304,0
"D12KH",401,342,"1200x900",800,1,600,400,"False",677,204,301,97,97,0
"D12KH",402,223,"1200x900",800,0,600,400,"True",179,191,177,-14,14,1
"D12KH",403,307,"1200x900",800,1,600,400,"False",716,247,328,81,81,0
"D12KH",404,300,"1200x900",800,1,600,400,"True",620,693,664,-29,29,0
"D12KH",405,185,"1200x900",600,2,600,400,"False",907,212,327,115,115,0
"D12KH",406,158,"1200x900",600,2,600,400,"True",939,300,282,-18,18,0
"D12KH",407,523,"1200x900",1000,1,600,400,"False",339,318,208,-110,110,0
"D12KH",408,572,"1200x900",1000,1,600,400,"True",302,260,299,39,39,0
"D12KH",409,433,"1200x900",1000,0,600,400,"True",76,222,234,12,12,1
"D12KH",410,603,"1200x900",1000,2,600,400,"True",693,280,285,5,5,0
"D12KH",411,270,"1200x900",800,0,600,400,"True",192,418,392,-26,26,1
"D12KH",412,292,"1200x900",800,1,600,400,"True",88,565,602,37,37,0
"D12KH",413,252,"1200x900",800,0,600,400,"True",224,673,644,-29,29,1
"D12KH",414,112,"1200x900",600,1,600,400,"False",681,490,324,-166,166,0
"D12KH",415,361,"1200x900",800,2,600,400,"True",931,328,286,-42,42,0
"D12KH",416,357,"1200x900",800,1,600,400,"True",109,594,637,43,43,0
"D12KH",417,266,"1200x900",800,0,600,400,"True",126,303,271,-32,32,1
"D12KH",418,461,"1200x900",1000,0,600,400,"True",95,711,711,0,0,1
"D12KH",419,644,"1200x900",1000,2,600,400,"False",495,486,311,-175,175,0
"D12KH",420,271,"1200x900",800,0,600,400,"False",74,360,436,76,76,1
"D12KH",421,255,"1200x900",800,0,600,400,"False",93,709,572,-137,137,1
"D12KH",422,355,"1200x900",800,1,600,400,"False",77,386,660,274,274,0
"D12KH",423,457,"1200x900",1000,0,600,400,"True",97,630,630,0,0,1
"D12KH",424,196,"1200x900",600,2,600,400,"False",1030,397,223,-174,174,0
"D12KH",425,562,"1200x900",1000,1,600,400,"False",347,540,617,77,77,0
"D12KH",426,269,"1200x900",800,0,600,400,"True",160,295,346,51,51,1
"D12KH",427,100,"1200x900",600,1,600,400,"False",453,511,356,-155,155,0
"D12KH",428,60,"1200x900",600,0,600,400,"False",365,213,341,128,128,1
"D12KH",429,560,"1200x900",1000,1,600,400,"False",516,693,591,-102,102,0
"D12KH",430,1,"1200x900",600,0,600,400,"True",136,502,547,45,45,0
"D12KH",431,273,"1200x900",800,0,600,400,"False",180,309,231,-78,78,1
"D12KH",432,642,"1200x900",1000,2,600,400,"False",776,316,397,81,81,0
"D12KH",433,533,"1200x900",1000,1,600,400,"False",355,483,351,-132,132,0
"D12KH",434,305,"1200x900",800,1,600,400,"False",471,716,640,-76,76,0
"D12KH",435,627,"1200x900",1000,2,600,400,"True",760,510,551,41,41,0
"D12KH",436,337,"1200x900",800,1,600,400,"False",299,622,409,-213,213,0
"D12KH",437,590,"1200x900",1000,2,600,400,"False",636,278,376,98,98,0
"D12KH",438,212,"1200x900",600,2,600,400,"False",841,206,320,114,114,0
"D12KH",439,234,"1200x900",800,0,600,400,"True",72,344,289,-55,55,1
"D12KH",440,613,"1200x900",1000,2,600,400,"False",690,374,512,138,138,0
"D12KH",441,564,"1200x900",1000,1,600,400,"False",215,264,337,73,73,0
"D12KH",442,629,"1200x900",1000,2,600,400,"True",681,257,296,39,39,0
"D12KH",443,79,"1200x900",600,1,600,400,"True",731,289,278,-11,11,0
"D12KH",444,498,"1200x900",1000,0,600,400,"True",100,260,230,-30,30,1
"D12KH",445,390,"1200x900",800,2,600,400,"False",982,674,580,-94,94,1
"D12KH",446,626,"1200x900",1000,2,600,400,"False",329,449,538,89,89,0
"D12KH",447,262,"1200x900",800,0,600,400,"True",196,481,504,23,23,1
"D12KH",448,11,"1200x900",600,0,600,400,"False",372,670,563,-107,107,1
"D12KH",449,73,"1200x900",600,1,600,400,"True",94,665,569,-96,96,0
"D12KH",450,221,"1200x900",800,0,600,400,"True",132,520,593,73,73,1
"D12KH",451,18,"1200x900",600,0,600,400,"True",400,318,325,7,7,1
"D12KH",452,281,"1200x900",800,0,600,400,"True",112,611,642,31,31,1
"D12KH",453,548,"1200x900",1000,1,600,400,"True",103,278,215,-63,63,0
"D12KH",454,91,"1200x900",600,1,600,400,"False",417,630,765,135,135,1
"D12KH",455,432,"1200x900",800,2,600,400,"False",792,380,226,-154,154,0
"D12KH",456,646,"1200x900",1000,2,600,400,"False",829,227,391,164,164,1
"D12KH",457,2,"1200x900",600,0,600,400,"True",159,323,239,-84,84,0
"D12KH",458,86,"1200x900",600,1,600,400,"True",692,388,443,55,55,1
"D12KH",459,175,"1200x900",600,2,600,400,"True",1028,432,465,33,33,0
"D12KH",460,191,"1200x900",600,2,600,400,"True",962,396,321,-75,75,0
"D12KH",461,591,"1200x900",1000,2,600,400,"True",698,336,331,-5,5,0
"D12KH",462,197,"1200x900",600,2,600,400,"False",903,212,395,183,183,0
"D12KH",463,422,"1200x900",800,2,600,400,"True",712,558,582,24,24,0
"D12KH",464,490,"1200x900",1000,0,600,400,"True",114,183,174,-9,9,1
"D12KH",465,313,"1200x900",800,1,600,400,"False",588,421,503,82,82,0
"D12KH",466,94,"1200x900",600,1,600,400,"True",729,482,485,3,3,0
"D12KH",467,622,"1200x900",1000,2,600,400,"True",307,683,700,17,17,0
"D12KH",468,10,"1200x900",600,0,600,400,"True",400,499,576,77,77,1
"D12KH",469,245,"1200x900",800,0,600,400,"True",296,235,244,9,9,1
"D12KH",470,151,"1200x900",600,2,600,400,"True",828,680,651,-29,29,0
"D12KH",471,608,"1200x900",1000,2,600,400,"False",742,250,583,333,333,0
"D12KH",472,87,"1200x900",600,1,600,400,"True",231,604,589,-15,15,0
"D12KH",473,511,"1200x900",1000,1,600,400,"False",408,390,537,147,147,1
"D12KH",474,515,"1200x900",1000,1,600,400,"False",307,217,348,131,131,0
"D12KH",475,435,"1200x900",1000,0,600,400,"True",119,200,195,-5,5,1
"D12KH",476,92,"1200x900",600,1,600,400,"True",624,605,625,20,20,0
"D12KH",477,565,"1200x900",1000,1,600,400,"False",451,562,468,-94,94,0
"D12KH",478,391,"1200x900",800,2,600,400,"True",895,521,606,85,85,0
"D12KH",479,249,"1200x900",800,0,600,400,"True",126,306,257,-49,49,1
"D12KH",480,57,"1200x900",600,0,600,400,"True",354,508,505,-3,3,1
"D12KH",481,105,"1200x900",600,1,600,400,"False",527,440,593,153,153,0
"D12KH",482,602,"1200x900",1000,2,600,400,"True",865,452,472,20,20,0
"D12KH",483,403,"1200x900",800,2,600,400,"False",625,704,450,-254,254,0
"D12KH",484,56,"1200x900",600,0,600,400,"False",148,491,369,-122,122,0
"D12KH",485,4,"1200x900",600,0,600,400,"True",602,200,170,-30,30,1
"D12KH",486,330,"1200x900",800,1,600,400,"True",759,301,334,33,33,1
"D12KH",487,340,"1200x900",800,1,600,400,"False",226,240,464,224,224,0
"D12KH",488,241,"1200x900",800,0,600,400,"True",129,227,178,-49,49,1
"D12KH",489,373,"1200x900",800,2,600,400,"True",694,326,305,-21,21,0
"D12KH",490,45,"1200x900",600,0,600,400,"True",487,678,658,-20,20,1
"D12KH",491,513,"1200x900",1000,1,600,400,"False",235,602,344,-258,258,0
"D12KH",492,106,"1200x900",600,1,600,400,"True",803,659,607,-52,52,1
"D12KH",493,306,"1200x900",800,1,600,400,"False",164,524,651,127,127,0
"D12KH",494,207,"1200x900",600,2,600,400,"True",838,235,172,-63,63,0
"D12KH",495,276,"1200x900",800,0,600,400,"True",281,217,203,-14,14,1
"D12KH",496,534,"1200x900",1000,1,600,400,"False",328,504,667,163,163,1
"D12KH",497,636,"1200x900",1000,2,600,400,"True",575,583,531,-52,52,0
"D12KH",498,478,"1200x900",1000,0,600,400,"True",79,672,599,-73,73,1
"D12KH",499,399,"1200x900",800,2,600,400,"False",603,602,454,-148,148,0
"D12KH",500,447,"1200x900",1000,0,600,400,"True",71,339,272,-67,67,1
"D12KH",501,509,"1200x900",1000,1,600,400,"True",509,434,381,-53,53,0
"D12KH",502,76,"1200x900",600,1,600,400,"True",647,614,601,-13,13,0
"D12KH",503,149,"1200x900",600,2,600,400,"True",890,289,353,64,64,0
"D12KH",504,121,"1200x900",600,1,600,400,"True",884,364,345,-19,19,0
"D12KH",505,78,"1200x900",600,1,600,400,"True",885,684,641,-43,43,0
"D12KH",506,624,"1200x900",1000,2,600,400,"False",693,501,596,95,95,0
"D12KH",507,527,"1200x900",1000,1,600,400,"True",565,601,583,-18,18,0
"D12KH",508,556,"1200x900",1000,1,600,400,"True",415,420,437,17,17,0
"D12KH",509,135,"1200x900",600,1,600,400,"True",759,569,602,33,33,0
"D12KH",510,427,"1200x900",800,2,600,400,"False",812,380,292,-88,88,0
"D12KH",511,322,"1200x900",800,1,600,400,"False",703,206,377,171,171,1
"D12KH",512,484,"1200x900",1000,0,600,400,"False",100,223,110,-113,113,1
"D12KH",513,450,"1200x900",1000,0,600,400,"True",130,204,171,-33,33,1
"D12KH",514,274,"1200x900",800,0,600,400,"False",146,497,372,-125,125,1
"D12KH",515,510,"1200x900",1000,1,600,400,"False",486,338,530,192,192,1
"D12KH",516,443,"1200x900",1000,0,600,400,"False",99,651,560,-91,91,1
"D12KH",517,321,"1200x900",800,1,600,400,"False",601,190,337,147,147,0
"D12KH",518,434,"1200x900",1000,0,600,400,"True",89,657,631,-26,26,1
"D12KH",519,181,"1200x900",600,2,600,400,"True",1018,223,180,-43,43,0
"D12KH",520,126,"1200x900",600,1,600,400,"False",849,354,486,132,132,0
"D12KH",521,183,"1200x900",600,2,600,400,"True",927,289,382,93,93,0
"D12KH",522,268,"1200x900",800,0,600,400,"True",148,400,385,-15,15,1
"D12KH",523,200,"1200x900",600,2,600,400,"True",897,302,326,24,24,0
"D12KH",524,377,"1200x900",800,2,600,400,"True",683,388,409,21,21,0
"D12KH",525,99,"1200x900",600,1,600,400,"True",811,407,451,44,44,0
"D12KH",526,499,"1200x900",1000,0,600,400,"True",93,271,219,-52,52,1
"D12KH",527,542,"1200x900",1000,1,600,400,"True",304,401,410,9,9,0
"D12KH",528,633,"1200x900",1000,2,600,400,"True",564,253,296,43,43,0
"D12KH",529,374,"1200x900",800,2,600,400,"True",755,450,403,-47,47,0
"D12KH",530,265,"1200x900",800,0,600,400,"True",229,353,330,-23,23,1
"D12KH",531,333,"1200x900",800,1,600,400,"True",521,548,507,-41,41,0
"D12KH",532,643,"1200x900",1000,2,600,400,"True",740,325,288,-37,37,0
"D12KH",533,110,"1200x900",600,1,600,400,"False",776,550,622,72,72,1
"D12KH",534,44,"1200x900",600,0,600,400,"True",305,554,542,-12,12,1
"D12KH",535,315,"1200x900",800,1,600,400,"False",105,211,340,129,129,0
"D12KH",536,303,"1200x900",800,1,600,400,"True",241,431,379,-52,52,0
"D12KH",537,296,"1200x900",800,1,600,400,"True",89,279,291,12,12,0
"D12KH",538,49,"1200x900",600,0,600,400,"True",109,380,371,-9,9,0
"D12KH",539,139,"1200x900",600,1,600,400,"True",192,695,716,21,21,0
"D12KH",540,174,"1200x900",600,2,600,400,"False",998,457,350,-107,107,0
"D12KH",541,524,"1200x900",1000,1,600,400,"False",534,470,623,153,153,0
"D12KH",542,176,"1200x900",600,2,600,400,"True",1033,281,299,18,18,0
"D12KH",543,581,"1200x900",1000,2,600,400,"True",310,357,361,4,4,0
"D12KH",544,69,"1200x900",600,0,600,400,"True",322,268,199,-69,69,0
"D12KH",545,66,"1200x900",600,0,600,400,"False",155,673,511,-162,162,0
"D12KH",546,529,"1200x900",1000,1,600,400,"True",267,412,393,-19,19,1
"D12KH",547,83,"1200x900",600,1,600,400,"True",763,568,468,-100,100,1
"D12KH",548,162,"1200x900",600,2,600,400,"True",849,279,345,66,66,0
"D12KH",549,592,"1200x900",1000,2,600,400,"False",492,392,659,267,267,0
"D12KH",550,596,"1200x900",1000,2,600,400,"True",706,513,439,-74,74,0
"D12KH",551,182,"1200x900",600,2,600,400,"True",933,389,298,-91,91,0
"D12KH",552,445,"1200x900",1000,0,600,400,"False",78,302,210,-92,92,1
"D12KH",553,118,"1200x900",600,1,600,400,"True",190,588,586,-2,2,0
"D12KH",554,538,"1200x900",1000,1,600,400,"False",308,457,533,76,76,1
"D12KH",555,107,"1200x900",600,1,600,400,"False",878,678,773,95,95,0
"D12KH",556,384,"1200x900",800,2,600,400,"False",821,707,767,60,60,0
"D12KH",558,514,"1200x900",1000,1,600,400,"True",539,690,708,18,18,0
"D12KH",559,123,"1200x900",600,1,600,400,"False",761,365,258,-107,107,1
"D12KH",560,648,"1200x900",1000,2,600,400,"False",557,394,300,-94,94,0
"D12KH",561,502,"1200x900",1000,0,600,400,"False",111,639,722,83,83,1
"D12KH",562,227,"1200x900",800,0,600,400,"True",196,551,508,-43,43,1
"D12KH",563,323,"1200x900",800,1,600,400,"False",388,348,635,287,287,0
"D12KH",564,472,"1200x900",1000,0,600,400,"False",77,685,547,-138,138,1
"D12KH",565,226,"1200x900",800,0,600,400,"True",187,229,261,32,32,1
"D12KH",566,244,"1200x900",800,0,600,400,"True",194,203,229,26,26,1
"D12KH",567,304,"1200x900",800,1,600,400,"False",667,605,386,-219,219,0
"D12KH",568,138,"1200x900",600,1,600,400,"False",844,580,674,94,94,1
"D12KH",569,283,"1200x900",800,0,600,400,"True",90,264,318,54,54,1
"D12KH",570,632,"1200x900",1000,2,600,400,"False",984,227,605,378,378,0
"D12KH",571,639,"1200x900",1000,2,600,400,"True",504,456,347,-109,109,0
"D12KH",572,59,"1200x900",600,0,600,400,"False",391,692,509,-183,183,1
"D12KH",573,319,"1200x900",800,1,600,400,"True",494,587,572,-15,15,1
"D12KH",574,491,"1200x900",1000,0,600,400,"False",108,198,84,-114,114,1
"D12KH",575,128,"1200x900",600,1,600,400,"False",661,258,148,-110,110,1
"D12KH",576,568,"1200x900",1000,1,600,400,"False",286,475,611,136,136,1
"D12KH",577,16,"1200x900",600,0,600,400,"True",297,514,526,12,12,1
"D12KH",578,567,"1200x900",1000,1,600,400,"False",655,297,516,219,219,1
"D12KH",579,356,"1200x900",800,1,600,400,"True",123,484,464,-20,20,0
"D12KH",580,42,"1200x900",600,0,600,400,"True",233,479,514,35,35,0
"D12KH",581,193,"1200x900",600,2,600,400,"True",874,588,552,-36,36,0
"D12KH",582,580,"1200x900",1000,2,600,400,"False",651,267,361,94,94,0
"D12KH",583,573,"1200x900",1000,1,600,400,"True",486,615,672,57,57,0
"D12KH",584,336,"1200x900",800,1,600,400,"True",251,587,521,-66,66,0
"D12KH",585,286,"1200x900",800,0,600,400,"False",105,378,291,-87,87,1
"D12KH",586,52,"1200x900",600,0,600,400,"True",171,188,179,-9,9,0
"D12KH",587,62,"1200x900",600,0,600,400,"True",345,346,333,-13,13,1
"D12KH",588,372,"1200x900",800,2,600,400,"True",833,620,622,2,2,0
"D12KH",589,389,"1200x900",800,2,600,400,"True",843,530,526,-4,4,0
"D12KH",590,39,"1200x900",600,0,600,400,"True",210,609,555,-54,54,0
"D12KH",591,618,"1200x900",1000,2,600,400,"True",276,671,625,-46,46,0
"D12KH",592,232,"1200x900",800,0,600,400,"True",84,511,538,27,27,1
"D12KH",593,272,"1200x900",800,0,600,400,"False",200,181,251,70,70,1
"D12KH",594,551,"1200x900",1000,1,600,400,"False",146,445,365,-80,80,1
"D12KH",595,233,"1200x900",800,0,600,400,"True",164,700,640,-60,60,1
"D12KH",596,50,"1200x900",600,0,600,400,"True",75,582,643,61,61,0
"D12KH",597,428,"1200x900",800,2,600,400,"False",732,665,573,-92,92,0
"D12KH",598,347,"1200x900",800,1,600,400,"False",757,295,525,230,230,1
"D12KH",599,19,"1200x900",600,0,600,400,"True",286,686,670,-16,16,0
"D12KH",600,251,"1200x900",800,0,600,400,"True",88,352,379,27,27,1
"D12KH",601,411,"1200x900",800,2,600,400,"False",805,361,514,153,153,0
"D12KH",602,501,"1200x900",1000,0,600,400,"False",96,323,236,-87,87,1
"D12KH",603,55,"1200x900",600,0,600,400,"True",211,305,286,-19,19,1
"D12KH",604,125,"1200x900",600,1,600,400,"True",750,531,515,-16,16,0
"D12KH",605,205,"1200x900",600,2,600,400,"True",1021,504,532,28,28,0
"D12KH",606,479,"1200x900",1000,0,600,400,"True",74,705,656,-49,49,1
"D12KH",607,97,"1200x900",600,1,600,400,"True",760,643,660,17,17,1
"D12KH",608,129,"1200x900",600,1,600,400,"False",859,482,361,-121,121,1
"D12KH",609,628,"1200x900",1000,2,600,400,"True",768,410,381,-29,29,0
"D12KH",610,392,"1200x900",800,2,600,400,"True",1031,618,665,47,47,0
"D12KH",611,201,"1200x900",600,2,600,400,"True",1005,462,476,14,14,0
"D12KH",612,27,"1200x900",600,0,600,400,"True",373,309,257,-52,52,1
"D12KH",613,519,"1200x900",1000,1,600,400,"True",319,565,498,-67,67,1
"D12KH",614,338,"1200x900",800,1,600,400,"False",813,253,420,167,167,1
"D12KH",615,468,"1200x900",1000,0,600,400,"False",121,219,132,-87,87,1
"D12KH",616,557,"1200x900",1000,1,600,400,"False",677,505,671,166,166,1
"D12KH",617,405,"1200x900",800,2,600,400,"False",790,307,408,101,101,0
"D12KH",618,206,"1200x900",600,2,600,400,"False",975,223,326,103,103,0
"D12KH",619,314,"1200x900",800,1,600,400,"False",277,616,324,-292,292,1
"D12KH",620,619,"1200x900",1000,2,600,400,"False",803,247,327,80,80,0
"D12KH",621,187,"1200x900",600,2,600,400,"False",857,639,307,-332,332,0
"D12KH",622,167,"1200x900",600,2,600,400,"True",956,241,309,68,68,0
"D12KH",623,195,"1200x900",600,2,600,400,"True",942,249,262,13,13,0
"D12KH",624,238,"1200x900",800,0,600,400,"False",162,283,147,-136,136,1
"D12KH",625,301,"1200x900",800,1,600,400,"True",162,574,561,-13,13,0
"D12KH",626,288,"1200x900",800,0,600,400,"True",180,547,505,-42,42,1
"D12KH",627,14,"1200x900",600,0,600,400,"True",399,224,153,-71,71,1
"D12KH",628,594,"1200x900",1000,2,600,400,"True",537,637,628,-9,9,0
"D12KH",629,179,"1200x900",600,2,600,400,"True",908,602,597,-5,5,0
"D12KH",630,13,"1200x900",600,0,600,400,"True",296,211,264,53,53,1
"D12KH",631,437,"1200x900",1000,0,600,400,"False",74,667,532,-135,135,1
"D12KH",632,147,"1200x900",600,2,600,400,"False",942,418,336,-82,82,0
"D12KH",633,400,"1200x900",800,2,600,400,"True",733,297,294,-3,3,0
"D12KH",634,600,"1200x900",1000,2,600,400,"False",765,207,389,182,182,0
"D12KH",635,5,"1200x900",600,0,600,400,"False",228,587,491,-96,96,0
"D12KH",636,526,"1200x900",1000,1,600,400,"False",497,710,560,-150,150,0
"D12KH",637,317,"1200x900",800,1,600,400,"True",185,564,597,33,33,0
"D12KH",638,631,"1200x900",1000,2,600,400,"False",699,479,388,-91,91,0
"D12KH",639,108,"1200x900",600,1,600,400,"False",830,239,398,159,159,0
"D12KH",640,612,"1200x900",1000,2,600,400,"True",706,198,165,-33,33,0
"D12KH",641,215,"1200x900",600,2,600,400,"True",939,596,646,50,50,0
"D12KH",642,540,"1200x900",1000,1,600,400,"False",389,568,468,-100,100,1
"D12KH",643,348,"1200x900",800,1,600,400,"True",764,294,310,16,16,0
"D12KH",644,418,"1200x900",800,2,600,400,"False",754,507,373,-134,134,0
"D12KH",645,122,"1200x900",600,1,600,400,"True",817,709,645,-64,64,0
"D12KH",646,351,"1200x900",800,1,600,400,"False",122,581,662,81,81,0
"D12KH",647,213,"1200x900",600,2,600,400,"True",822,275,331,56,56,0
"D12KH",648,96,"1200x900",600,1,600,400,"True",433,458,488,30,30,0
"D13JS",1,601,"1200x900",1000,2,600,400,"False",735,697,357,-340,340,0
"D13JS",2,549,"1200x900",1000,1,600,400,"True",657,366,313,-53,53,0
"D13JS",3,13,"1200x900",600,0,600,400,"True",296,211,189,-22,22,1
"D13JS",4,255,"1200x900",800,0,600,400,"True",93,709,768,59,59,1
"D13JS",5,490,"1200x900",1000,0,600,400,"True",114,183,219,36,36,1
"D13JS",6,484,"1200x900",1000,0,600,400,"True",100,223,191,-32,32,1
"D13JS",7,33,"1200x900",600,0,600,400,"True",198,533,540,7,7,1
"D13JS",8,460,"1200x900",1000,0,600,400,"False",155,189,271,82,82,1
"D13JS",9,205,"1200x900",600,2,600,400,"False",1021,504,686,182,182,0
"D13JS",10,286,"1200x900",800,0,600,400,"False",105,378,254,-124,124,1
"D13JS",11,580,"1200x900",1000,2,600,400,"False",651,267,639,372,372,0
"D13JS",12,133,"1200x900",600,1,600,400,"False",345,551,338,-213,213,0
"D13JS",13,546,"1200x900",1000,1,600,400,"True",305,374,315,-59,59,0
"D13JS",14,616,"1200x900",1000,2,600,400,"True",854,357,316,-41,41,1
"D13JS",15,38,"1200x900",600,0,600,400,"False",120,628,428,-200,200,1
"D13JS",16,575,"1200x900",1000,1,600,400,"True",272,693,672,-21,21,0
"D13JS",17,95,"1200x900",600,1,600,400,"True",749,425,470,45,45,1
"D13JS",18,123,"1200x900",600,1,600,400,"False",761,365,243,-122,122,1
"D13JS",19,577,"1200x900",1000,2,600,400,"False",455,420,262,-158,158,0
"D13JS",20,121,"1200x900",600,1,600,400,"True",884,364,430,66,66,0
"D13JS",21,340,"1200x900",800,1,600,400,"False",226,240,297,57,57,0
"D13JS",23,345,"1200x900",800,1,600,400,"False",841,566,631,65,65,1
"D13JS",24,402,"1200x900",800,2,600,400,"False",878,234,342,108,108,0
"D13JS",25,403,"1200x900",800,2,600,400,"False",625,704,343,-361,361,0
"D13JS",26,394,"1200x900",800,2,600,400,"False",847,292,510,218,218,0
"D13JS",27,234,"1200x900",800,0,600,400,"True",72,344,294,-50,50,1
"D13JS",28,184,"1200x900",600,2,600,400,"False",1067,441,766,325,325,0
"D13JS",29,593,"1200x900",1000,2,600,400,"False",246,719,438,-281,281,0
"D13JS",30,363,"1200x900",800,2,600,400,"False",800,218,439,221,221,0
"D13JS",31,645,"1200x900",1000,2,600,400,"False",619,396,309,-87,87,0
"D13JS",32,253,"1200x900",800,0,600,400,"False",177,424,341,-83,83,1
"D13JS",34,512,"1200x900",1000,1,600,400,"False",139,261,343,82,82,0
"D13JS",35,226,"1200x900",800,0,600,400,"True",187,229,275,46,46,1
"D13JS",36,587,"1200x900",1000,2,600,400,"False",741,686,513,-173,173,0
"D13JS",37,562,"1200x900",1000,1,600,400,"False",347,540,415,-125,125,0
"D13JS",38,502,"1200x900",1000,0,600,400,"True",111,639,581,-58,58,1
"D13JS",39,600,"1200x900",1000,2,600,400,"False",765,207,472,265,265,0
"D13JS",40,73,"1200x900",600,1,600,400,"False",94,665,337,-328,328,0
"D13JS",41,115,"1200x900",600,1,600,400,"False",545,307,214,-93,93,0
"D13JS",42,515,"1200x900",1000,1,600,400,"False",307,217,352,135,135,0
"D13JS",43,348,"1200x900",800,1,600,400,"False",764,294,435,141,141,0
"D13JS",44,283,"1200x900",800,0,600,400,"True",90,264,315,51,51,1
"D13JS",45,292,"1200x900",800,1,600,400,"False",88,565,630,65,65,0
"D13JS",46,465,"1200x900",1000,0,600,400,"False",85,203,417,214,214,1
"D13JS",47,113,"1200x900",600,1,600,400,"True",897,657,699,42,42,0
"D13JS",48,170,"1200x900",600,2,600,400,"False",996,468,409,-59,59,0
"D13JS",49,379,"1200x900",800,2,600,400,"False",994,325,610,285,285,0
"D13JS",50,613,"1200x900",1000,2,600,400,"False",690,374,441,67,67,0
"D13JS",51,111,"1200x900",600,1,600,400,"False",922,552,349,-203,203,1
"D13JS",52,308,"1200x900",800,1,600,400,"False",437,425,585,160,160,0
"D13JS",53,438,"1200x900",1000,0,600,400,"True",77,713,658,-55,55,1
"D13JS",54,545,"1200x900",1000,1,600,400,"True",358,562,548,-14,14,0
"D13JS",55,218,"1200x900",800,0,600,400,"True",106,397,462,65,65,1
"D13JS",56,77,"1200x900",600,1,600,400,"False",780,525,396,-129,129,0
"D13JS",57,199,"1200x900",600,2,600,400,"True",992,467,422,-45,45,0
"D13JS",58,458,"1200x900",1000,0,600,400,"True",78,624,610,-14,14,1
"D13JS",59,321,"1200x900",800,1,600,400,"False",601,190,264,74,74,0
"D13JS",60,139,"1200x900",600,1,600,400,"False",192,695,471,-224,224,0
"D13JS",61,224,"1200x900",800,0,600,400,"True",161,474,457,-17,17,1
"D13JS",62,330,"1200x900",800,1,600,400,"True",759,301,308,7,7,1
"D13JS",63,573,"1200x900",1000,1,600,400,"False",486,615,518,-97,97,0
"D13JS",64,574,"1200x900",1000,1,600,400,"False",614,194,411,217,217,0
"D13JS",65,620,"1200x900",1000,2,600,400,"False",832,649,557,-92,92,0
"D13JS",66,451,"1200x900",1000,0,600,400,"True",110,702,743,41,41,1
"D13JS",67,570,"1200x900",1000,1,600,400,"False",315,352,595,243,243,0
"D13JS",68,640,"1200x900",1000,2,600,400,"True",361,334,404,70,70,0
"D13JS",69,365,"1200x900",800,2,600,400,"False",1055,305,501,196,196,0
"D13JS",70,153,"1200x900",600,2,600,400,"False",1037,601,419,-182,182,0
"D13JS",71,370,"1200x900",800,2,600,400,"True",874,336,426,90,90,0
"D13JS",72,236,"1200x900",800,0,600,400,"True",162,350,375,25,25,1
"D13JS",73,540,"1200x900",1000,1,600,400,"False",389,568,248,-320,320,1
"D13JS",74,260,"1200x900",800,0,600,400,"False",103,525,457,-68,68,1
"D13JS",75,81,"1200x900",600,1,600,400,"False",696,225,301,76,76,0
"D13JS",76,271,"1200x900",800,0,600,400,"True",74,360,377,17,17,1
"D13JS",77,96,"1200x900",600,1,600,400,"True",433,458,499,41,41,0
"D13JS",80,239,"1200x900",800,0,600,400,"False",114,231,296,65,65,1
"D13JS",81,264,"1200x900",800,0,600,400,"False",198,660,497,-163,163,1
"D13JS",82,270,"1200x900",800,0,600,400,"True",192,418,407,-11,11,1
"D13JS",83,441,"1200x900",1000,0,600,400,"False",85,684,578,-106,106,1
"D13JS",84,612,"1200x900",1000,2,600,400,"False",706,198,554,356,356,0
"D13JS",85,324,"1200x900",800,1,600,400,"False",719,712,439,-273,273,1
"D13JS",87,517,"1200x900",1000,1,600,400,"False",548,182,291,109,109,0
"D13JS",88,424,"1200x900",800,2,600,400,"True",903,545,584,39,39,0
"D13JS",89,422,"1200x900",800,2,600,400,"False",712,558,315,-243,243,0
"D13JS",90,338,"1200x900",800,1,600,400,"True",813,253,241,-12,12,1
"D13JS",91,21,"1200x900",600,0,600,400,"True",314,383,317,-66,66,1
"D13JS",92,642,"1200x900",1000,2,600,400,"True",776,316,320,4,4,0
"D13JS",93,488,"1200x900",1000,0,600,400,"True",129,687,710,23,23,1
"D13JS",94,43,"1200x900",600,0,600,400,"True",277,446,497,51,51,1
"D13JS",95,528,"1200x900",1000,1,600,400,"False",839,227,573,346,346,1
"D13JS",96,257,"1200x900",800,0,600,400,"False",97,219,115,-104,104,1
"D13JS",97,208,"1200x900",600,2,600,400,"False",946,399,608,209,209,0
"D13JS",98,547,"1200x900",1000,1,600,400,"False",369,384,563,179,179,1
"D13JS",99,584,"1200x900",1000,2,600,400,"False",731,413,618,205,205,0
"D13JS",100,209,"1200x900",600,2,600,400,"True",937,637,609,-28,28,0
"D13JS",101,480,"1200x900",1000,0,600,400,"False",100,231,81,-150,150,1
"D13JS",102,92,"1200x900",600,1,600,400,"False",624,605,331,-274,274,0
"D13JS",103,634,"1200x900",1000,2,600,400,"True",735,313,337,24,24,0
"D13JS",104,146,"1200x900",600,2,600,400,"True",989,492,480,-12,12,0
"D13JS",105,147,"1200x900",600,2,600,400,"True",942,418,484,66,66,0
"D13JS",108,91,"1200x900",600,1,600,400,"False",417,630,512,-118,118,1
"D13JS",109,11,"1200x900",600,0,600,400,"True",372,670,668,-2,2,1
"D13JS",110,586,"1200x900",1000,2,600,400,"False",802,262,596,334,334,0
"D13JS",111,361,"1200x900",800,2,600,400,"False",931,328,542,214,214,0
"D13JS",112,164,"1200x900",600,2,600,400,"True",1051,268,275,7,7,0
"D13JS",113,583,"1200x900",1000,2,600,400,"True",949,284,246,-38,38,1
"D13JS",114,42,"1200x900",600,0,600,400,"False",233,479,390,-89,89,0
"D13JS",115,97,"1200x900",600,1,600,400,"False",760,643,704,61,61,1
"D13JS",116,204,"1200x900",600,2,600,400,"True",1053,432,488,56,56,0
"D13JS",118,198,"1200x900",600,2,600,400,"True",976,500,491,-9,9,0
"D13JS",119,566,"1200x900",1000,1,600,400,"True",378,472,511,39,39,1
"D13JS",120,482,"1200x900",1000,0,600,400,"False",79,686,615,-71,71,1
"D13JS",121,510,"1200x900",1000,1,600,400,"False",486,338,601,263,263,1
"D13JS",122,127,"1200x900",600,1,600,400,"True",309,691,638,-53,53,0
"D13JS",123,232,"1200x900",800,0,600,400,"False",84,511,592,81,81,1
"D13JS",124,498,"1200x900",1000,0,600,400,"True",100,260,308,48,48,1
"D13JS",125,633,"1200x900",1000,2,600,400,"False",564,253,317,64,64,0
"D13JS",126,594,"1200x900",1000,2,600,400,"False",537,637,277,-360,360,0
"D13JS",127,206,"1200x900",600,2,600,400,"False",975,223,488,265,265,0
"D13JS",128,221,"1200x900",800,0,600,400,"False",132,520,448,-72,72,1
"D13JS",129,335,"1200x900",800,1,600,400,"False",124,360,454,94,94,0
"D13JS",130,599,"1200x900",1000,2,600,400,"False",316,570,438,-132,132,0
"D13JS",131,245,"1200x900",800,0,600,400,"False",296,235,320,85,85,1
"D13JS",132,450,"1200x900",1000,0,600,400,"True",130,204,245,41,41,1
"D13JS",133,16,"1200x900",600,0,600,400,"False",297,514,278,-236,236,1
"D13JS",134,268,"1200x900",800,0,600,400,"False",148,400,320,-80,80,1
"D13JS",135,235,"1200x900",800,0,600,400,"False",146,646,568,-78,78,1
"D13JS",136,352,"1200x900",800,1,600,400,"False",235,717,615,-102,102,0
"D13JS",137,70,"1200x900",600,0,600,400,"True",309,703,696,-7,7,1
"D13JS",138,420,"1200x900",800,2,600,400,"False",519,223,689,466,466,0
"D13JS",139,337,"1200x900",800,1,600,400,"False",299,622,696,74,74,0
"D13JS",140,169,"1200x900",600,2,600,400,"False",924,290,684,394,394,0
"D13JS",141,31,"1200x900",600,0,600,400,"True",365,338,350,12,12,1
"D13JS",142,555,"1200x900",1000,1,600,400,"False",444,556,645,89,89,0
"D13JS",143,309,"1200x900",800,1,600,400,"False",186,225,487,262,262,0
"D13JS",144,393,"1200x900",800,2,600,400,"False",657,620,288,-332,332,0
"D13JS",145,103,"1200x900",600,1,600,400,"False",528,320,518,198,198,1
"D13JS",146,507,"1200x900",1000,1,600,400,"True",608,583,565,-18,18,1
"D13JS",147,120,"1200x900",600,1,600,400,"True",690,655,584,-71,71,0
"D13JS",148,466,"1200x900",1000,0,600,400,"False",82,205,297,92,92,1
"D13JS",149,506,"1200x900",1000,1,600,400,"False",559,567,298,-269,269,1
"D13JS",150,306,"1200x900",800,1,600,400,"True",164,524,564,40,40,0
"D13JS",151,328,"1200x900",800,1,600,400,"False",104,649,480,-169,169,0
"D13JS",152,415,"1200x900",800,2,600,400,"True",823,684,704,20,20,0
"D13JS",153,409,"1200x900",800,2,600,400,"True",501,659,669,10,10,0
"D13JS",155,343,"1200x900",800,1,600,400,"False",407,557,670,113,113,0
"D13JS",156,156,"1200x900",600,2,600,400,"False",913,197,565,368,368,0
"D13JS",157,84,"1200x900",600,1,600,400,"False",144,184,325,141,141,0
"D13JS",158,541,"1200x900",1000,1,600,400,"False",339,478,380,-98,98,0
"D13JS",159,126,"1200x900",600,1,600,400,"False",849,354,495,141,141,0
"D13JS",160,624,"1200x900",1000,2,600,400,"False",693,501,414,-87,87,0
"D13JS",161,414,"1200x900",800,2,600,400,"False",831,592,382,-210,210,0
"D13JS",162,377,"1200x900",800,2,600,400,"True",683,388,441,53,53,0
"D13JS",163,483,"1200x900",1000,0,600,400,"True",93,191,204,13,13,1
"D13JS",164,151,"1200x900",600,2,600,400,"False",828,680,544,-136,136,0
"D13JS",165,242,"1200x900",800,0,600,400,"False",117,448,599,151,151,1
"D13JS",166,50,"1200x900",600,0,600,400,"True",75,582,583,1,1,0
"D13JS",167,497,"1200x900",1000,0,600,400,"False",106,696,582,-114,114,1
"D13JS",168,312,"1200x900",800,1,600,400,"False",238,683,437,-246,246,0
"D13JS",169,609,"1200x900",1000,2,600,400,"False",697,627,449,-178,178,0
"D13JS",170,514,"1200x900",1000,1,600,400,"True",539,690,717,27,27,0
"D13JS",171,425,"1200x900",800,2,600,400,"False",621,438,677,239,239,0
"D13JS",172,163,"1200x900",600,2,600,400,"True",1046,665,563,-102,102,0
"D13JS",173,51,"1200x900",600,0,600,400,"True",272,181,229,48,48,1
"D13JS",174,327,"1200x900",800,1,600,400,"False",152,339,159,-180,180,0
"D13JS",175,526,"1200x900",1000,1,600,400,"False",497,710,562,-148,148,0
"D13JS",176,108,"1200x900",600,1,600,400,"False",830,239,555,316,316,0
"D13JS",177,456,"1200x900",1000,0,600,400,"True",91,257,218,-39,39,1
"D13JS",178,276,"1200x900",800,0,600,400,"True",281,217,241,24,24,1
"D13JS",180,396,"1200x900",800,2,600,400,"False",678,663,246,-417,417,0
"D13JS",182,293,"1200x900",800,1,600,400,"True",561,396,329,-67,67,0
"D13JS",183,173,"1200x900",600,2,600,400,"False",948,693,323,-370,370,0
"D13JS",184,533,"1200x900",1000,1,600,400,"False",355,483,318,-165,165,0
"D13JS",185,1,"1200x900",600,0,600,400,"True",136,502,479,-23,23,0
"D13JS",186,564,"1200x900",1000,1,600,400,"True",215,264,332,68,68,0
"D13JS",187,222,"1200x900",800,0,600,400,"True",152,206,147,-59,59,1
"D13JS",188,531,"1200x900",1000,1,600,400,"False",233,362,560,198,198,0
"D13JS",189,89,"1200x900",600,1,600,400,"False",917,366,562,196,196,1
"D13JS",190,643,"1200x900",1000,2,600,400,"False",740,325,166,-159,159,0
"D13JS",191,431,"1200x900",800,2,600,400,"False",694,382,518,136,136,0
"D13JS",192,605,"1200x900",1000,2,600,400,"False",493,665,401,-264,264,0
"D13JS",193,15,"1200x900",600,0,600,400,"True",473,352,336,-16,16,1
"D13JS",194,304,"1200x900",800,1,600,400,"False",667,605,379,-226,226,0
"D13JS",195,354,"1200x900",800,1,600,400,"False",118,236,348,112,112,0
"D13JS",196,18,"1200x900",600,0,600,400,"True",400,318,286,-32,32,1
"D13JS",197,472,"1200x900",1000,0,600,400,"False",77,685,559,-126,126,1
"D13JS",198,597,"1200x900",1000,2,600,400,"True",352,239,216,-23,23,0
"D13JS",199,301,"1200x900",800,1,600,400,"False",162,574,640,66,66,0
"D13JS",200,282,"1200x900",800,0,600,400,"True",109,246,264,18,18,1
"D13JS",201,5,"1200x900",600,0,600,400,"True",228,587,633,46,46,0
"D13JS",202,82,"1200x900",600,1,600,400,"True",108,213,264,51,51,0
"D13JS",203,265,"1200x900",800,0,600,400,"True",229,353,283,-70,70,1
"D13JS",205,137,"1200x900",600,1,600,400,"True",789,577,576,-1,1,0
"D13JS",207,26,"1200x900",600,0,600,400,"True",70,712,677,-35,35,0
"D13JS",208,138,"1200x900",600,1,600,400,"False",844,580,656,76,76,1
"D13JS",209,174,"1200x900",600,2,600,400,"False",998,457,586,129,129,0
"D13JS",210,364,"1200x900",800,2,600,400,"False",1018,204,611,407,407,0
"D13JS",211,401,"1200x900",800,2,600,400,"False",821,260,194,-66,66,0
"D13JS",212,477,"1200x900",1000,0,600,400,"True",88,640,613,-27,27,1
"D13JS",213,360,"1200x900",800,1,600,400,"False",203,608,392,-216,216,0
"D13JS",215,463,"1200x900",1000,0,600,400,"True",115,693,693,0,0,1
"D13JS",216,487,"1200x900",1000,0,600,400,"False",78,670,555,-115,115,1
"D13JS",217,636,"1200x900",1000,2,600,400,"True",575,583,556,-27,27,0
"D13JS",221,10,"1200x900",600,0,600,400,"True",400,499,497,-2,2,1
"D13JS",222,176,"1200x900",600,2,600,400,"False",1033,281,502,221,221,0
"D13JS",223,622,"1200x900",1000,2,600,400,"False",307,683,399,-284,284,0
"D13JS",224,86,"1200x900",600,1,600,400,"True",692,388,354,-34,34,1
"D13JS",225,105,"1200x900",600,1,600,400,"True",527,440,373,-67,67,0
"D13JS",226,516,"1200x900",1000,1,600,400,"False",440,559,660,101,101,0
"D13JS",227,307,"1200x900",800,1,600,400,"False",716,247,659,412,412,0
"D13JS",228,617,"1200x900",1000,2,600,400,"False",294,180,634,454,454,0
"D13JS",229,464,"1200x900",1000,0,600,400,"True",82,222,149,-73,73,1
"D13JS",230,262,"1200x900",800,0,600,400,"True",196,481,416,-65,65,1
"D13JS",231,220,"1200x900",800,0,600,400,"True",108,699,661,-38,38,1
"D13JS",232,159,"1200x900",600,2,600,400,"True",992,309,319,10,10,0
"D13JS",233,259,"1200x900",800,0,600,400,"True",156,180,203,23,23,1
"D13JS",234,495,"1200x900",1000,0,600,400,"False",93,692,409,-283,283,1
"D13JS",236,3,"1200x900",600,0,600,400,"False",298,443,526,83,83,1
"D13JS",237,214,"1200x900",600,2,600,400,"False",1046,305,525,220,220,0
"D13JS",238,140,"1200x900",600,1,600,400,"True",700,523,523,0,0,0
"D13JS",239,314,"1200x900",800,1,600,400,"False",277,616,486,-130,130,1
"D13JS",240,434,"1200x900",1000,0,600,400,"False",89,657,491,-166,166,1
"D13JS",241,392,"1200x900",800,2,600,400,"False",1031,618,492,-126,126,0
"D13JS",242,319,"1200x900",800,1,600,400,"True",494,587,515,-72,72,1
"D13JS",243,368,"1200x900",800,2,600,400,"True",778,515,518,3,3,0
"D13JS",244,446,"1200x900",1000,0,600,400,"True",72,298,300,2,2,1
"D13JS",245,179,"1200x900",600,2,600,400,"False",908,602,303,-299,299,0
"D13JS",246,527,"1200x900",1000,1,600,400,"False",565,601,308,-293,293,0
"D13JS",247,56,"1200x900",600,0,600,400,"False",148,491,380,-111,111,0
"D13JS",248,390,"1200x900",800,2,600,400,"False",982,674,381,-293,293,1
"D13JS",251,358,"1200x900",800,1,600,400,"False",263,635,482,-153,153,0
"D13JS",252,567,"1200x900",1000,1,600,400,"False",655,297,50,-247,247,1
"D13JS",253,213,"1200x900",600,2,600,400,"True",822,275,258,-17,17,0
"D13JS",254,155,"1200x900",600,2,600,400,"False",940,269,412,143,143,0
"D13JS",255,240,"1200x900",800,0,600,400,"False",330,656,578,-78,78,1
"D13JS",256,311,"1200x900",800,1,600,400,"False",710,261,429,168,168,0
"D13JS",258,496,"1200x900",1000,0,600,400,"False",70,639,432,-207,207,1
"D13JS",259,193,"1200x900",600,2,600,400,"True",874,588,636,48,48,0
"D13JS",260,519,"1200x900",1000,1,600,400,"False",319,565,427,-138,138,1
"D13JS",261,74,"1200x900",600,1,600,400,"True",115,358,416,58,58,0
"D13JS",262,342,"1200x900",800,1,600,400,"False",677,204,494,290,290,0
"D13JS",263,288,"1200x900",800,0,600,400,"True",180,547,563,16,16,1
"D13JS",264,85,"1200x900",600,1,600,400,"False",434,347,733,386,386,0
"D13JS",265,461,"1200x900",1000,0,600,400,"False",95,711,594,-117,117,1
"D13JS",266,572,"1200x900",1000,1,600,400,"False",302,260,346,86,86,0
"D13JS",267,30,"1200x900",600,0,600,400,"True",107,353,324,-29,29,0
"D13JS",268,130,"1200x900",600,1,600,400,"True",741,428,481,53,53,0
"D13JS",269,36,"1200x900",600,0,600,400,"False",128,346,423,77,77,1
"D13JS",270,229,"1200x900",800,0,600,400,"False",117,697,594,-103,103,1
"D13JS",271,596,"1200x900",1000,2,600,400,"False",706,513,626,113,113,0
"D13JS",272,275,"1200x900",800,0,600,400,"True",120,594,580,-14,14,0
"D13JS",273,4,"1200x900",600,0,600,400,"False",602,200,293,93,93,1
"D13JS",274,457,"1200x900",1000,0,600,400,"False",97,630,477,-153,153,1
"D13JS",275,141,"1200x900",600,1,600,400,"False",671,582,456,-126,126,0
"D13JS",276,172,"1200x900",600,2,600,400,"False",912,444,567,123,123,0
"D13JS",277,453,"1200x900",1000,0,600,400,"True",71,393,415,22,22,1
"D13JS",278,59,"1200x900",600,0,600,400,"True",391,692,652,-40,40,1
"D13JS",280,406,"1200x900",800,2,600,400,"False",971,233,445,212,212,0
"D13JS",281,367,"1200x900",800,2,600,400,"False",613,464,371,-93,93,0
"D13JS",282,481,"1200x900",1000,0,600,400,"False",80,185,253,68,68,1
"D13JS",283,54,"1200x900",600,0,600,400,"False",474,564,657,93,93,1
"D13JS",285,212,"1200x900",600,2,600,400,"False",841,206,651,445,445,0
"D13JS",286,378,"1200x900",800,2,600,400,"False",1018,708,648,-60,60,0
"D13JS",287,561,"1200x900",1000,1,600,400,"False",231,406,525,119,119,0
"D13JS",288,278,"1200x900",800,0,600,400,"True",251,711,677,-34,34,1
"D13JS",289,303,"1200x900",800,1,600,400,"True",241,431,439,8,8,0
"D13JS",290,300,"1200x900",800,1,600,400,"False",620,693,566,-127,127,0
"D13JS",291,49,"1200x900",600,0,600,400,"True",109,380,385,5,5,0
"D13JS",292,157,"1200x900",600,2,600,400,"True",1016,323,388,65,65,0
"D13JS",293,267,"1200x900",800,0,600,400,"True",145,665,625,-40,40,1
"D13JS",294,407,"1200x900",800,2,600,400,"True",989,340,308,-32,32,0
"D13JS",295,485,"1200x900",1000,0,600,400,"False",121,694,614,-80,80,1
"D13JS",296,558,"1200x900",1000,1,600,400,"True",72,464,537,73,73,1
"D13JS",298,459,"1200x900",1000,0,600,400,"True",70,645,586,-59,59,1
"D13JS",299,35,"1200x900",600,0,600,400,"True",366,555,585,30,30,1
"D13JS",300,20,"1200x900",600,0,600,400,"False",204,545,681,136,136,1
"D13JS",301,329,"1200x900",800,1,600,400,"False",517,239,450,211,211,0
"D13JS",302,356,"1200x900",800,1,600,400,"True",123,484,499,15,15,0
"D13JS",303,608,"1200x900",1000,2,600,400,"False",742,250,308,58,58,0
"D13JS",304,384,"1200x900",800,2,600,400,"False",821,707,330,-377,377,0
"D13JS",305,595,"1200x900",1000,2,600,400,"False",687,640,169,-471,471,0
"D13JS",306,563,"1200x900",1000,1,600,400,"True",201,696,682,-14,14,0
"D13JS",307,285,"1200x900",800,0,600,400,"True",237,396,326,-70,70,1
"D13JS",308,625,"1200x900",1000,2,600,400,"False",279,228,333,105,105,0
"D13JS",309,58,"1200x900",600,0,600,400,"False",353,655,509,-146,146,1
"D13JS",310,68,"1200x900",600,0,600,400,"True",165,367,410,43,43,0
"D13JS",311,149,"1200x900",600,2,600,400,"False",890,289,411,122,122,0
"D13JS",312,150,"1200x900",600,2,600,400,"True",897,345,416,71,71,0
"D13JS",313,9,"1200x900",600,0,600,400,"True",509,654,697,43,43,1
"D13JS",314,52,"1200x900",600,0,600,400,"True",171,188,219,31,31,0
"D13JS",315,243,"1200x900",800,0,600,400,"False",114,332,226,-106,106,1
"D13JS",316,376,"1200x900",800,2,600,400,"True",788,275,229,-46,46,0
"D13JS",317,462,"1200x900",1000,0,600,400,"True",102,672,692,20,20,1
"D13JS",318,591,"1200x900",1000,2,600,400,"False",698,336,694,358,358,0
"D13JS",319,124,"1200x900",600,1,600,400,"False",345,467,270,-197,197,0
"D13JS",320,581,"1200x900",1000,2,600,400,"False",310,357,441,84,84,0
"D13JS",321,494,"1200x900",1000,0,600,400,"False",127,692,620,-72,72,1
"D13JS",323,499,"1200x900",1000,0,600,400,"False",93,271,177,-94,94,1
"D13JS",324,397,"1200x900",800,2,600,400,"True",817,692,704,12,12,0
"D13JS",325,93,"1200x900",600,1,600,400,"False",139,540,271,-269,269,0
"D13JS",326,107,"1200x900",600,1,600,400,"True",878,678,632,-46,46,0
"D13JS",327,627,"1200x900",1000,2,600,400,"False",760,510,633,123,123,0
"D13JS",328,629,"1200x900",1000,2,600,400,"False",681,257,438,181,181,0
"D13JS",329,473,"1200x900",1000,0,600,400,"True",75,323,288,-35,35,1
"D13JS",330,471,"1200x900",1000,0,600,400,"True",122,200,180,-20,20,1
"D13JS",332,552,"1200x900",1000,1,600,400,"False",255,412,675,263,263,0
"D13JS",333,279,"1200x900",800,0,600,400,"True",252,202,232,30,30,1
"D13JS",334,332,"1200x900",800,1,600,400,"False",260,699,448,-251,251,0
"D13JS",335,382,"1200x900",800,2,600,400,"False",870,523,640,117,117,0
"D13JS",336,87,"1200x900",600,1,600,400,"False",231,604,472,-132,132,0
"D13JS",337,374,"1200x900",800,2,600,400,"False",755,450,335,-115,115,0
"D13JS",338,291,"1200x900",800,1,600,400,"False",522,694,334,-360,360,0
"D13JS",339,621,"1200x900",1000,2,600,400,"False",540,478,337,-141,141,0
"D13JS",341,250,"1200x900",800,0,600,400,"True",290,248,224,-24,24,1
"D13JS",342,190,"1200x900",600,2,600,400,"True",977,238,223,-15,15,0
"D13JS",343,298,"1200x900",800,1,600,400,"True",311,457,468,11,11,0
"D13JS",345,88,"1200x900",600,1,600,400,"False",186,554,291,-263,263,0
"D13JS",346,76,"1200x900",600,1,600,400,"True",647,614,525,-89,89,0
"D13JS",347,158,"1200x900",600,2,600,400,"False",939,300,523,223,223,0
"D13JS",348,238,"1200x900",800,0,600,400,"True",162,283,344,61,61,1
"D13JS",349,178,"1200x900",600,2,600,400,"False",1041,510,347,-163,163,0
"D13JS",350,412,"1200x900",800,2,600,400,"True",842,280,350,70,70,0
"D13JS",351,266,"1200x900",800,0,600,400,"True",126,303,336,33,33,1
"D13JS",352,536,"1200x900",1000,1,600,400,"False",580,213,445,232,232,0
"D13JS",353,132,"1200x900",600,1,600,400,"True",333,185,276,91,91,0
"D13JS",354,273,"1200x900",800,0,600,400,"False",180,309,214,-95,95,1
"D13JS",355,247,"1200x900",800,0,600,400,"False",160,424,261,-163,163,1
"D13JS",356,142,"1200x900",600,1,600,400,"False",286,474,571,97,97,0
"D13JS",357,635,"1200x900",1000,2,600,400,"True",833,402,486,84,84,0
"D13JS",358,520,"1200x900",1000,1,600,400,"False",564,260,364,104,104,0
"D13JS",359,294,"1200x900",800,1,600,400,"False",262,287,360,73,73,0
"D13JS",360,542,"1200x900",1000,1,600,400,"True",304,401,397,-4,4,0
"D13JS",361,503,"1200x900",1000,0,600,400,"False",86,279,189,-90,90,1
"D13JS",362,447,"1200x900",1000,0,600,400,"True",71,339,298,-41,41,1
"D13JS",363,578,"1200x900",1000,2,600,400,"False",966,276,628,352,352,0
"D13JS",364,189,"1200x900",600,2,600,400,"False",881,397,619,222,222,0
"D13JS",365,646,"1200x900",1000,2,600,400,"True",829,227,240,13,13,1
"D13JS",366,299,"1200x900",800,1,600,400,"True",779,274,282,8,8,0
"D13JS",367,588,"1200x900",1000,2,600,400,"False",585,350,457,107,107,0
"D13JS",368,162,"1200x900",600,2,600,400,"False",849,279,440,161,161,0
"D13JS",369,474,"1200x900",1000,0,600,400,"False",85,339,229,-110,110,1
"D13JS",370,522,"1200x900",1000,1,600,400,"False",223,379,470,91,91,0
"D13JS",371,554,"1200x900",1000,1,600,400,"False",79,309,68,-241,241,1
"D13JS",372,479,"1200x900",1000,0,600,400,"False",74,705,453,-252,252,1
"D13JS",373,476,"1200x900",1000,0,600,400,"False",76,359,255,-104,104,1
"D13JS",374,227,"1200x900",800,0,600,400,"False",196,551,381,-170,170,1
"D13JS",376,131,"1200x900",600,1,600,400,"True",531,367,293,-74,74,0
"D13JS",377,395,"1200x900",800,2,600,400,"True",743,334,317,-17,17,0
"D13JS",378,287,"1200x900",800,0,600,400,"False",120,567,425,-142,142,1
"D13JS",379,440,"1200x900",1000,0,600,400,"True",71,237,173,-64,64,1
"D13JS",380,215,"1200x900",600,2,600,400,"False",939,596,255,-341,341,0
"D13JS",381,589,"1200x900",1000,2,600,400,"False",856,418,512,94,94,0
"D13JS",382,254,"1200x900",800,0,600,400,"True",136,583,587,4,4,1
"D13JS",383,231,"1200x900",800,0,600,400,"False",251,718,629,-89,89,1
"D13JS",384,529,"1200x900",1000,1,600,400,"True",267,412,409,-3,3,1
"D13JS",385,228,"1200x900",800,0,600,400,"True",174,687,713,26,26,1
"D13JS",386,399,"1200x900",800,2,600,400,"False",603,602,495,-107,107,0
"D13JS",387,65,"1200x900",600,0,600,400,"True",442,645,685,40,40,1
"D13JS",388,201,"1200x900",600,2,600,400,"False",1005,462,217,-245,245,0
"D13JS",389,530,"1200x900",1000,1,600,400,"False",584,405,264,-141,141,1
"D13JS",390,75,"1200x900",600,1,600,400,"False",635,558,282,-276,276,0
"D13JS",391,410,"1200x900",800,2,600,400,"True",916,477,487,10,10,0
"D13JS",392,114,"1200x900",600,1,600,400,"False",183,697,485,-212,212,0
"D13JS",393,196,"1200x900",600,2,600,400,"True",1030,397,481,84,84,0
"D13JS",396,623,"1200x900",1000,2,600,400,"True",636,527,474,-53,53,0
"D13JS",398,325,"1200x900",800,1,600,400,"False",105,394,510,116,116,0
"D13JS",399,6,"1200x900",600,0,600,400,"False",217,689,619,-70,70,1
"D13JS",400,632,"1200x900",1000,2,600,400,"False",984,227,503,276,276,0
"D13JS",402,305,"1200x900",800,1,600,400,"True",471,716,680,-36,36,0
"D13JS",403,188,"1200x900",600,2,600,400,"False",900,195,668,473,473,0
"D13JS",404,619,"1200x900",1000,2,600,400,"False",803,247,467,220,220,0
"D13JS",405,211,"1200x900",600,2,600,400,"True",986,407,466,59,59,0
"D13JS",406,523,"1200x900",1000,1,600,400,"False",339,318,178,-140,140,0
"D13JS",407,544,"1200x900",1000,1,600,400,"False",602,620,184,-436,436,0
"D13JS",408,66,"1200x900",600,0,600,400,"True",155,673,611,-62,62,0
"D13JS",409,631,"1200x900",1000,2,600,400,"True",699,479,409,-70,70,0
"D13JS",410,101,"1200x900",600,1,600,400,"True",541,656,613,-43,43,0
"D13JS",411,167,"1200x900",600,2,600,400,"False",956,241,537,296,296,0
"D13JS",412,14,"1200x900",600,0,600,400,"True",399,224,233,9,9,1
"D13JS",413,391,"1200x900",800,2,600,400,"True",895,521,575,54,54,0
"D13JS",414,112,"1200x900",600,1,600,400,"True",681,490,573,83,83,0
"D13JS",415,154,"1200x900",600,2,600,400,"False",941,454,575,121,121,0
"D13JS",416,29,"1200x900",600,0,600,400,"True",385,533,559,26,26,1
"D13JS",417,23,"1200x900",600,0,600,400,"True",308,463,497,34,34,1
"D13JS",418,45,"1200x900",600,0,600,400,"False",487,678,607,-71,71,1
"D13JS",419,53,"1200x900",600,0,600,400,"False",177,189,603,414,414,0
"D13JS",420,322,"1200x900",800,1,600,400,"False",703,206,288,82,82,1
"D13JS",421,72,"1200x900",600,0,600,400,"True",158,537,515,-22,22,0
"D13JS",422,468,"1200x900",1000,0,600,400,"False",121,219,367,148,148,1
"D13JS",423,185,"1200x900",600,2,600,400,"False",907,212,370,158,158,0
"D13JS",424,341,"1200x900",800,1,600,400,"False",735,632,554,-78,78,1
"D13JS",425,357,"1200x900",800,1,600,400,"False",109,594,490,-104,104,0
"D13JS",427,71,"1200x900",600,0,600,400,"False",219,248,312,64,64,0
"D13JS",428,371,"1200x900",800,2,600,400,"False",730,560,317,-243,243,0
"D13JS",429,336,"1200x900",800,1,600,400,"False",251,587,330,-257,257,0
"D13JS",430,386,"1200x900",800,2,600,400,"True",774,301,331,30,30,0
"D13JS",431,280,"1200x900",800,0,600,400,"True",104,302,289,-13,13,1
"D13JS",432,210,"1200x900",600,2,600,400,"True",835,506,468,-38,38,0
"D13JS",433,333,"1200x900",800,1,600,400,"False",521,548,653,105,105,0
"D13JS",436,219,"1200x900",800,0,600,400,"True",202,502,566,64,64,1
"D13JS",437,202,"1200x900",600,2,600,400,"True",966,460,491,31,31,0
"D13JS",439,350,"1200x900",800,1,600,400,"True",182,566,565,-1,1,0
"D13JS",440,17,"1200x900",600,0,600,400,"True",402,496,540,44,44,1
"D13JS",441,39,"1200x900",600,0,600,400,"True",210,609,539,-70,70,0
"D13JS",445,128,"1200x900",600,1,600,400,"False",661,258,544,286,286,1
"D13JS",446,385,"1200x900",800,2,600,400,"False",740,456,363,-93,93,0
"D13JS",447,598,"1200x900",1000,2,600,400,"False",706,559,396,-163,163,0
"D13JS",449,135,"1200x900",600,1,600,400,"True",759,569,530,-39,39,0
"D13JS",450,413,"1200x900",800,2,600,400,"True",849,506,506,0,0,0
"D13JS",452,436,"1200x900",1000,0,600,400,"True",82,617,564,-53,53,1
"D13JS",453,571,"1200x900",1000,1,600,400,"True",239,522,443,-79,79,1
"D13JS",454,491,"1200x900",1000,0,600,400,"False",108,198,358,160,160,1
"D13JS",455,277,"1200x900",800,0,600,400,"False",140,310,387,77,77,1
"D13JS",456,556,"1200x900",1000,1,600,400,"False",415,420,649,229,229,0
"D13JS",457,55,"1200x900",600,0,600,400,"True",211,305,371,66,66,1
"D13JS",458,419,"1200x900",800,2,600,400,"True",769,351,398,47,47,0
"D13JS",459,110,"1200x900",600,1,600,400,"False",776,550,668,118,118,1
"D13JS",460,148,"1200x900",600,2,600,400,"False",907,330,430,100,100,0
"D13JS",461,90,"1200x900",600,1,600,400,"False",560,474,421,-53,53,0
"D13JS",462,191,"1200x900",600,2,600,400,"False",962,396,538,142,142,0
"D13JS",463,28,"1200x900",600,0,600,400,"False",336,410,492,82,82,1
"D13JS",464,187,"1200x900",600,2,600,400,"False",857,639,491,-148,148,0
"D13JS",466,618,"1200x900",1000,2,600,400,"False",276,671,493,-178,178,0
"D13JS",467,508,"1200x900",1000,1,600,400,"True",596,485,518,33,33,0
"D13JS",468,538,"1200x900",1000,1,600,400,"True",308,457,402,-55,55,1
"D13JS",469,602,"1200x900",1000,2,600,400,"True",865,452,527,75,75,0
"D13JS",470,263,"1200x900",800,0,600,400,"False",82,396,499,103,103,1
"D13JS",471,19,"1200x900",600,0,600,400,"False",286,686,619,-67,67,0
"D13JS",472,509,"1200x900",1000,1,600,400,"False",509,434,655,221,221,0
"D13JS",473,290,"1200x900",800,1,600,400,"False",789,603,683,80,80,0
"D13JS",474,383,"1200x900",800,2,600,400,"False",855,407,551,144,144,0
"D13JS",475,12,"1200x900",600,0,600,400,"False",365,336,444,108,108,1
"D13JS",476,284,"1200x900",800,0,600,400,"True",135,293,346,53,53,1
"D13JS",477,454,"1200x900",1000,0,600,400,"False",78,687,551,-136,136,1
"D13JS",478,125,"1200x900",600,1,600,400,"False",750,531,669,138,138,0
"D13JS",479,539,"1200x900",1000,1,600,400,"False",510,383,536,153,153,0
"D13JS",480,80,"1200x900",600,1,600,400,"True",616,423,450,27,27,1
"D13JS",481,24,"1200x900",600,0,600,400,"True",430,538,539,1,1,1
"D13JS",482,644,"1200x900",1000,2,600,400,"True",495,486,465,-21,21,0
"D13JS",483,452,"1200x900",1000,0,600,400,"False",97,273,376,103,103,1
"D13JS",484,116,"1200x900",600,1,600,400,"False",767,289,463,174,174,0
"D13JS",485,8,"1200x900",600,0,600,400,"True",156,679,645,-34,34,0
"D13JS",486,22,"1200x900",600,0,600,400,"True",398,591,647,56,56,1
"D13JS",488,192,"1200x900",600,2,600,400,"False",1064,320,646,326,326,0
"D13JS",489,557,"1200x900",1000,1,600,400,"False",677,505,583,78,78,1
"D13JS",490,274,"1200x900",800,0,600,400,"True",146,497,491,-6,6,1
"D13JS",491,27,"1200x900",600,0,600,400,"True",373,309,341,32,32,1
"D13JS",492,437,"1200x900",1000,0,600,400,"False",74,667,538,-129,129,1
"D13JS",493,355,"1200x900",800,1,600,400,"True",77,386,344,-42,42,0
"D13JS",494,535,"1200x900",1000,1,600,400,"False",372,410,255,-155,155,0
"D13JS",495,568,"1200x900",1000,1,600,400,"True",286,475,407,-68,68,1
"D13JS",496,501,"1200x900",1000,0,600,400,"True",96,323,338,15,15,1
"D13JS",497,389,"1200x900",800,2,600,400,"True",843,530,576,46,46,0
"D13JS",498,318,"1200x900",800,1,600,400,"True",788,534,504,-30,30,0
"D13JS",500,241,"1200x900",800,0,600,400,"False",129,227,292,65,65,1
"D13JS",501,511,"1200x900",1000,1,600,400,"False",408,390,485,95,95,1
"D13JS",502,69,"1200x900",600,0,600,400,"True",322,268,278,10,10,0
"D13JS",503,244,"1200x900",800,0,600,400,"False",194,203,281,78,78,1
"D13JS",504,427,"1200x900",800,2,600,400,"True",812,380,409,29,29,0
"D13JS",505,249,"1200x900",800,0,600,400,"True",126,306,324,18,18,1
"D13JS",506,478,"1200x900",1000,0,600,400,"False",79,672,591,-81,81,1
"D13JS",507,569,"1200x900",1000,1,600,400,"False",494,720,588,-132,132,0
"D13JS",508,323,"1200x900",800,1,600,400,"True",388,348,398,50,50,0
"D13JS",509,317,"1200x900",800,1,600,400,"False",185,564,349,-215,215,0
"D13JS",510,455,"1200x900",1000,0,600,400,"False",107,718,642,-76,76,1
"D13JS",511,344,"1200x900",800,1,600,400,"True",589,408,416,8,8,0
"D13JS",512,302,"1200x900",800,1,600,400,"True",479,467,421,-46,46,1
"D13JS",513,223,"1200x900",800,0,600,400,"True",179,191,209,18,18,1
"D13JS",514,638,"1200x900",1000,2,600,400,"True",385,198,216,18,18,0
"D13JS",515,37,"1200x900",600,0,600,400,"True",258,403,421,18,18,1
"D13JS",516,648,"1200x900",1000,2,600,400,"False",557,394,537,143,143,0
"D13JS",517,439,"1200x900",1000,0,600,400,"True",110,229,286,57,57,1
"D13JS",518,233,"1200x900",800,0,600,400,"True",164,700,718,18,18,1
"D13JS",520,195,"1200x900",600,2,600,400,"True",942,249,255,6,6,0
"D13JS",521,405,"1200x900",800,2,600,400,"False",790,307,594,287,287,0
"D13JS",522,106,"1200x900",600,1,600,400,"False",803,659,577,-82,82,1
"D13JS",523,404,"1200x900",800,2,600,400,"False",842,396,687,291,291,0
"D13JS",524,537,"1200x900",1000,1,600,400,"True",621,412,442,30,30,1
"D13JS",525,248,"1200x900",800,0,600,400,"True",94,240,273,33,33,1
"D13JS",526,639,"1200x900",1000,2,600,400,"False",504,456,136,-320,320,0
"D13JS",527,256,"1200x900",800,0,600,400,"True",192,656,589,-67,67,1
"D13JS",528,41,"1200x900",600,0,600,400,"True",370,452,487,35,35,1
"D13JS",529,62,"1200x900",600,0,600,400,"False",345,346,421,75,75,1
"D13JS",530,637,"1200x900",1000,2,600,400,"False",750,460,559,99,99,0
"D13JS",531,252,"1200x900",800,0,600,400,"True",224,673,711,38,38,1
"D13JS",532,316,"1200x900",800,1,600,400,"False",362,319,436,117,117,0
"D13JS",533,40,"1200x900",600,0,600,400,"True",143,513,531,18,18,0
"D13JS",534,469,"1200x900",1000,0,600,400,"True",73,227,274,47,47,1
"D13JS",535,647,"1200x900",1000,2,600,400,"False",560,637,445,-192,192,0
"D13JS",536,313,"1200x900",800,1,600,400,"True",588,421,412,-9,9,0
"D13JS",537,63,"1200x900",600,0,600,400,"True",311,188,226,38,38,1
"D13JS",538,161,"1200x900",600,2,600,400,"False",939,553,627,74,74,0
"D13JS",539,387,"1200x900",800,2,600,400,"False",990,444,317,-127,127,0
"D13JS",540,67,"1200x900",600,0,600,400,"True",289,308,301,-7,7,1
"D13JS",541,168,"1200x900",600,2,600,400,"True",1001,439,405,-34,34,0
"D13JS",542,57,"1200x900",600,0,600,400,"True",354,508,478,-30,30,1
"D13JS",543,553,"1200x900",1000,1,600,400,"False",116,712,598,-114,114,0
"D13JS",544,559,"1200x900",1000,1,600,400,"False",641,244,643,399,399,0
"D13JS",545,375,"1200x900",800,2,600,400,"False",716,384,633,249,249,0
"D13JS",547,492,"1200x900",1000,0,600,400,"True",76,692,651,-41,41,1
"D13JS",548,381,"1200x900",800,2,600,400,"False",705,408,652,244,244,0
"D13JS",549,225,"1200x900",800,0,600,400,"True",178,423,425,2,2,1
"D13JS",550,258,"1200x900",800,0,600,400,"False",126,664,549,-115,115,1
"D13JS",551,326,"1200x900",800,1,600,400,"True",103,482,475,-7,7,0
"D13JS",552,641,"1200x900",1000,2,600,400,"False",897,272,481,209,209,0
"D13JS",555,579,"1200x900",1000,2,600,400,"False",803,394,525,131,131,0
"D13JS",556,296,"1200x900",800,1,600,400,"True",89,279,313,34,34,0
"D13JS",557,182,"1200x900",600,2,600,400,"False",933,389,308,-81,81,0
"D13JS",558,289,"1200x900",800,1,600,400,"False",421,703,465,-238,238,1
"D13JS",559,349,"1200x900",800,1,600,400,"False",402,665,359,-306,306,0
"D13JS",560,83,"1200x900",600,1,600,400,"True",763,568,613,45,45,1
"D13JS",561,398,"1200x900",800,2,600,400,"True",944,698,612,-86,86,0
"D13JS",562,486,"1200x900",1000,0,600,400,"True",102,676,657,-19,19,1
"D13JS",563,585,"1200x900",1000,2,600,400,"False",698,688,755,67,67,1
"D13JS",564,433,"1200x900",1000,0,600,400,"False",76,222,342,120,120,1
"D13JS",565,122,"1200x900",600,1,600,400,"True",817,709,703,-6,6,0
"D13JS",566,448,"1200x900",1000,0,600,400,"True",107,641,704,63,63,1
"D13JS",567,269,"1200x900",800,0,600,400,"True",160,295,358,63,63,1
"D13JS",568,79,"1200x900",600,1,600,400,"True",731,289,243,-46,46,0
"D13JS",569,78,"1200x900",600,1,600,400,"True",885,684,700,16,16,0
"D13JS",570,442,"1200x900",1000,0,600,400,"True",87,183,208,25,25,1
"D13JS",571,32,"1200x900",600,0,600,400,"True",152,563,509,-54,54,1
"D13JS",572,444,"1200x900",1000,0,600,400,"True",101,714,656,-58,58,1
"D13JS",573,207,"1200x900",600,2,600,400,"False",838,235,657,422,422,0
"D13JS",574,339,"1200x900",800,1,600,400,"False",273,545,362,-183,183,1
"D13JS",575,615,"1200x900",1000,2,600,400,"True",736,634,634,0,0,0
"D13JS",576,548,"1200x900",1000,1,600,400,"False",103,278,363,85,85,0
"D13JS",577,25,"1200x900",600,0,600,400,"True",263,403,366,-37,37,1
"D13JS",578,177,"1200x900",600,2,600,400,"True",912,236,299,63,63,0
"D13JS",579,362,"1200x900",800,2,600,400,"False",819,338,556,218,218,0
"D13JS",580,315,"1200x900",800,1,600,400,"False",105,211,351,140,140,0
"D13JS",581,369,"1200x900",800,2,600,400,"False",903,594,660,66,66,0
"D13JS",582,183,"1200x900",600,2,600,400,"False",927,289,499,210,210,0
"D13JS",583,426,"1200x900",800,2,600,400,"True",830,263,312,49,49,0
"D13JS",584,534,"1200x900",1000,1,600,400,"True",328,504,553,49,49,1
"D13JS",585,524,"1200x900",1000,1,600,400,"True",534,470,477,7,7,0
"D13JS",586,34,"1200x900",600,0,600,400,"True",361,242,243,1,1,1
"D13JS",587,144,"1200x900",600,1,600,400,"False",718,371,464,93,93,0
"D13JS",588,351,"1200x900",800,1,600,400,"False",122,581,646,65,65,0
"D13JS",589,181,"1200x900",600,2,600,400,"True",1018,223,179,-44,44,0
"D13JS",590,331,"1200x900",800,1,600,400,"False",240,620,411,-209,209,0
"D13JS",591,251,"1200x900",800,0,600,400,"False",88,352,449,97,97,1
"D13JS",592,449,"1200x900",1000,0,600,400,"True",105,683,643,-40,40,1
"D13JS",593,237,"1200x900",800,0,600,400,"True",204,481,497,16,16,1
"D13JS",594,518,"1200x900",1000,1,600,400,"True",583,717,762,45,45,0
"D13JS",595,500,"1200x900",1000,0,600,400,"True",105,700,723,23,23,1
"D13JS",596,217,"1200x900",800,0,600,400,"True",85,573,633,60,60,1
"D13JS",597,400,"1200x900",800,2,600,400,"True",733,297,314,17,17,0
"D13JS",598,551,"1200x900",1000,1,600,400,"True",146,445,406,-39,39,1
"D13JS",600,505,"1200x900",1000,1,600,400,"False",191,484,623,139,139,1
"D13JS",601,532,"1200x900",1000,1,600,400,"False",215,207,445,238,238,0
"D13JS",602,565,"1200x900",1000,1,600,400,"False",451,562,311,-251,251,0
"D13JS",603,197,"1200x900",600,2,600,400,"False",903,212,539,327,327,0
"D13JS",604,160,"1200x900",600,2,600,400,"True",863,606,640,34,34,0
"D13JS",605,171,"1200x900",600,2,600,400,"False",909,200,632,432,432,0
"D13JS",606,592,"1200x900",1000,2,600,400,"False",492,392,513,121,121,0
"D13JS",607,186,"1200x900",600,2,600,400,"False",997,197,512,315,315,0
"D13JS",608,470,"1200x900",1000,0,600,400,"False",91,666,372,-294,294,1
"D13JS",609,416,"1200x900",800,2,600,400,"False",748,617,374,-243,243,0
"D13JS",610,445,"1200x900",1000,0,600,400,"True",78,302,347,45,45,1
"D13JS",611,430,"1200x900",800,2,600,400,"True",922,254,348,94,94,0
"D13JS",612,98,"1200x900",600,1,600,400,"True",625,530,543,13,13,0
"D13JS",613,443,"1200x900",1000,0,600,400,"False",99,651,575,-76,76,1
"D13JS",614,310,"1200x900",800,1,600,400,"True",559,592,581,-11,11,0
"D13JS",615,100,"1200x900",600,1,600,400,"False",453,511,364,-147,147,0
"D13JS",616,628,"1200x900",1000,2,600,400,"False",768,410,598,188,188,0
"D13JS",617,353,"1200x900",800,1,600,400,"False",90,476,615,139,139,0
"D13JS",618,216,"1200x900",600,2,600,400,"False",1029,286,444,158,158,0
"D13JS",619,136,"1200x900",600,1,600,400,"True",264,205,199,-6,6,0
"D13JS",620,388,"1200x900",800,2,600,400,"True",930,320,250,-70,70,0
"D13JS",621,145,"1200x900",600,2,600,400,"False",1004,630,252,-378,378,0
"D13JS",622,576,"1200x900",1000,1,600,400,"False",376,713,588,-125,125,0
"D13JS",623,521,"1200x900",1000,1,600,400,"False",111,303,587,284,284,1
"D13JS",624,261,"1200x900",800,0,600,400,"True",86,713,691,-22,22,1
"D13JS",625,614,"1200x900",1000,2,600,400,"False",823,563,689,126,126,0
"D13JS",627,347,"1200x900",800,1,600,400,"False",757,295,588,293,293,1
"D13JS",628,408,"1200x900",800,2,600,400,"True",758,567,581,14,14,0
"D13JS",629,504,"1200x900",1000,0,600,400,"True",107,699,652,-47,47,1
"D13JS",630,60,"1200x900",600,0,600,400,"True",365,213,235,22,22,1
"D13JS",631,611,"1200x900",1000,2,600,400,"True",414,511,539,28,28,0
"D13JS",632,423,"1200x900",800,2,600,400,"True",1051,710,655,-55,55,1
"D13JS",634,61,"1200x900",600,0,600,400,"True",272,670,688,18,18,1
"D13JS",635,467,"1200x900",1000,0,600,400,"False",74,712,593,-119,119,1
"D13JS",636,7,"1200x900",600,0,600,400,"True",431,654,655,1,1,1
"D13JS",637,543,"1200x900",1000,1,600,400,"False",88,202,577,375,375,0
"D13JS",638,118,"1200x900",600,1,600,400,"True",190,588,590,2,2,0
"D13JS",639,203,"1200x900",600,2,600,400,"True",938,603,589,-14,14,0
"D13JS",641,246,"1200x900",800,0,600,400,"True",196,418,437,19,19,1
"D13JS",642,230,"1200x900",800,0,600,400,"True",99,678,637,-41,41,1
"D13JS",643,435,"1200x900",1000,0,600,400,"False",119,200,293,93,93,1
"D13JS",644,606,"1200x900",1000,2,600,400,"False",653,627,537,-90,90,0
"D13JS",645,560,"1200x900",1000,1,600,400,"True",516,693,753,60,60,0
"D13JS",646,297,"1200x900",800,1,600,400,"True",625,244,290,46,46,0
"D13JS",647,418,"1200x900",800,2,600,400,"False",754,507,388,-119,119,0
"D13JS",648,64,"1200x900",600,0,600,400,"True",102,339,305,-34,34,0
"D14DL",1,208,"1200x900",600,2,600,400,"False",946,399,513,114,114,0
"D14DL",2,308,"1200x900",800,1,600,400,"True",437,425,408,-17,17,0
"D14DL",3,573,"1200x900",1000,1,600,400,"False",486,615,505,-110,110,0
"D14DL",4,363,"1200x900",800,2,600,400,"False",800,218,449,231,231,0
"D14DL",5,422,"1200x900",800,2,600,400,"True",712,558,553,-5,5,0
"D14DL",6,343,"1200x900",800,1,600,400,"False",407,557,427,-130,130,0
"D14DL",7,99,"1200x900",600,1,600,400,"False",811,407,483,76,76,0
"D14DL",8,552,"1200x900",1000,1,600,400,"True",255,412,337,-75,75,0
"D14DL",9,317,"1200x900",800,1,600,400,"False",185,564,402,-162,162,0
"D14DL",10,248,"1200x900",800,0,600,400,"False",94,240,314,74,74,1
"D14DL",11,535,"1200x900",1000,1,600,400,"True",372,410,414,4,4,0
"D14DL",12,579,"1200x900",1000,2,600,400,"False",803,394,490,96,96,0
"D14DL",13,327,"1200x900",800,1,600,400,"True",152,339,378,39,39,0
"D14DL",14,507,"1200x900",1000,1,600,400,"True",608,583,584,1,1,1
"D14DL",15,624,"1200x900",1000,2,600,400,"False",693,501,409,-92,92,0
"D14DL",16,354,"1200x900",800,1,600,400,"False",118,236,387,151,151,0
"D14DL",17,439,"1200x900",1000,0,600,400,"False",110,229,409,180,180,1
"D14DL",18,385,"1200x900",800,2,600,400,"True",740,456,442,-14,14,0
"D14DL",19,28,"1200x900",600,0,600,400,"True",336,410,399,-11,11,1
"D14DL",20,186,"1200x900",600,2,600,400,"True",997,197,234,37,37,0
"D14DL",21,135,"1200x900",600,1,600,400,"False",759,569,459,-110,110,0
"D14DL",22,347,"1200x900",800,1,600,400,"False",757,295,560,265,265,1
"D14DL",23,86,"1200x900",600,1,600,400,"True",692,388,335,-53,53,1
"D14DL",24,6,"1200x900",600,0,600,400,"True",217,689,699,10,10,1
"D14DL",25,230,"1200x900",800,0,600,400,"True",99,678,671,-7,7,1
"D14DL",26,146,"1200x900",600,2,600,400,"False",989,492,268,-224,224,0
"D14DL",27,359,"1200x900",800,1,600,400,"False",653,241,397,156,156,0
"D14DL",28,332,"1200x900",800,1,600,400,"True",260,699,620,-79,79,0
"D14DL",29,233,"1200x900",800,0,600,400,"True",164,700,706,6,6,1
"D14DL",30,318,"1200x900",800,1,600,400,"False",788,534,719,185,185,0
"D14DL",31,609,"1200x900",1000,2,600,400,"True",697,627,635,8,8,0
"D14DL",32,53,"1200x900",600,0,600,400,"True",177,189,216,27,27,0
"D14DL",33,638,"1200x900",1000,2,600,400,"False",385,198,688,490,490,0
"D14DL",34,538,"1200x900",1000,1,600,400,"True",308,457,398,-59,59,1
"D14DL",35,38,"1200x900",600,0,600,400,"True",120,628,575,-53,53,1
"D14DL",36,640,"1200x900",1000,2,600,400,"False",361,334,568,234,234,0
"D14DL",37,440,"1200x900",1000,0,600,400,"True",71,237,219,-18,18,1
"D14DL",38,88,"1200x900",600,1,600,400,"False",186,554,342,-212,212,0
"D14DL",39,202,"1200x900",600,2,600,400,"False",966,460,584,124,124,0
"D14DL",40,475,"1200x900",1000,0,600,400,"False",101,715,555,-160,160,1
"D14DL",41,213,"1200x900",600,2,600,400,"False",822,275,383,108,108,0
"D14DL",42,314,"1200x900",800,1,600,400,"False",277,616,370,-246,246,1
"D14DL",43,335,"1200x900",800,1,600,400,"True",124,360,327,-33,33,0
"D14DL",44,631,"1200x900",1000,2,600,400,"False",699,479,704,225,225,0
"D14DL",45,279,"1200x900",800,0,600,400,"True",252,202,134,-68,68,1
"D14DL",46,187,"1200x900",600,2,600,400,"False",857,639,484,-155,155,0
"D14DL",47,4,"1200x900",600,0,600,400,"False",602,200,322,122,122,1
"D14DL",48,583,"1200x900",1000,2,600,400,"True",949,284,342,58,58,1
"D14DL",49,607,"1200x900",1000,2,600,400,"False",900,573,691,118,118,1
"D14DL",50,316,"1200x900",800,1,600,400,"True",362,319,325,6,6,0
"D14DL",51,587,"1200x900",1000,2,600,400,"False",741,686,560,-126,126,0
"D14DL",52,80,"1200x900",600,1,600,400,"True",616,423,416,-7,7,1
"D14DL",53,598,"1200x900",1000,2,600,400,"False",706,559,470,-89,89,0
"D14DL",54,211,"1200x900",600,2,600,400,"True",986,407,395,-12,12,0
"D14DL",55,390,"1200x900",800,2,600,400,"False",982,674,559,-115,115,1
"D14DL",56,612,"1200x900",1000,2,600,400,"True",706,198,206,8,8,0
"D14DL",57,365,"1200x900",800,2,600,400,"False",1055,305,399,94,94,0
"D14DL",58,376,"1200x900",800,2,600,400,"False",788,275,504,229,229,0
"D14DL",59,288,"1200x900",800,0,600,400,"True",180,547,607,60,60,1
"D14DL",60,253,"1200x900",800,0,600,400,"True",177,424,462,38,38,1
"D14DL",61,571,"1200x900",1000,1,600,400,"False",239,522,433,-89,89,1
"D14DL",62,172,"1200x900",600,2,600,400,"True",912,444,492,48,48,0
"D14DL",63,277,"1200x900",800,0,600,400,"True",140,310,362,52,52,1
"D14DL",64,613,"1200x900",1000,2,600,400,"True",690,374,357,-17,17,0
"D14DL",65,214,"1200x900",600,2,600,400,"True",1046,305,407,102,102,0
"D14DL",66,89,"1200x900",600,1,600,400,"False",917,366,532,166,166,1
"D14DL",67,497,"1200x900",1000,0,600,400,"False",106,696,560,-136,136,1
"D14DL",68,536,"1200x900",1000,1,600,400,"False",580,213,402,189,189,0
"D14DL",69,33,"1200x900",600,0,600,400,"True",198,533,514,-19,19,1
"D14DL",70,555,"1200x900",1000,1,600,400,"False",444,556,628,72,72,0
"D14DL",71,415,"1200x900",800,2,600,400,"False",823,684,455,-229,229,0
"D14DL",72,152,"1200x900",600,2,600,400,"False",971,399,598,199,199,0
"D14DL",73,147,"1200x900",600,2,600,400,"True",942,418,498,80,80,0
"D14DL",74,85,"1200x900",600,1,600,400,"False",434,347,592,245,245,0
"D14DL",75,446,"1200x900",1000,0,600,400,"False",72,298,391,93,93,1
"D14DL",76,565,"1200x900",1000,1,600,400,"True",451,562,619,57,57,0
"D14DL",77,593,"1200x900",1000,2,600,400,"False",246,719,304,-415,415,0
"D14DL",78,218,"1200x900",800,0,600,400,"True",106,397,418,21,21,1
"D14DL",79,635,"1200x900",1000,2,600,400,"False",833,402,599,197,197,0
"D14DL",80,151,"1200x900",600,2,600,400,"False",828,680,588,-92,92,0
"D14DL",81,615,"1200x900",1000,2,600,400,"True",736,634,617,-17,17,0
"D14DL",82,648,"1200x900",1000,2,600,400,"True",557,394,473,79,79,0
"D14DL",83,162,"1200x900",600,2,600,400,"False",849,279,565,286,286,0
"D14DL",84,353,"1200x900",800,1,600,400,"False",90,476,351,-125,125,0
"D14DL",85,203,"1200x900",600,2,600,400,"False",938,603,664,61,61,0
"D14DL",86,160,"1200x900",600,2,600,400,"True",863,606,569,-37,37,0
"D14DL",87,515,"1200x900",1000,1,600,400,"False",307,217,463,246,246,0
"D14DL",88,78,"1200x900",600,1,600,400,"False",885,684,451,-233,233,0
"D14DL",89,371,"1200x900",800,2,600,400,"False",730,560,661,101,101,0
"D14DL",90,27,"1200x900",600,0,600,400,"True",373,309,295,-14,14,1
"D14DL",91,513,"1200x900",1000,1,600,400,"False",235,602,241,-361,361,0
"D14DL",92,228,"1200x900",800,0,600,400,"True",174,687,659,-28,28,1
"D14DL",93,77,"1200x900",600,1,600,400,"True",780,525,578,53,53,0
"D14DL",94,629,"1200x900",1000,2,600,400,"False",681,257,388,131,131,0
"D14DL",95,391,"1200x900",800,2,600,400,"False",895,521,352,-169,169,0
"D14DL",96,23,"1200x900",600,0,600,400,"True",308,463,514,51,51,1
"D14DL",97,542,"1200x900",1000,1,600,400,"True",304,401,450,49,49,0
"D14DL",98,304,"1200x900",800,1,600,400,"False",667,605,408,-197,197,0
"D14DL",99,102,"1200x900",600,1,600,400,"False",861,603,680,77,77,0
"D14DL",100,161,"1200x900",600,2,600,400,"True",939,553,543,-10,10,0
"D14DL",101,143,"1200x900",600,1,600,400,"True",479,284,313,29,29,1
"D14DL",102,540,"1200x900",1000,1,600,400,"True",389,568,576,8,8,1
"D14DL",103,204,"1200x900",600,2,600,400,"True",1053,432,493,61,61,0
"D14DL",104,625,"1200x900",1000,2,600,400,"False",279,228,532,304,304,0
"D14DL",105,315,"1200x900",800,1,600,400,"True",105,211,230,19,19,0
"D14DL",106,35,"1200x900",600,0,600,400,"True",366,555,583,28,28,1
"D14DL",107,173,"1200x900",600,2,600,400,"True",948,693,608,-85,85,0
"D14DL",108,309,"1200x900",800,1,600,400,"False",186,225,529,304,304,0
"D14DL",109,286,"1200x900",800,0,600,400,"True",105,378,441,63,63,1
"D14DL",110,245,"1200x900",800,0,600,400,"False",296,235,358,123,123,1
"D14DL",111,616,"1200x900",1000,2,600,400,"True",854,357,329,-28,28,1
"D14DL",112,510,"1200x900",1000,1,600,400,"False",486,338,542,204,204,1
"D14DL",113,251,"1200x900",800,0,600,400,"True",88,352,401,49,49,1
"D14DL",114,287,"1200x900",800,0,600,400,"False",120,567,496,-71,71,1
"D14DL",115,19,"1200x900",600,0,600,400,"False",286,686,581,-105,105,0
"D14DL",116,585,"1200x900",1000,2,600,400,"True",698,688,715,27,27,1
"D14DL",117,25,"1200x900",600,0,600,400,"True",263,403,437,34,34,1
"D14DL",118,429,"1200x900",800,2,600,400,"True",682,692,616,-76,76,0
"D14DL",119,643,"1200x900",1000,2,600,400,"False",740,325,564,239,239,0
"D14DL",120,403,"1200x900",800,2,600,400,"False",625,704,517,-187,187,0
"D14DL",121,466,"1200x900",1000,0,600,400,"False",82,205,345,140,140,1
"D14DL",122,67,"1200x900",600,0,600,400,"True",289,308,363,55,55,1
"D14DL",123,360,"1200x900",800,1,600,400,"False",203,608,735,127,127,0
"D14DL",124,576,"1200x900",1000,1,600,400,"False",376,713,519,-194,194,0
"D14DL",125,572,"1200x900",1000,1,600,400,"False",302,260,606,346,346,0
"D14DL",126,344,"1200x900",800,1,600,400,"False",589,408,556,148,148,0
"D14DL",127,426,"1200x900",800,2,600,400,"False",830,263,425,162,162,0
"D14DL",128,120,"1200x900",600,1,600,400,"True",690,655,606,-49,49,0
"D14DL",129,637,"1200x900",1000,2,600,400,"False",750,460,681,221,221,0
"D14DL",130,252,"1200x900",800,0,600,400,"True",224,673,660,-13,13,1
"D14DL",131,107,"1200x900",600,1,600,400,"True",878,678,728,50,50,0
"D14DL",132,222,"1200x900",800,0,600,400,"True",152,206,206,0,0,1
"D14DL",133,545,"1200x900",1000,1,600,400,"False",358,562,440,-122,122,0
"D14DL",134,34,"1200x900",600,0,600,400,"False",361,242,165,-77,77,1
"D14DL",135,235,"1200x900",800,0,600,400,"False",146,646,480,-166,166,1
"D14DL",136,523,"1200x900",1000,1,600,400,"False",339,318,542,224,224,0
"D14DL",137,508,"1200x900",1000,1,600,400,"True",596,485,526,41,41,0
"D14DL",138,383,"1200x900",800,2,600,400,"False",855,407,562,155,155,0
"D14DL",139,337,"1200x900",800,1,600,400,"False",299,622,512,-110,110,0
"D14DL",140,580,"1200x900",1000,2,600,400,"False",651,267,468,201,201,0
"D14DL",141,134,"1200x900",600,1,600,400,"True",300,188,180,-8,8,0
"D14DL",142,58,"1200x900",600,0,600,400,"True",353,655,642,-13,13,1
"D14DL",143,130,"1200x900",600,1,600,400,"True",741,428,438,10,10,0
"D14DL",144,227,"1200x900",800,0,600,400,"True",196,551,589,38,38,1
"D14DL",145,98,"1200x900",600,1,600,400,"False",625,530,658,128,128,0
"D14DL",146,307,"1200x900",800,1,600,400,"False",716,247,480,233,233,0
"D14DL",147,131,"1200x900",600,1,600,400,"False",531,367,458,91,91,0
"D14DL",148,66,"1200x900",600,0,600,400,"False",155,673,570,-103,103,0
"D14DL",149,112,"1200x900",600,1,600,400,"True",681,490,506,16,16,0
"D14DL",150,1,"1200x900",600,0,600,400,"True",136,502,484,-18,18,0
"D14DL",151,268,"1200x900",800,0,600,400,"True",148,400,405,5,5,1
"D14DL",152,336,"1200x900",800,1,600,400,"False",251,587,499,-88,88,0
"D14DL",153,329,"1200x900",800,1,600,400,"False",517,239,455,216,216,0
"D14DL",154,425,"1200x900",800,2,600,400,"True",621,438,463,25,25,0
"D14DL",155,105,"1200x900",600,1,600,400,"True",527,440,395,-45,45,0
"D14DL",156,132,"1200x900",600,1,600,400,"True",333,185,223,38,38,0
"D14DL",157,522,"1200x900",1000,1,600,400,"False",223,379,576,197,197,0
"D14DL",158,10,"1200x900",600,0,600,400,"False",400,499,430,-69,69,1
"D14DL",159,408,"1200x900",800,2,600,400,"False",758,567,698,131,131,0
"D14DL",160,139,"1200x900",600,1,600,400,"False",192,695,610,-85,85,0
"D14DL",161,518,"1200x900",1000,1,600,400,"False",583,717,625,-92,92,0
"D14DL",162,346,"1200x900",800,1,600,400,"True",269,635,665,30,30,0
"D14DL",163,465,"1200x900",1000,0,600,400,"False",85,203,439,236,236,1
"D14DL",164,271,"1200x900",800,0,600,400,"True",74,360,355,-5,5,1
"D14DL",165,470,"1200x900",1000,0,600,400,"False",91,666,537,-129,129,1
"D14DL",166,567,"1200x900",1000,1,600,400,"True",655,297,306,9,9,1
"D14DL",167,487,"1200x900",1000,0,600,400,"True",78,670,606,-64,64,1
"D14DL",168,595,"1200x900",1000,2,600,400,"False",687,640,422,-218,218,0
"D14DL",169,458,"1200x900",1000,0,600,400,"False",78,624,516,-108,108,1
"D14DL",170,171,"1200x900",600,2,600,400,"False",909,200,490,290,290,0
"D14DL",171,175,"1200x900",600,2,600,400,"True",1028,432,402,-30,30,0
"D14DL",172,45,"1200x900",600,0,600,400,"False",487,678,549,-129,129,1
"D14DL",173,642,"1200x900",1000,2,600,400,"False",776,316,651,335,335,0
"D14DL",174,185,"1200x900",600,2,600,400,"False",907,212,450,238,238,0
"D14DL",175,127,"1200x900",600,1,600,400,"False",309,691,572,-119,119,0
"D14DL",176,114,"1200x900",600,1,600,400,"True",183,697,694,-3,3,0
"D14DL",177,141,"1200x900",600,1,600,400,"True",671,582,520,-62,62,0
"D14DL",178,433,"1200x900",1000,0,600,400,"False",76,222,380,158,158,1
"D14DL",179,326,"1200x900",800,1,600,400,"False",103,482,402,-80,80,0
"D14DL",180,478,"1200x900",1000,0,600,400,"False",79,672,440,-232,232,1
"D14DL",181,246,"1200x900",800,0,600,400,"True",196,418,458,40,40,1
"D14DL",182,419,"1200x900",800,2,600,400,"False",769,351,461,110,110,0
"D14DL",183,647,"1200x900",1000,2,600,400,"False",560,637,529,-108,108,0
"D14DL",184,644,"1200x900",1000,2,600,400,"False",495,486,575,89,89,0
"D14DL",185,117,"1200x900",600,1,600,400,"True",711,456,472,16,16,0
"D14DL",186,622,"1200x900",1000,2,600,400,"False",307,683,513,-170,170,0
"D14DL",187,110,"1200x900",600,1,600,400,"True",776,550,595,45,45,1
"D14DL",188,145,"1200x900",600,2,600,400,"True",1004,630,658,28,28,0
"D14DL",189,505,"1200x900",1000,1,600,400,"False",191,484,615,131,131,1
"D14DL",190,413,"1200x900",800,2,600,400,"False",849,506,643,137,137,0
"D14DL",191,244,"1200x900",800,0,600,400,"True",194,203,158,-45,45,1
"D14DL",192,306,"1200x900",800,1,600,400,"False",164,524,593,69,69,0
"D14DL",193,338,"1200x900",800,1,600,400,"False",813,253,440,187,187,1
"D14DL",194,366,"1200x900",800,2,600,400,"False",931,464,378,-86,86,0
"D14DL",195,504,"1200x900",1000,0,600,400,"False",107,699,573,-126,126,1
"D14DL",196,100,"1200x900",600,1,600,400,"True",453,511,484,-27,27,0
"D14DL",197,473,"1200x900",1000,0,600,400,"False",75,323,443,120,120,1
"D14DL",198,495,"1200x900",1000,0,600,400,"False",93,692,609,-83,83,1
"D14DL",199,15,"1200x900",600,0,600,400,"True",473,352,388,36,36,1
"D14DL",200,61,"1200x900",600,0,600,400,"True",272,670,648,-22,22,1
"D14DL",201,296,"1200x900",800,1,600,400,"True",89,279,338,59,59,0
"D14DL",202,484,"1200x900",1000,0,600,400,"True",100,223,275,52,52,1
"D14DL",203,592,"1200x900",1000,2,600,400,"True",492,392,413,21,21,0
"D14DL",204,521,"1200x900",1000,1,600,400,"True",111,303,336,33,33,1
"D14DL",205,402,"1200x900",800,2,600,400,"True",878,234,305,71,71,0
"D14DL",206,21,"1200x900",600,0,600,400,"True",314,383,365,-18,18,1
"D14DL",207,159,"1200x900",600,2,600,400,"True",992,309,340,31,31,0
"D14DL",208,491,"1200x900",1000,0,600,400,"False",108,198,282,84,84,1
"D14DL",209,348,"1200x900",800,1,600,400,"True",764,294,322,28,28,0
"D14DL",210,216,"1200x900",600,2,600,400,"False",1029,286,420,134,134,0
"D14DL",211,325,"1200x900",800,1,600,400,"True",105,394,361,-33,33,0
"D14DL",212,559,"1200x900",1000,1,600,400,"False",641,244,338,94,94,0
"D14DL",213,155,"1200x900",600,2,600,400,"True",940,269,331,62,62,0
"D14DL",214,13,"1200x900",600,0,600,400,"False",296,211,297,86,86,1
"D14DL",215,388,"1200x900",800,2,600,400,"True",930,320,344,24,24,0
"D14DL",216,496,"1200x900",1000,0,600,400,"False",70,639,561,-78,78,1
"D14DL",217,427,"1200x900",800,2,600,400,"False",812,380,566,186,186,0
"D14DL",218,263,"1200x900",800,0,600,400,"True",82,396,384,-12,12,1
"D14DL",219,276,"1200x900",800,0,600,400,"False",281,217,345,128,128,1
"D14DL",220,527,"1200x900",1000,1,600,400,"False",565,601,346,-255,255,0
"D14DL",221,261,"1200x900",800,0,600,400,"True",86,713,731,18,18,1
"D14DL",222,63,"1200x900",600,0,600,400,"True",311,188,200,12,12,1
"D14DL",223,556,"1200x900",1000,1,600,400,"False",415,420,276,-144,144,0
"D14DL",224,597,"1200x900",1000,2,600,400,"True",352,239,278,39,39,0
"D14DL",225,590,"1200x900",1000,2,600,400,"False",636,278,365,87,87,0
"D14DL",226,128,"1200x900",600,1,600,400,"False",661,258,349,91,91,1
"D14DL",227,305,"1200x900",800,1,600,400,"False",471,716,385,-331,331,0
"D14DL",228,300,"1200x900",800,1,600,400,"False",620,693,544,-149,149,0
"D14DL",229,26,"1200x900",600,0,600,400,"True",70,712,675,-37,37,0
"D14DL",230,226,"1200x900",800,0,600,400,"False",187,229,358,129,129,1
"D14DL",231,396,"1200x900",800,2,600,400,"False",678,663,367,-296,296,0
"D14DL",232,239,"1200x900",800,0,600,400,"False",114,231,316,85,85,1
"D14DL",233,198,"1200x900",600,2,600,400,"False",976,500,563,63,63,0
"D14DL",234,17,"1200x900",600,0,600,400,"True",402,496,450,-46,46,1
"D14DL",235,109,"1200x900",600,1,600,400,"True",691,589,640,51,51,0
"D14DL",236,414,"1200x900",800,2,600,400,"True",831,592,585,-7,7,0
"D14DL",237,397,"1200x900",800,2,600,400,"False",817,692,554,-138,138,0
"D14DL",238,196,"1200x900",600,2,600,400,"False",1030,397,518,121,121,0
"D14DL",239,356,"1200x900",800,1,600,400,"True",123,484,437,-47,47,0
"D14DL",240,275,"1200x900",800,0,600,400,"True",120,594,623,29,29,0
"D14DL",241,95,"1200x900",600,1,600,400,"False",749,425,536,111,111,1
"D14DL",242,92,"1200x900",600,1,600,400,"False",624,605,464,-141,141,0
"D14DL",243,375,"1200x900",800,2,600,400,"False",716,384,531,147,147,0
"D14DL",244,548,"1200x900",1000,1,600,400,"False",103,278,361,83,83,0
"D14DL",245,553,"1200x900",1000,1,600,400,"False",116,712,442,-270,270,0
"D14DL",246,623,"1200x900",1000,2,600,400,"True",636,527,558,31,31,0
"D14DL",247,367,"1200x900",800,2,600,400,"False",613,464,374,-90,90,0
"D14DL",248,373,"1200x900",800,2,600,400,"True",694,326,381,55,55,0
"D14DL",249,258,"1200x900",800,0,600,400,"True",126,664,660,-4,4,1
"D14DL",250,434,"1200x900",1000,0,600,400,"False",89,657,527,-130,130,1
"D14DL",251,395,"1200x900",800,2,600,400,"False",743,334,603,269,269,0
"D14DL",252,404,"1200x900",800,2,600,400,"True",842,396,453,57,57,0
"D14DL",253,604,"1200x900",1000,2,600,400,"False",459,593,480,-113,113,0
"D14DL",254,50,"1200x900",600,0,600,400,"True",75,582,552,-30,30,0
"D14DL",255,457,"1200x900",1000,0,600,400,"False",97,630,523,-107,107,1
"D14DL",256,483,"1200x900",1000,0,600,400,"False",93,191,291,100,100,1
"D14DL",257,212,"1200x900",600,2,600,400,"False",841,206,373,167,167,0
"D14DL",258,7,"1200x900",600,0,600,400,"False",431,654,591,-63,63,1
"D14DL",259,443,"1200x900",1000,0,600,400,"False",99,651,550,-101,101,1
"D14DL",260,438,"1200x900",1000,0,600,400,"False",77,713,593,-120,120,1
"D14DL",261,150,"1200x900",600,2,600,400,"False",897,345,526,181,181,0
"D14DL",262,448,"1200x900",1000,0,600,400,"False",107,641,536,-105,105,1
"D14DL",263,39,"1200x900",600,0,600,400,"True",210,609,580,-29,29,0
"D14DL",264,259,"1200x900",800,0,600,400,"False",156,180,339,159,159,1
"D14DL",265,399,"1200x900",800,2,600,400,"False",603,602,330,-272,272,0
"D14DL",266,163,"1200x900",600,2,600,400,"True",1046,665,684,19,19,0
"D14DL",267,301,"1200x900",800,1,600,400,"False",162,574,377,-197,197,0
"D14DL",268,183,"1200x900",600,2,600,400,"False",927,289,501,212,212,0
"D14DL",269,70,"1200x900",600,0,600,400,"True",309,703,683,-20,20,1
"D14DL",270,455,"1200x900",1000,0,600,400,"False",107,718,637,-81,81,1
"D14DL",271,374,"1200x900",800,2,600,400,"False",755,450,573,123,123,0
"D14DL",272,531,"1200x900",1000,1,600,400,"False",233,362,520,158,158,0
"D14DL",273,154,"1200x900",600,2,600,400,"True",941,454,471,17,17,0
"D14DL",274,181,"1200x900",600,2,600,400,"False",1018,223,459,236,236,0
"D14DL",275,191,"1200x900",600,2,600,400,"False",962,396,320,-76,76,0
"D14DL",276,266,"1200x900",800,0,600,400,"True",126,303,354,51,51,1
"D14DL",277,83,"1200x900",600,1,600,400,"False",763,568,703,135,135,1
"D14DL",278,578,"1200x900",1000,2,600,400,"False",966,276,543,267,267,0
"D14DL",279,123,"1200x900",600,1,600,400,"False",761,365,471,106,106,1
"D14DL",280,42,"1200x900",600,0,600,400,"False",233,479,416,-63,63,0
"D14DL",281,594,"1200x900",1000,2,600,400,"False",537,637,384,-253,253,0
"D14DL",282,486,"1200x900",1000,0,600,400,"False",102,676,591,-85,85,1
"D14DL",283,369,"1200x900",800,2,600,400,"True",903,594,550,-44,44,0
"D14DL",284,345,"1200x900",800,1,600,400,"False",841,566,388,-178,178,1
"D14DL",285,193,"1200x900",600,2,600,400,"True",874,588,570,-18,18,0
"D14DL",286,322,"1200x900",800,1,600,400,"False",703,206,544,338,338,1
"D14DL",287,355,"1200x900",800,1,600,400,"True",77,386,389,3,3,0
"D14DL",288,435,"1200x900",1000,0,600,400,"True",119,200,223,23,23,1
"D14DL",289,87,"1200x900",600,1,600,400,"False",231,604,251,-353,353,0
"D14DL",290,267,"1200x900",800,0,600,400,"True",145,665,628,-37,37,1
"D14DL",292,310,"1200x900",800,1,600,400,"False",559,592,492,-100,100,0
"D14DL",293,97,"1200x900",600,1,600,400,"True",760,643,580,-63,63,1
"D14DL",294,462,"1200x900",1000,0,600,400,"False",102,672,534,-138,138,1
"D14DL",295,562,"1200x900",1000,1,600,400,"True",347,540,569,29,29,0
"D14DL",296,158,"1200x900",600,2,600,400,"False",939,300,514,214,214,0
"D14DL",297,195,"1200x900",600,2,600,400,"False",942,249,516,267,267,0
"D14DL",298,242,"1200x900",800,0,600,400,"True",117,448,482,34,34,1
"D14DL",299,610,"1200x900",1000,2,600,400,"False",702,293,475,182,182,0
"D14DL",300,479,"1200x900",1000,0,600,400,"False",74,705,546,-159,159,1
"D14DL",301,225,"1200x900",800,0,600,400,"True",178,423,410,-13,13,1
"D14DL",302,618,"1200x900",1000,2,600,400,"False",276,671,491,-180,180,0
"D14DL",303,68,"1200x900",600,0,600,400,"True",165,367,420,53,53,0
"D14DL",304,379,"1200x900",800,2,600,400,"False",994,325,488,163,163,0
"D14DL",305,617,"1200x900",1000,2,600,400,"False",294,180,509,329,329,0
"D14DL",306,566,"1200x900",1000,1,600,400,"False",378,472,397,-75,75,1
"D14DL",307,201,"1200x900",600,2,600,400,"False",1005,462,384,-78,78,0
"D14DL",308,179,"1200x900",600,2,600,400,"False",908,602,501,-101,101,0
"D14DL",309,96,"1200x900",600,1,600,400,"False",433,458,523,65,65,0
"D14DL",310,321,"1200x900",800,1,600,400,"False",601,190,438,248,248,0
"D14DL",311,525,"1200x900",1000,1,600,400,"False",123,690,528,-162,162,0
"D14DL",312,178,"1200x900",600,2,600,400,"False",1041,510,599,89,89,0
"D14DL",313,368,"1200x900",800,2,600,400,"True",778,515,510,-5,5,0
"D14DL",314,492,"1200x900",1000,0,600,400,"False",76,692,474,-218,218,1
"D14DL",315,311,"1200x900",800,1,600,400,"False",710,261,425,164,164,0
"D14DL",316,372,"1200x900",800,2,600,400,"False",833,620,411,-209,209,0
"D14DL",317,199,"1200x900",600,2,600,400,"True",992,467,516,49,49,0
"D14DL",318,62,"1200x900",600,0,600,400,"True",345,346,388,42,42,1
"D14DL",319,41,"1200x900",600,0,600,400,"True",370,452,446,-6,6,1
"D14DL",320,382,"1200x900",800,2,600,400,"False",870,523,434,-89,89,0
"D14DL",321,468,"1200x900",1000,0,600,400,"False",121,219,377,158,158,1
"D14DL",322,421,"1200x900",800,2,600,400,"True",898,394,438,44,44,0
"D14DL",323,60,"1200x900",600,0,600,400,"True",365,213,251,38,38,1
"D14DL",324,40,"1200x900",600,0,600,400,"True",143,513,529,16,16,0
"D14DL",325,299,"1200x900",800,1,600,400,"False",779,274,487,213,213,0
"D14DL",326,111,"1200x900",600,1,600,400,"True",922,552,587,35,35,1
"D14DL",327,384,"1200x900",800,2,600,400,"False",821,707,478,-229,229,0
"D14DL",328,257,"1200x900",800,0,600,400,"False",97,219,289,70,70,1
"D14DL",329,453,"1200x900",1000,0,600,400,"False",71,393,581,188,188,1
"D14DL",330,537,"1200x900",1000,1,600,400,"False",621,412,512,100,100,1
"D14DL",331,215,"1200x900",600,2,600,400,"True",939,596,553,-43,43,0
"D14DL",332,104,"1200x900",600,1,600,400,"True",448,584,501,-83,83,0
"D14DL",333,51,"1200x900",600,0,600,400,"True",272,181,211,30,30,1
"D14DL",334,169,"1200x900",600,2,600,400,"True",924,290,246,-44,44,0
"D14DL",335,436,"1200x900",1000,0,600,400,"False",82,617,474,-143,143,1
"D14DL",336,564,"1200x900",1000,1,600,400,"False",215,264,414,150,150,0
"D14DL",337,166,"1200x900",600,2,600,400,"False",896,274,523,249,249,0
"D14DL",338,400,"1200x900",800,2,600,400,"True",733,297,355,58,58,0
"D14DL",339,469,"1200x900",1000,0,600,400,"False",73,227,344,117,117,1
"D14DL",340,546,"1200x900",1000,1,600,400,"True",305,374,366,-8,8,0
"D14DL",341,568,"1200x900",1000,1,600,400,"True",286,475,416,-59,59,1
"D14DL",342,544,"1200x900",1000,1,600,400,"False",602,620,499,-121,121,0
"D14DL",343,539,"1200x900",1000,1,600,400,"False",510,383,477,94,94,0
"D14DL",344,57,"1200x900",600,0,600,400,"True",354,508,499,-9,9,1
"D14DL",345,84,"1200x900",600,1,600,400,"False",144,184,498,314,314,0
"D14DL",346,626,"1200x900",1000,2,600,400,"True",329,449,520,71,71,0
"D14DL",348,420,"1200x900",800,2,600,400,"False",519,223,514,291,291,0
"D14DL",349,533,"1200x900",1000,1,600,400,"True",355,483,531,48,48,0
"D14DL",350,323,"1200x900",800,1,600,400,"False",388,348,422,74,74,0
"D14DL",351,409,"1200x900",800,2,600,400,"False",501,659,418,-241,241,0
"D14DL",352,534,"1200x900",1000,1,600,400,"True",328,504,506,2,2,1
"D14DL",353,588,"1200x900",1000,2,600,400,"True",585,350,411,61,61,0
"D14DL",354,380,"1200x900",800,2,600,400,"False",942,228,470,242,242,0
"D14DL",355,291,"1200x900",800,1,600,400,"False",522,694,616,-78,78,0
"D14DL",356,532,"1200x900",1000,1,600,400,"False",215,207,533,326,326,0
"D14DL",357,324,"1200x900",800,1,600,400,"True",719,712,670,-42,42,1
"D14DL",358,639,"1200x900",1000,2,600,400,"False",504,456,133,-323,323,0
"D14DL",359,467,"1200x900",1000,0,600,400,"False",74,712,606,-106,106,1
"D14DL",360,591,"1200x900",1000,2,600,400,"False",698,336,625,289,289,0
"D14DL",361,364,"1200x900",800,2,600,400,"False",1018,204,484,280,280,0
"D14DL",362,634,"1200x900",1000,2,600,400,"False",735,313,202,-111,111,0
"D14DL",363,630,"1200x900",1000,2,600,400,"False",754,559,279,-280,280,0
"D14DL",364,381,"1200x900",800,2,600,400,"True",705,408,430,22,22,0
"D14DL",366,333,"1200x900",800,1,600,400,"True",521,548,601,53,53,0
"D14DL",367,456,"1200x900",1000,0,600,400,"False",91,257,347,90,90,1
"D14DL",368,633,"1200x900",1000,2,600,400,"True",564,253,212,-41,41,0
"D14DL",369,370,"1200x900",800,2,600,400,"True",874,336,424,88,88,0
"D14DL",370,223,"1200x900",800,0,600,400,"True",179,191,173,-18,18,1
"D14DL",371,405,"1200x900",800,2,600,400,"True",790,307,262,-45,45,0
"D14DL",372,20,"1200x900",600,0,600,400,"True",204,545,531,-14,14,1
"D14DL",373,357,"1200x900",800,1,600,400,"False",109,594,408,-186,186,0
"D14DL",374,611,"1200x900",1000,2,600,400,"True",414,511,486,-25,25,0
"D14DL",375,137,"1200x900",600,1,600,400,"True",789,577,560,-17,17,0
"D14DL",376,240,"1200x900",800,0,600,400,"True",330,656,596,-60,60,1
"D14DL",377,270,"1200x900",800,0,600,400,"True",192,418,412,-6,6,1
"D14DL",378,511,"1200x900",1000,1,600,400,"False",408,390,501,111,111,1
"D14DL",379,153,"1200x900",600,2,600,400,"False",1037,601,363,-238,238,0
"D14DL",380,601,"1200x900",1000,2,600,400,"False",735,697,618,-79,79,0
"D14DL",381,599,"1200x900",1000,2,600,400,"False",316,570,284,-286,286,0
"D14DL",382,281,"1200x900",800,0,600,400,"False",112,611,541,-70,70,1
"D14DL",383,519,"1200x900",1000,1,600,400,"True",319,565,560,-5,5,1
"D14DL",384,432,"1200x900",800,2,600,400,"False",792,380,571,191,191,0
"D14DL",385,221,"1200x900",800,0,600,400,"False",132,520,405,-115,115,1
"D14DL",386,294,"1200x900",800,1,600,400,"False",262,287,346,59,59,0
"D14DL",387,302,"1200x900",800,1,600,400,"False",479,467,319,-148,148,1
"D14DL",388,116,"1200x900",600,1,600,400,"False",767,289,408,119,119,0
"D14DL",389,24,"1200x900",600,0,600,400,"False",430,538,421,-117,117,1
"D14DL",390,560,"1200x900",1000,1,600,400,"False",516,693,603,-90,90,0
"D14DL",391,180,"1200x900",600,2,600,400,"False",929,270,530,260,260,0
"D14DL",392,12,"1200x900",600,0,600,400,"True",365,336,358,22,22,1
"D14DL",393,55,"1200x900",600,0,600,400,"True",211,305,317,12,12,1
"D14DL",394,170,"1200x900",600,2,600,400,"False",996,468,320,-148,148,0
"D14DL",395,156,"1200x900",600,2,600,400,"False",913,197,382,185,185,0
"D14DL",396,217,"1200x900",800,0,600,400,"False",85,573,435,-138,138,1
"D14DL",397,126,"1200x900",600,1,600,400,"False",849,354,538,184,184,0
"D14DL",398,121,"1200x900",600,1,600,400,"True",884,364,395,31,31,0
"D14DL",399,313,"1200x900",800,1,600,400,"True",588,421,355,-66,66,0
"D14DL",400,330,"1200x900",800,1,600,400,"False",759,301,235,-66,66,1
"D14DL",401,581,"1200x900",1000,2,600,400,"False",310,357,654,297,297,0
"D14DL",402,31,"1200x900",600,0,600,400,"True",365,338,347,9,9,1
"D14DL",403,423,"1200x900",800,2,600,400,"False",1051,710,584,-126,126,1
"D14DL",404,90,"1200x900",600,1,600,400,"True",560,474,532,58,58,0
"D14DL",405,464,"1200x900",1000,0,600,400,"False",82,222,299,77,77,1
"D14DL",406,430,"1200x900",800,2,600,400,"False",922,254,370,116,116,0
"D14DL",407,237,"1200x900",800,0,600,400,"True",204,481,518,37,37,1
"D14DL",408,149,"1200x900",600,2,600,400,"False",890,289,404,115,115,0
"D14DL",409,528,"1200x900",1000,1,600,400,"False",839,227,414,187,187,1
"D14DL",410,501,"1200x900",1000,0,600,400,"True",96,323,301,-22,22,1
"D14DL",411,295,"1200x900",800,1,600,400,"False",471,334,436,102,102,0
"D14DL",412,101,"1200x900",600,1,600,400,"False",541,656,388,-268,268,0
"D14DL",413,549,"1200x900",1000,1,600,400,"True",657,366,427,61,61,0
"D14DL",414,182,"1200x900",600,2,600,400,"True",933,389,437,48,48,0
"D14DL",415,444,"1200x900",1000,0,600,400,"False",101,714,515,-199,199,1
"D14DL",416,103,"1200x900",600,1,600,400,"False",528,320,477,157,157,1
"D14DL",417,392,"1200x900",800,2,600,400,"True",1031,618,624,6,6,0
"D14DL",418,627,"1200x900",1000,2,600,400,"False",760,510,359,-151,151,0
"D14DL",419,463,"1200x900",1000,0,600,400,"False",115,693,513,-180,180,1
"D14DL",420,608,"1200x900",1000,2,600,400,"False",742,250,563,313,313,0
"D14DL",421,197,"1200x900",600,2,600,400,"False",903,212,459,247,247,0
"D14DL",422,297,"1200x900",800,1,600,400,"False",625,244,347,103,103,0
"D14DL",424,342,"1200x900",800,1,600,400,"False",677,204,357,153,153,0
"D14DL",425,46,"1200x900",600,0,600,400,"True",193,355,343,-12,12,1
"D14DL",426,516,"1200x900",1000,1,600,400,"True",440,559,570,11,11,0
"D14DL",427,351,"1200x900",800,1,600,400,"False",122,581,482,-99,99,0
"D14DL",428,401,"1200x900",800,2,600,400,"True",821,260,299,39,39,0
"D14DL",429,454,"1200x900",1000,0,600,400,"False",78,687,779,92,92,1
"D14DL",430,269,"1200x900",800,0,600,400,"True",160,295,353,58,58,1
"D14DL",431,262,"1200x900",800,0,600,400,"False",196,481,392,-89,89,1
"D14DL",432,554,"1200x900",1000,1,600,400,"False",79,309,181,-128,128,1
"D14DL",433,339,"1200x900",800,1,600,400,"False",273,545,300,-245,245,1
"D14DL",434,206,"1200x900",600,2,600,400,"True",975,223,301,78,78,0
"D14DL",436,3,"1200x900",600,0,600,400,"True",298,443,493,50,50,1
"D14DL",437,441,"1200x900",1000,0,600,400,"False",85,684,540,-144,144,1
"D14DL",438,506,"1200x900",1000,1,600,400,"True",559,567,524,-43,43,1
"D14DL",439,398,"1200x900",800,2,600,400,"False",944,698,535,-163,163,0
"D14DL",440,144,"1200x900",600,1,600,400,"False",718,371,450,79,79,0
"D14DL",441,284,"1200x900",800,0,600,400,"True",135,293,356,63,63,1
"D14DL",442,499,"1200x900",1000,0,600,400,"False",93,271,348,77,77,1
"D14DL",443,167,"1200x900",600,2,600,400,"False",956,241,364,123,123,0
"D14DL",444,148,"1200x900",600,2,600,400,"True",907,330,331,1,1,0
"D14DL",445,349,"1200x900",800,1,600,400,"False",402,665,475,-190,190,0
"D14DL",446,447,"1200x900",1000,0,600,400,"False",71,339,502,163,163,1
"D14DL",447,190,"1200x900",600,2,600,400,"False",977,238,410,172,172,0
"D14DL",448,520,"1200x900",1000,1,600,400,"True",564,260,296,36,36,0
"D14DL",449,570,"1200x900",1000,1,600,400,"False",315,352,446,94,94,0
"D14DL",450,641,"1200x900",1000,2,600,400,"False",897,272,399,127,127,0
"D14DL",452,52,"1200x900",600,0,600,400,"True",171,188,251,63,63,0
"D14DL",453,72,"1200x900",600,0,600,400,"True",158,537,500,-37,37,0
"D14DL",454,192,"1200x900",600,2,600,400,"False",1064,320,476,156,156,0
"D14DL",455,334,"1200x900",800,1,600,400,"True",481,665,689,24,24,0
"D14DL",456,69,"1200x900",600,0,600,400,"False",322,268,154,-114,114,0
"D14DL",457,231,"1200x900",800,0,600,400,"True",251,718,701,-17,17,1
"D14DL",458,142,"1200x900",600,1,600,400,"True",286,474,436,-38,38,0
"D14DL",459,620,"1200x900",1000,2,600,400,"False",832,649,421,-228,228,0
"D14DL",460,220,"1200x900",800,0,600,400,"True",108,699,633,-66,66,1
"D14DL",461,406,"1200x900",800,2,600,400,"False",971,233,610,377,377,0
"D14DL",462,272,"1200x900",800,0,600,400,"True",200,181,102,-79,79,1
"D14DL",463,619,"1200x900",1000,2,600,400,"False",803,247,490,243,243,0
"D14DL",464,194,"1200x900",600,2,600,400,"False",896,236,371,135,135,0
"D14DL",465,254,"1200x900",800,0,600,400,"False",136,583,502,-81,81,1
"D14DL",466,59,"1200x900",600,0,600,400,"True",391,692,683,-9,9,1
"D14DL",467,418,"1200x900",800,2,600,400,"True",754,507,532,25,25,0
"D14DL",468,9,"1200x900",600,0,600,400,"True",509,654,655,1,1,1
"D14DL",469,188,"1200x900",600,2,600,400,"False",900,195,520,325,325,0
"D14DL",470,219,"1200x900",800,0,600,400,"False",202,502,619,117,117,1
"D14DL",471,303,"1200x900",800,1,600,400,"True",241,431,402,-29,29,0
"D14DL",472,509,"1200x900",1000,1,600,400,"False",509,434,527,93,93,0
"D14DL",473,176,"1200x900",600,2,600,400,"False",1033,281,409,128,128,0
"D14DL",474,14,"1200x900",600,0,600,400,"True",399,224,250,26,26,1
"D14DL",475,632,"1200x900",1000,2,600,400,"False",984,227,337,110,110,0
"D14DL",476,177,"1200x900",600,2,600,400,"False",912,236,353,117,117,0
"D14DL",477,407,"1200x900",800,2,600,400,"True",989,340,303,-37,37,0
"D14DL",478,621,"1200x900",1000,2,600,400,"True",540,478,437,-41,41,0
"D14DL",479,451,"1200x900",1000,0,600,400,"False",110,702,590,-112,112,1
"D14DL",480,476,"1200x900",1000,0,600,400,"False",76,359,526,167,167,1
"D14DL",481,292,"1200x900",800,1,600,400,"False",88,565,446,-119,119,0
"D14DL",482,18,"1200x900",600,0,600,400,"True",400,318,360,42,42,1
"D14DL",483,482,"1200x900",1000,0,600,400,"False",79,686,524,-162,162,1
"D14DL",484,65,"1200x900",600,0,600,400,"True",442,645,657,12,12,1
"D14DL",485,586,"1200x900",1000,2,600,400,"False",802,262,586,324,324,0
"D14DL",486,431,"1200x900",800,2,600,400,"True",694,382,344,-38,38,0
"D14DL",487,575,"1200x900",1000,1,600,400,"False",272,693,399,-294,294,0
"D14DL",488,74,"1200x900",600,1,600,400,"True",115,358,457,99,99,0
"D14DL",489,471,"1200x900",1000,0,600,400,"False",122,200,343,143,143,1
"D14DL",490,424,"1200x900",800,2,600,400,"True",903,545,520,-25,25,0
"D14DL",491,36,"1200x900",600,0,600,400,"True",128,346,339,-7,7,1
"D14DL",492,574,"1200x900",1000,1,600,400,"False",614,194,374,180,180,0
"D14DL",493,157,"1200x900",600,2,600,400,"False",1016,323,425,102,102,0
"D14DL",494,589,"1200x900",1000,2,600,400,"False",856,418,513,95,95,0
"D14DL",495,502,"1200x900",1000,0,600,400,"False",111,639,537,-102,102,1
"D14DL",496,298,"1200x900",800,1,600,400,"True",311,457,457,0,0,0
"D14DL",497,283,"1200x900",800,0,600,400,"True",90,264,264,0,0,1
"D14DL",498,526,"1200x900",1000,1,600,400,"False",497,710,832,122,122,0
"D14DL",499,16,"1200x900",600,0,600,400,"False",297,514,582,68,68,1
"D14DL",500,241,"1200x900",800,0,600,400,"True",129,227,295,68,68,1
"D14DL",501,485,"1200x900",1000,0,600,400,"False",121,694,538,-156,156,1
"D14DL",502,312,"1200x900",800,1,600,400,"True",238,683,603,-80,80,0
"D14DL",503,274,"1200x900",800,0,600,400,"True",146,497,438,-59,59,1
"D14DL",504,493,"1200x900",1000,0,600,400,"False",80,582,426,-156,156,1
"D14DL",505,445,"1200x900",1000,0,600,400,"True",78,302,293,-9,9,1
"D14DL",506,543,"1200x900",1000,1,600,400,"False",88,202,527,325,325,0
"D14DL",507,264,"1200x900",800,0,600,400,"False",198,660,783,123,123,1
"D14DL",508,5,"1200x900",600,0,600,400,"True",228,587,543,-44,44,0
"D14DL",509,133,"1200x900",600,1,600,400,"True",345,551,540,-11,11,0
"D14DL",510,44,"1200x900",600,0,600,400,"False",305,554,480,-74,74,1
"D14DL",511,449,"1200x900",1000,0,600,400,"False",105,683,477,-206,206,1
"D14DL",512,200,"1200x900",600,2,600,400,"False",897,302,504,202,202,0
"D14DL",513,234,"1200x900",800,0,600,400,"True",72,344,321,-23,23,1
"D14DL",514,22,"1200x900",600,0,600,400,"True",398,591,560,-31,31,1
"D14DL",515,256,"1200x900",800,0,600,400,"True",192,656,706,50,50,1
"D14DL",516,489,"1200x900",1000,0,600,400,"False",88,604,530,-74,74,1
"D14DL",517,247,"1200x900",800,0,600,400,"True",160,424,428,4,4,1
"D14DL",518,550,"1200x900",1000,1,600,400,"False",301,459,572,113,113,0
"D14DL",519,29,"1200x900",600,0,600,400,"True",385,533,518,-15,15,1
"D14DL",520,428,"1200x900",800,2,600,400,"False",732,665,324,-341,341,0
"D14DL",521,125,"1200x900",600,1,600,400,"True",750,531,502,-29,29,0
"D14DL",522,75,"1200x900",600,1,600,400,"True",635,558,518,-40,40,0
"D14DL",523,480,"1200x900",1000,0,600,400,"True",100,231,220,-11,11,1
"D14DL",524,320,"1200x900",800,1,600,400,"True",644,376,341,-35,35,0
"D14DL",525,645,"1200x900",1000,2,600,400,"True",619,396,355,-41,41,0
"D14DL",526,450,"1200x900",1000,0,600,400,"False",130,204,277,73,73,1
"D14DL",527,341,"1200x900",800,1,600,400,"False",735,632,536,-96,96,1
"D14DL",528,168,"1200x900",600,2,600,400,"False",1001,439,331,-108,108,0
"D14DL",529,472,"1200x900",1000,0,600,400,"False",77,685,527,-158,158,1
"D14DL",530,94,"1200x900",600,1,600,400,"False",729,482,569,87,87,0
"D14DL",531,393,"1200x900",800,2,600,400,"False",657,620,393,-227,227,0
"D14DL",532,82,"1200x900",600,1,600,400,"False",108,213,432,219,219,0
"D14DL",533,118,"1200x900",600,1,600,400,"False",190,588,396,-192,192,0
"D14DL",534,232,"1200x900",800,0,600,400,"False",84,511,437,-74,74,1
"D14DL",535,331,"1200x900",800,1,600,400,"False",240,620,503,-117,117,0
"D14DL",536,255,"1200x900",800,0,600,400,"False",93,709,602,-107,107,1
"D14DL",537,416,"1200x900",800,2,600,400,"True",748,617,600,-17,17,0
"D14DL",538,488,"1200x900",1000,0,600,400,"False",129,687,528,-159,159,1
"D14DL",539,119,"1200x900",600,1,600,400,"False",168,563,390,-173,173,0
"D14DL",540,32,"1200x900",600,0,600,400,"True",152,563,626,63,63,1
"D14DL",541,64,"1200x900",600,0,600,400,"True",102,339,354,15,15,0
"D14DL",542,558,"1200x900",1000,1,600,400,"False",72,464,594,130,130,1
"D14DL",543,460,"1200x900",1000,0,600,400,"True",155,189,216,27,27,1
"D14DL",544,636,"1200x900",1000,2,600,400,"False",575,583,291,-292,292,0
"D14DL",545,628,"1200x900",1000,2,600,400,"True",768,410,436,26,26,0
"D14DL",546,236,"1200x900",800,0,600,400,"False",162,350,280,-70,70,1
"D14DL",547,557,"1200x900",1000,1,600,400,"False",677,505,789,284,284,1
"D14DL",548,541,"1200x900",1000,1,600,400,"True",339,478,489,11,11,0
"D14DL",549,106,"1200x900",600,1,600,400,"True",803,659,677,18,18,1
"D14DL",550,138,"1200x900",600,1,600,400,"False",844,580,472,-108,108,1
"D14DL",551,352,"1200x900",800,1,600,400,"True",235,717,650,-67,67,0
"D14DL",552,210,"1200x900",600,2,600,400,"False",835,506,566,60,60,0
"D14DL",553,514,"1200x900",1000,1,600,400,"False",539,690,552,-138,138,0
"D14DL",554,224,"1200x900",800,0,600,400,"False",161,474,545,71,71,1
"D14DL",555,530,"1200x900",1000,1,600,400,"True",584,405,356,-49,49,1
"D14DL",556,529,"1200x900",1000,1,600,400,"False",267,412,291,-121,121,1
"D14DL",557,340,"1200x900",800,1,600,400,"False",226,240,422,182,182,0
"D14DL",558,265,"1200x900",800,0,600,400,"True",229,353,386,33,33,1
"D14DL",559,410,"1200x900",800,2,600,400,"False",916,477,369,-108,108,0
"D14DL",560,37,"1200x900",600,0,600,400,"True",258,403,396,-7,7,1
"D14DL",561,30,"1200x900",600,0,600,400,"True",107,353,376,23,23,0
"D14DL",562,577,"1200x900",1000,2,600,400,"True",455,420,421,1,1,0
"D14DL",563,361,"1200x900",800,2,600,400,"False",931,328,446,118,118,0
"D14DL",564,184,"1200x900",600,2,600,400,"True",1067,441,485,44,44,0
"D14DL",565,76,"1200x900",600,1,600,400,"False",647,614,506,-108,108,0
"D14DL",566,547,"1200x900",1000,1,600,400,"False",369,384,541,157,157,1
"D14DL",567,378,"1200x900",800,2,600,400,"False",1018,708,493,-215,215,0
"D14DL",568,73,"1200x900",600,1,600,400,"False",94,665,517,-148,148,0
"D14DL",569,54,"1200x900",600,0,600,400,"False",474,564,495,-69,69,1
"D14DL",570,603,"1200x900",1000,2,600,400,"False",693,280,503,223,223,0
"D14DL",571,93,"1200x900",600,1,600,400,"False",139,540,403,-137,137,0
"D14DL",572,377,"1200x900",800,2,600,400,"False",683,388,479,91,91,0
"D14DL",573,437,"1200x900",1000,0,600,400,"False",74,667,597,-70,70,1
"D14DL",574,350,"1200x900",800,1,600,400,"True",182,566,563,-3,3,0
"D14DL",575,386,"1200x900",800,2,600,400,"False",774,301,550,249,249,0
"D14DL",576,646,"1200x900",1000,2,600,400,"True",829,227,275,48,48,1
"D14DL",577,165,"1200x900",600,2,600,400,"False",912,554,284,-270,270,0
"D14DL",578,71,"1200x900",600,0,600,400,"True",219,248,304,56,56,0
"D14DL",579,477,"1200x900",1000,0,600,400,"True",88,640,638,-2,2,1
"D14DL",580,79,"1200x900",600,1,600,400,"True",731,289,309,20,20,0
"D14DL",581,605,"1200x900",1000,2,600,400,"True",493,665,665,0,0,0
"D14DL",582,362,"1200x900",800,2,600,400,"False",819,338,508,170,170,0
"D14DL",583,238,"1200x900",800,0,600,400,"True",162,283,329,46,46,1
"D14DL",584,517,"1200x900",1000,1,600,400,"False",548,182,416,234,234,0
"D14DL",585,113,"1200x900",600,1,600,400,"False",897,657,443,-214,214,0
"D14DL",586,442,"1200x900",1000,0,600,400,"True",87,183,211,28,28,1
"D14DL",587,249,"1200x900",800,0,600,400,"True",126,306,310,4,4,1
"D14DL",588,582,"1200x900",1000,2,600,400,"False",554,347,551,204,204,0
"D14DL",589,494,"1200x900",1000,0,600,400,"True",127,692,715,23,23,1
"D14DL",590,2,"1200x900",600,0,600,400,"False",159,323,201,-122,122,0
"D14DL",591,503,"1200x900",1000,0,600,400,"True",86,279,319,40,40,1
"D14DL",592,91,"1200x900",600,1,600,400,"False",417,630,323,-307,307,1
"D14DL",593,48,"1200x900",600,0,600,400,"True",323,645,597,-48,48,1
"D14DL",594,394,"1200x900",800,2,600,400,"False",847,292,363,71,71,0
"D14DL",595,47,"1200x900",600,0,600,400,"False",303,499,412,-87,87,1
"D14DL",596,600,"1200x900",1000,2,600,400,"False",765,207,417,210,210,0
"D14DL",598,606,"1200x900",1000,2,600,400,"False",653,627,467,-160,160,0
"D14DL",599,124,"1200x900",600,1,600,400,"True",345,467,514,47,47,0
"D14DL",600,260,"1200x900",800,0,600,400,"False",103,525,602,77,77,1
"D14DL",601,417,"1200x900",800,2,600,400,"False",750,280,357,77,77,0
"D14DL",602,278,"1200x900",800,0,600,400,"True",251,711,676,-35,35,1
"D14DL",603,8,"1200x900",600,0,600,400,"True",156,679,683,4,4,0
"D14DL",604,189,"1200x900",600,2,600,400,"False",881,397,576,179,179,0
"D14DL",605,461,"1200x900",1000,0,600,400,"False",95,711,573,-138,138,1
"D14DL",606,289,"1200x900",800,1,600,400,"False",421,703,767,64,64,1
"D14DL",607,319,"1200x900",800,1,600,400,"False",494,587,762,175,175,1
"D14DL",608,561,"1200x900",1000,1,600,400,"True",231,406,479,73,73,0
"D14DL",609,474,"1200x900",1000,0,600,400,"True",85,339,376,37,37,1
"D14DL",610,569,"1200x900",1000,1,600,400,"False",494,720,409,-311,311,0
"D14DL",611,285,"1200x900",800,0,600,400,"False",237,396,499,103,103,1
"D14DL",612,459,"1200x900",1000,0,600,400,"False",70,645,555,-90,90,1
"D14DL",613,115,"1200x900",600,1,600,400,"False",545,307,516,209,209,0
"D14DL",614,512,"1200x900",1000,1,600,400,"False",139,261,349,88,88,0
"D14DL",615,205,"1200x900",600,2,600,400,"False",1021,504,372,-132,132,0
"D14DL",616,498,"1200x900",1000,0,600,400,"True",100,260,301,41,41,1
"D14DL",617,282,"1200x900",800,0,600,400,"True",109,246,284,38,38,1
"D14DL",618,596,"1200x900",1000,2,600,400,"False",706,513,349,-164,164,0
"D14DL",619,490,"1200x900",1000,0,600,400,"False",114,183,365,182,182,1
"D14DL",620,209,"1200x900",600,2,600,400,"False",937,637,352,-285,285,0
"D14DL",621,207,"1200x900",600,2,600,400,"False",838,235,504,269,269,0
"D14DL",622,122,"1200x900",600,1,600,400,"False",817,709,539,-170,170,0
"D14DL",623,108,"1200x900",600,1,600,400,"True",830,239,272,33,33,0
"D14DL",624,164,"1200x900",600,2,600,400,"False",1051,268,195,-73,73,0
"D14DL",625,584,"1200x900",1000,2,600,400,"False",731,413,517,104,104,0
"D14DL",626,81,"1200x900",600,1,600,400,"False",696,225,317,92,92,0
"D14DL",627,273,"1200x900",800,0,600,400,"True",180,309,291,-18,18,1
"D14DL",628,129,"1200x900",600,1,600,400,"False",859,482,392,-90,90,1
"D14DL",629,293,"1200x900",800,1,600,400,"True",561,396,437,41,41,0
"D14DL",630,563,"1200x900",1000,1,600,400,"False",201,696,369,-327,327,0
"D14DL",631,614,"1200x900",1000,2,600,400,"False",823,563,433,-130,130,0
"D14DL",632,250,"1200x900",800,0,600,400,"False",290,248,356,108,108,1
"D14DL",633,452,"1200x900",1000,0,600,400,"True",97,273,323,50,50,1
"D14DL",634,280,"1200x900",800,0,600,400,"True",104,302,314,12,12,1
"D14DL",635,56,"1200x900",600,0,600,400,"True",148,491,426,-65,65,0
"D14DL",636,411,"1200x900",800,2,600,400,"False",805,361,446,85,85,0
"D14DL",637,602,"1200x900",1000,2,600,400,"True",865,452,429,-23,23,0
"D14DL",638,290,"1200x900",800,1,600,400,"False",789,603,414,-189,189,0
"D14DL",639,481,"1200x900",1000,0,600,400,"False",80,185,265,80,80,1
"D14DL",640,229,"1200x900",800,0,600,400,"True",117,697,696,-1,1,1
"D14DL",641,389,"1200x900",800,2,600,400,"True",843,530,505,-25,25,0
"D14DL",642,136,"1200x900",600,1,600,400,"False",264,205,389,184,184,0
"D14DL",643,524,"1200x900",1000,1,600,400,"True",534,470,513,43,43,0
"D14DL",644,11,"1200x900",600,0,600,400,"True",372,670,609,-61,61,1
"D14DL",645,500,"1200x900",1000,0,600,400,"False",105,700,585,-115,115,1
"D14DL",646,43,"1200x900",600,0,600,400,"False",277,446,593,147,147,1
"D14DL",647,551,"1200x900",1000,1,600,400,"True",146,445,490,45,45,1
"D14DL",648,49,"1200x900",600,0,600,400,"True",109,380,439,59,59,0
"D15DC",1,14,"1200x900",600,0,600,400,"False",399,224,339,115,115,1
"D15DC",2,521,"1200x900",1000,1,600,400,"True",111,303,324,21,21,1
"D15DC",3,193,"1200x900",600,2,600,400,"False",874,588,442,-146,146,0
"D15DC",4,9,"1200x900",600,0,600,400,"True",509,654,670,16,16,1
"D15DC",5,580,"1200x900",1000,2,600,400,"False",651,267,611,344,344,0
"D15DC",6,339,"1200x900",800,1,600,400,"False",273,545,295,-250,250,1
"D15DC",7,156,"1200x900",600,2,600,400,"False",913,197,522,325,325,0
"D15DC",8,439,"1200x900",1000,0,600,400,"False",110,229,364,135,135,1
"D15DC",9,485,"1200x900",1000,0,600,400,"False",121,694,290,-404,404,1
"D15DC",10,313,"1200x900",800,1,600,400,"False",588,421,517,96,96,0
"D15DC",11,57,"1200x900",600,0,600,400,"True",354,508,534,26,26,1
"D15DC",12,105,"1200x900",600,1,600,400,"True",527,440,472,32,32,0
"D15DC",13,75,"1200x900",600,1,600,400,"True",635,558,531,-27,27,0
"D15DC",14,634,"1200x900",1000,2,600,400,"True",735,313,356,43,43,0
"D15DC",15,584,"1200x900",1000,2,600,400,"True",731,413,413,0,0,0
"D15DC",16,488,"1200x900",1000,0,600,400,"False",129,687,553,-134,134,1
"D15DC",17,170,"1200x900",600,2,600,400,"False",996,468,354,-114,114,0
"D15DC",18,647,"1200x900",1000,2,600,400,"False",560,637,541,-96,96,0
"D15DC",19,77,"1200x900",600,1,600,400,"True",780,525,548,23,23,0
"D15DC",20,542,"1200x900",1000,1,600,400,"True",304,401,478,77,77,0
"D15DC",21,111,"1200x900",600,1,600,400,"False",922,552,447,-105,105,1
"D15DC",22,419,"1200x900",800,2,600,400,"True",769,351,430,79,79,0
"D15DC",23,431,"1200x900",800,2,600,400,"True",694,382,436,54,54,0
"D15DC",24,287,"1200x900",800,0,600,400,"False",120,567,437,-130,130,1
"D15DC",25,15,"1200x900",600,0,600,400,"False",473,352,439,87,87,1
"D15DC",26,358,"1200x900",800,1,600,400,"False",263,635,440,-195,195,0
"D15DC",27,462,"1200x900",1000,0,600,400,"False",102,672,606,-66,66,1
"D15DC",28,274,"1200x900",800,0,600,400,"False",146,497,612,115,115,1
"D15DC",29,309,"1200x900",800,1,600,400,"False",186,225,616,391,391,0
"D15DC",30,395,"1200x900",800,2,600,400,"False",743,334,553,219,219,0
"D15DC",31,256,"1200x900",800,0,600,400,"False",192,656,560,-96,96,1
"D15DC",32,44,"1200x900",600,0,600,400,"False",305,554,631,77,77,1
"D15DC",33,151,"1200x900",600,2,600,400,"True",828,680,611,-69,69,0
"D15DC",34,229,"1200x900",800,0,600,400,"False",117,697,469,-228,228,1
"D15DC",35,355,"1200x900",800,1,600,400,"True",77,386,415,29,29,0
"D15DC",36,150,"1200x900",600,2,600,400,"False",897,345,534,189,189,0
"D15DC",37,90,"1200x900",600,1,600,400,"True",560,474,450,-24,24,0
"D15DC",38,633,"1200x900",1000,2,600,400,"False",564,253,415,162,162,0
"D15DC",39,609,"1200x900",1000,2,600,400,"False",697,627,333,-294,294,0
"D15DC",40,275,"1200x900",800,0,600,400,"False",120,594,425,-169,169,0
"D15DC",41,283,"1200x900",800,0,600,400,"False",90,264,388,124,124,1
"D15DC",42,114,"1200x900",600,1,600,400,"False",183,697,420,-277,277,0
"D15DC",43,349,"1200x900",800,1,600,400,"False",402,665,384,-281,281,0
"D15DC",44,539,"1200x900",1000,1,600,400,"True",510,383,385,2,2,0
"D15DC",45,197,"1200x900",600,2,600,400,"False",903,212,388,176,176,0
"D15DC",46,138,"1200x900",600,1,600,400,"False",844,580,383,-197,197,1
"D15DC",47,273,"1200x900",800,0,600,400,"True",180,309,312,3,3,1
"D15DC",48,598,"1200x900",1000,2,600,400,"True",706,559,543,-16,16,0
"D15DC",49,433,"1200x900",1000,0,600,400,"False",76,222,331,109,109,1
"D15DC",50,94,"1200x900",600,1,600,400,"False",729,482,354,-128,128,0
"D15DC",51,303,"1200x900",800,1,600,400,"False",241,431,597,166,166,0
"D15DC",52,546,"1200x900",1000,1,600,400,"False",305,374,515,141,141,0
"D15DC",53,482,"1200x900",1000,0,600,400,"True",79,686,680,-6,6,1
"D15DC",54,179,"1200x900",600,2,600,400,"True",908,602,657,55,55,0
"D15DC",55,83,"1200x900",600,1,600,400,"False",763,568,437,-131,131,1
"D15DC",56,168,"1200x900",600,2,600,400,"True",1001,439,519,80,80,0
"D15DC",57,178,"1200x900",600,2,600,400,"False",1041,510,603,93,93,0
"D15DC",58,493,"1200x900",1000,0,600,400,"True",80,582,625,43,43,1
"D15DC",59,541,"1200x900",1000,1,600,400,"False",339,478,611,133,133,0
"D15DC",60,203,"1200x900",600,2,600,400,"False",938,603,506,-97,97,0
"D15DC",61,384,"1200x900",800,2,600,400,"False",821,707,581,-126,126,0
"D15DC",63,264,"1200x900",800,0,600,400,"True",198,660,671,11,11,1
"D15DC",64,119,"1200x900",600,1,600,400,"False",168,563,638,75,75,0
"D15DC",65,307,"1200x900",800,1,600,400,"False",716,247,604,357,357,0
"D15DC",66,281,"1200x900",800,0,600,400,"True",112,611,655,44,44,1
"D15DC",67,270,"1200x900",800,0,600,400,"True",192,418,466,48,48,1
"D15DC",68,21,"1200x900",600,0,600,400,"True",314,383,389,6,6,1
"D15DC",69,334,"1200x900",800,1,600,400,"False",481,665,393,-272,272,0
"D15DC",70,474,"1200x900",1000,0,600,400,"False",85,339,460,121,121,1
"D15DC",71,393,"1200x900",800,2,600,400,"False",657,620,523,-97,97,0
"D15DC",72,383,"1200x900",800,2,600,400,"False",855,407,534,127,127,0
"D15DC",73,335,"1200x900",800,1,600,400,"True",124,360,418,58,58,0
"D15DC",74,302,"1200x900",800,1,600,400,"True",479,467,416,-51,51,1
"D15DC",75,330,"1200x900",800,1,600,400,"False",759,301,411,110,110,1
"D15DC",76,424,"1200x900",800,2,600,400,"False",903,545,404,-141,141,0
"D15DC",77,72,"1200x900",600,0,600,400,"True",158,537,510,-27,27,0
"D15DC",78,324,"1200x900",800,1,600,400,"False",719,712,514,-198,198,1
"D15DC",79,390,"1200x900",800,2,600,400,"True",982,674,569,-105,105,1
"D15DC",80,154,"1200x900",600,2,600,400,"False",941,454,570,116,116,0
"D15DC",81,368,"1200x900",800,2,600,400,"True",778,515,487,-28,28,0
"D15DC",82,258,"1200x900",800,0,600,400,"True",126,664,658,-6,6,1
"D15DC",83,285,"1200x900",800,0,600,400,"True",237,396,429,33,33,1
"D15DC",84,66,"1200x900",600,0,600,400,"True",155,673,635,-38,38,0
"D15DC",85,308,"1200x900",800,1,600,400,"False",437,425,553,128,128,0
"D15DC",86,577,"1200x900",1000,2,600,400,"False",455,420,528,108,108,0
"D15DC",87,380,"1200x900",800,2,600,400,"False",942,228,573,345,345,0
"D15DC",88,50,"1200x900",600,0,600,400,"True",75,582,651,69,69,0
"D15DC",89,172,"1200x900",600,2,600,400,"False",912,444,635,191,191,0
"D15DC",90,177,"1200x900",600,2,600,400,"False",912,236,512,276,276,0
"D15DC",91,69,"1200x900",600,0,600,400,"False",322,268,372,104,104,0
"D15DC",92,611,"1200x900",1000,2,600,400,"True",414,511,544,33,33,0
"D15DC",93,512,"1200x900",1000,1,600,400,"False",139,261,450,189,189,0
"D15DC",94,149,"1200x900",600,2,600,400,"False",890,289,395,106,106,0
"D15DC",95,298,"1200x900",800,1,600,400,"True",311,457,528,71,71,0
"D15DC",96,524,"1200x900",1000,1,600,400,"True",534,470,395,-75,75,0
"D15DC",97,405,"1200x900",800,2,600,400,"False",790,307,414,107,107,0
"D15DC",98,137,"1200x900",600,1,600,400,"True",789,577,546,-31,31,0
"D15DC",99,259,"1200x900",800,0,600,400,"False",156,180,287,107,107,1
"D15DC",100,402,"1200x900",800,2,600,400,"True",878,234,315,81,81,0
"D15DC",101,173,"1200x900",600,2,600,400,"False",948,693,258,-435,435,0
"D15DC",102,585,"1200x900",1000,2,600,400,"False",698,688,476,-212,212,1
"D15DC",103,425,"1200x900",800,2,600,400,"True",621,438,502,64,64,0
"D15DC",104,547,"1200x900",1000,1,600,400,"False",369,384,501,117,117,1
"D15DC",105,132,"1200x900",600,1,600,400,"True",333,185,144,-41,41,0
"D15DC",106,246,"1200x900",800,0,600,400,"False",196,418,506,88,88,1
"D15DC",107,536,"1200x900",1000,1,600,400,"False",580,213,484,271,271,0
"D15DC",108,347,"1200x900",800,1,600,400,"False",757,295,630,335,335,1
"D15DC",109,318,"1200x900",800,1,600,400,"False",788,534,377,-157,157,0
"D15DC",110,492,"1200x900",1000,0,600,400,"False",76,692,604,-88,88,1
"D15DC",111,297,"1200x900",800,1,600,400,"False",625,244,565,321,321,0
"D15DC",112,51,"1200x900",600,0,600,400,"False",272,181,279,98,98,1
"D15DC",113,29,"1200x900",600,0,600,400,"True",385,533,571,38,38,1
"D15DC",114,139,"1200x900",600,1,600,400,"False",192,695,542,-153,153,0
"D15DC",115,279,"1200x900",800,0,600,400,"False",252,202,322,120,120,1
"D15DC",116,583,"1200x900",1000,2,600,400,"False",949,284,419,135,135,1
"D15DC",117,223,"1200x900",800,0,600,400,"False",179,191,318,127,127,1
"D15DC",119,343,"1200x900",800,1,600,400,"True",407,557,503,-54,54,0
"D15DC",120,345,"1200x900",800,1,600,400,"False",841,566,373,-193,193,1
"D15DC",121,158,"1200x900",600,2,600,400,"False",939,300,406,106,106,0
"D15DC",122,639,"1200x900",1000,2,600,400,"True",504,456,408,-48,48,0
"D15DC",123,58,"1200x900",600,0,600,400,"False",353,655,571,-84,84,1
"D15DC",124,587,"1200x900",1000,2,600,400,"False",741,686,585,-101,101,0
"D15DC",125,325,"1200x900",800,1,600,400,"False",105,394,583,189,189,0
"D15DC",126,403,"1200x900",800,2,600,400,"False",625,704,560,-144,144,0
"D15DC",127,91,"1200x900",600,1,600,400,"False",417,630,412,-218,218,1
"D15DC",128,555,"1200x900",1000,1,600,400,"True",444,556,483,-73,73,0
"D15DC",129,157,"1200x900",600,2,600,400,"False",1016,323,435,112,112,0
"D15DC",130,531,"1200x900",1000,1,600,400,"False",233,362,555,193,193,0
"D15DC",131,280,"1200x900",800,0,600,400,"False",104,302,369,67,67,1
"D15DC",132,400,"1200x900",800,2,600,400,"False",733,297,461,164,164,0
"D15DC",133,422,"1200x900",800,2,600,400,"False",712,558,238,-320,320,0
"D15DC",134,423,"1200x900",800,2,600,400,"True",1051,710,696,-14,14,1
"D15DC",135,648,"1200x900",1000,2,600,400,"False",557,394,705,311,311,0
"D15DC",136,311,"1200x900",800,1,600,400,"False",710,261,694,433,433,0
"D15DC",137,466,"1200x900",1000,0,600,400,"True",82,205,244,39,39,1
"D15DC",138,510,"1200x900",1000,1,600,400,"True",486,338,394,56,56,1
"D15DC",139,622,"1200x900",1000,2,600,400,"False",307,683,365,-318,318,0
"D15DC",140,266,"1200x900",800,0,600,400,"False",126,303,367,64,64,1
"D15DC",141,644,"1200x900",1000,2,600,400,"False",495,486,285,-201,201,0
"D15DC",142,588,"1200x900",1000,2,600,400,"True",585,350,431,81,81,0
"D15DC",143,133,"1200x900",600,1,600,400,"False",345,551,613,62,62,0
"D15DC",144,103,"1200x900",600,1,600,400,"True",528,320,314,-6,6,1
"D15DC",145,117,"1200x900",600,1,600,400,"False",711,456,353,-103,103,0
"D15DC",146,571,"1200x900",1000,1,600,400,"True",239,522,538,16,16,1
"D15DC",147,408,"1200x900",800,2,600,400,"False",758,567,465,-102,102,0
"D15DC",148,63,"1200x900",600,0,600,400,"True",311,188,230,42,42,1
"D15DC",149,430,"1200x900",800,2,600,400,"False",922,254,372,118,118,0
"D15DC",150,84,"1200x900",600,1,600,400,"False",144,184,113,-71,71,0
"D15DC",151,144,"1200x900",600,1,600,400,"True",718,371,360,-11,11,0
"D15DC",152,456,"1200x900",1000,0,600,400,"True",91,257,279,22,22,1
"D15DC",153,320,"1200x900",800,1,600,400,"True",644,376,368,-8,8,0
"D15DC",154,253,"1200x900",800,0,600,400,"True",177,424,351,-73,73,1
"D15DC",155,572,"1200x900",1000,1,600,400,"True",302,260,223,-37,37,0
"D15DC",156,278,"1200x900",800,0,600,400,"True",251,711,648,-63,63,1
"D15DC",157,321,"1200x900",800,1,600,400,"False",601,190,523,333,333,0
"D15DC",158,337,"1200x900",800,1,600,400,"True",299,622,566,-56,56,0
"D15DC",159,344,"1200x900",800,1,600,400,"False",589,408,568,160,160,0
"D15DC",160,233,"1200x900",800,0,600,400,"True",164,700,665,-35,35,1
"D15DC",161,365,"1200x900",800,2,600,400,"False",1055,305,537,232,232,0
"D15DC",162,228,"1200x900",800,0,600,400,"True",174,687,655,-32,32,1
"D15DC",163,375,"1200x900",800,2,600,400,"True",716,384,360,-24,24,0
"D15DC",164,398,"1200x900",800,2,600,400,"False",944,698,483,-215,215,0
"D15DC",165,459,"1200x900",1000,0,600,400,"False",70,645,378,-267,267,1
"D15DC",166,420,"1200x900",800,2,600,400,"False",519,223,595,372,372,0
"D15DC",167,25,"1200x900",600,0,600,400,"True",263,403,397,-6,6,1
"D15DC",168,18,"1200x900",600,0,600,400,"True",400,318,325,7,7,1
"D15DC",169,13,"1200x900",600,0,600,400,"False",296,211,346,135,135,1
"D15DC",170,143,"1200x900",600,1,600,400,"False",479,284,452,168,168,1
"D15DC",171,34,"1200x900",600,0,600,400,"True",361,242,274,32,32,1
"D15DC",172,438,"1200x900",1000,0,600,400,"False",77,713,546,-167,167,1
"D15DC",173,497,"1200x900",1000,0,600,400,"True",106,696,652,-44,44,1
"D15DC",174,590,"1200x900",1000,2,600,400,"False",636,278,474,196,196,0
"D15DC",175,629,"1200x900",1000,2,600,400,"False",681,257,377,120,120,0
"D15DC",176,247,"1200x900",800,0,600,400,"True",160,424,400,-24,24,1
"D15DC",177,148,"1200x900",600,2,600,400,"True",907,330,401,71,71,0
"D15DC",178,496,"1200x900",1000,0,600,400,"False",70,639,552,-87,87,1
"D15DC",179,407,"1200x900",800,2,600,400,"True",989,340,364,24,24,0
"D15DC",180,40,"1200x900",600,0,600,400,"True",143,513,485,-28,28,0
"D15DC",181,643,"1200x900",1000,2,600,400,"True",740,325,407,82,82,0
"D15DC",182,357,"1200x900",800,1,600,400,"False",109,594,457,-137,137,0
"D15DC",183,484,"1200x900",1000,0,600,400,"False",100,223,358,135,135,1
"D15DC",184,364,"1200x900",800,2,600,400,"False",1018,204,628,424,424,0
"D15DC",185,257,"1200x900",800,0,600,400,"True",97,219,260,41,41,1
"D15DC",186,33,"1200x900",600,0,600,400,"True",198,533,475,-58,58,1
"D15DC",187,401,"1200x900",800,2,600,400,"False",821,260,515,255,255,0
"D15DC",188,238,"1200x900",800,0,600,400,"True",162,283,281,-2,2,1
"D15DC",189,575,"1200x900",1000,1,600,400,"False",272,693,306,-387,387,0
"D15DC",190,129,"1200x900",600,1,600,400,"True",859,482,452,-30,30,1
"D15DC",191,635,"1200x900",1000,2,600,400,"True",833,402,353,-49,49,0
"D15DC",192,552,"1200x900",1000,1,600,400,"True",255,412,396,-16,16,0
"D15DC",193,338,"1200x900",800,1,600,400,"False",813,253,493,240,240,1
"D15DC",194,142,"1200x900",600,1,600,400,"False",286,474,318,-156,156,0
"D15DC",195,545,"1200x900",1000,1,600,400,"True",358,562,571,9,9,0
"D15DC",196,442,"1200x900",1000,0,600,400,"False",87,183,298,115,115,1
"D15DC",197,74,"1200x900",600,1,600,400,"True",115,358,390,32,32,0
"D15DC",198,607,"1200x900",1000,2,600,400,"True",900,573,595,22,22,1
"D15DC",199,261,"1200x900",800,0,600,400,"False",86,713,586,-127,127,1
"D15DC",200,626,"1200x900",1000,2,600,400,"False",329,449,323,-126,126,0
"D15DC",201,444,"1200x900",1000,0,600,400,"False",101,714,604,-110,110,1
"D15DC",202,73,"1200x900",600,1,600,400,"True",94,665,583,-82,82,0
"D15DC",203,465,"1200x900",1000,0,600,400,"False",85,203,322,119,119,1
"D15DC",204,176,"1200x900",600,2,600,400,"False",1033,281,410,129,129,0
"D15DC",205,509,"1200x900",1000,1,600,400,"True",509,434,377,-57,57,0
"D15DC",206,473,"1200x900",1000,0,600,400,"True",75,323,343,20,20,1
"D15DC",207,263,"1200x900",800,0,600,400,"True",82,396,375,-21,21,1
"D15DC",208,109,"1200x900",600,1,600,400,"True",691,589,526,-63,63,0
"D15DC",209,134,"1200x900",600,1,600,400,"False",300,188,372,184,184,0
"D15DC",210,162,"1200x900",600,2,600,400,"False",849,279,371,92,92,0
"D15DC",211,480,"1200x900",1000,0,600,400,"True",100,231,288,57,57,1
"D15DC",212,300,"1200x900",800,1,600,400,"False",620,693,347,-346,346,0
"D15DC",213,292,"1200x900",800,1,600,400,"True",88,565,517,-48,48,0
"D15DC",214,140,"1200x900",600,1,600,400,"False",700,523,439,-84,84,0
"D15DC",215,569,"1200x900",1000,1,600,400,"False",494,720,381,-339,339,0
"D15DC",216,476,"1200x900",1000,0,600,400,"True",76,359,318,-41,41,1
"D15DC",217,513,"1200x900",1000,1,600,400,"False",235,602,415,-187,187,0
"D15DC",218,500,"1200x900",1000,0,600,400,"False",105,700,408,-292,292,1
"D15DC",219,92,"1200x900",600,1,600,400,"False",624,605,447,-158,158,0
"D15DC",220,102,"1200x900",600,1,600,400,"False",861,603,537,-66,66,0
"D15DC",221,468,"1200x900",1000,0,600,400,"False",121,219,327,108,108,1
"D15DC",222,136,"1200x900",600,1,600,400,"True",264,205,254,49,49,0
"D15DC",223,418,"1200x900",800,2,600,400,"False",754,507,256,-251,251,0
"D15DC",224,628,"1200x900",1000,2,600,400,"False",768,410,344,-66,66,0
"D15DC",225,612,"1200x900",1000,2,600,400,"False",706,198,465,267,267,0
"D15DC",226,196,"1200x900",600,2,600,400,"False",1030,397,296,-101,101,0
"D15DC",227,199,"1200x900",600,2,600,400,"False",992,467,322,-145,145,0
"D15DC",228,323,"1200x900",800,1,600,400,"False",388,348,487,139,139,0
"D15DC",229,6,"1200x900",600,0,600,400,"True",217,689,638,-51,51,1
"D15DC",230,511,"1200x900",1000,1,600,400,"False",408,390,637,247,247,1
"D15DC",231,250,"1200x900",800,0,600,400,"False",290,248,386,138,138,1
"D15DC",232,378,"1200x900",800,2,600,400,"False",1018,708,387,-321,321,0
"D15DC",233,276,"1200x900",800,0,600,400,"True",281,217,226,9,9,1
"D15DC",234,81,"1200x900",600,1,600,400,"True",696,225,231,6,6,0
"D15DC",235,329,"1200x900",800,1,600,400,"False",517,239,473,234,234,0
"D15DC",236,517,"1200x900",1000,1,600,400,"False",548,182,452,270,270,0
"D15DC",237,625,"1200x900",1000,2,600,400,"False",279,228,613,385,385,0
"D15DC",238,503,"1200x900",1000,0,600,400,"True",86,279,267,-12,12,1
"D15DC",239,391,"1200x900",800,2,600,400,"False",895,521,443,-78,78,0
"D15DC",240,54,"1200x900",600,0,600,400,"True",474,564,606,42,42,1
"D15DC",241,550,"1200x900",1000,1,600,400,"True",301,459,417,-42,42,0
"D15DC",242,389,"1200x900",800,2,600,400,"True",843,530,536,6,6,0
"D15DC",243,498,"1200x900",1000,0,600,400,"False",100,260,364,104,104,1
"D15DC",244,526,"1200x900",1000,1,600,400,"False",497,710,505,-205,205,0
"D15DC",245,322,"1200x900",800,1,600,400,"False",703,206,294,88,88,1
"D15DC",246,605,"1200x900",1000,2,600,400,"False",493,665,532,-133,133,0
"D15DC",247,174,"1200x900",600,2,600,400,"True",998,457,418,-39,39,0
"D15DC",248,553,"1200x900",1000,1,600,400,"False",116,712,331,-381,381,0
"D15DC",249,245,"1200x900",800,0,600,400,"False",296,235,301,66,66,1
"D15DC",250,336,"1200x900",800,1,600,400,"False",251,587,428,-159,159,0
"D15DC",251,499,"1200x900",1000,0,600,400,"True",93,271,327,56,56,1
"D15DC",252,467,"1200x900",1000,0,600,400,"True",74,712,684,-28,28,1
"D15DC",253,582,"1200x900",1000,2,600,400,"False",554,347,636,289,289,0
"D15DC",254,98,"1200x900",600,1,600,400,"True",625,530,495,-35,35,0
"D15DC",255,595,"1200x900",1000,2,600,400,"False",687,640,539,-101,101,0
"D15DC",256,130,"1200x900",600,1,600,400,"False",741,428,354,-74,74,0
"D15DC",257,55,"1200x900",600,0,600,400,"True",211,305,363,58,58,1
"D15DC",258,351,"1200x900",800,1,600,400,"False",122,581,250,-331,331,0
"D15DC",259,367,"1200x900",800,2,600,400,"True",613,464,499,35,35,0
"D15DC",260,616,"1200x900",1000,2,600,400,"True",854,357,342,-15,15,1
"D15DC",261,506,"1200x900",1000,1,600,400,"False",559,567,469,-98,98,1
"D15DC",262,88,"1200x900",600,1,600,400,"False",186,554,355,-199,199,0
"D15DC",264,161,"1200x900",600,2,600,400,"False",939,553,652,99,99,0
"D15DC",265,152,"1200x900",600,2,600,400,"False",971,399,540,141,141,0
"D15DC",266,216,"1200x900",600,2,600,400,"False",1029,286,427,141,141,0
"D15DC",267,236,"1200x900",800,0,600,400,"False",162,350,523,173,173,1
"D15DC",268,483,"1200x900",1000,0,600,400,"False",93,191,307,116,116,1
"D15DC",269,416,"1200x900",800,2,600,400,"False",748,617,314,-303,303,0
"D15DC",270,110,"1200x900",600,1,600,400,"False",776,550,449,-101,101,1
"D15DC",271,333,"1200x900",800,1,600,400,"True",521,548,576,28,28,0
"D15DC",272,566,"1200x900",1000,1,600,400,"False",378,472,383,-89,89,1
"D15DC",273,254,"1200x900",800,0,600,400,"True",136,583,550,-33,33,1
"D15DC",274,627,"1200x900",1000,2,600,400,"False",760,510,354,-156,156,0
"D15DC",275,558,"1200x900",1000,1,600,400,"False",72,464,639,175,175,1
"D15DC",276,304,"1200x900",800,1,600,400,"True",667,605,640,35,35,0
"D15DC",277,163,"1200x900",600,2,600,400,"False",1046,665,520,-145,145,0
"D15DC",278,374,"1200x900",800,2,600,400,"False",755,450,524,74,74,0
"D15DC",279,362,"1200x900",800,2,600,400,"False",819,338,468,130,130,0
"D15DC",280,187,"1200x900",600,2,600,400,"False",857,639,367,-272,272,0
"D15DC",281,538,"1200x900",1000,1,600,400,"True",308,457,400,-57,57,1
"D15DC",282,262,"1200x900",800,0,600,400,"True",196,481,480,-1,1,1
"D15DC",283,640,"1200x900",1000,2,600,400,"False",361,334,537,203,203,0
"D15DC",284,319,"1200x900",800,1,600,400,"False",494,587,376,-211,211,1
"D15DC",285,412,"1200x900",800,2,600,400,"False",842,280,384,104,104,0
"D15DC",286,171,"1200x900",600,2,600,400,"False",909,200,460,260,260,0
"D15DC",287,125,"1200x900",600,1,600,400,"True",750,531,466,-65,65,0
"D15DC",288,82,"1200x900",600,1,600,400,"False",108,213,604,391,391,0
"D15DC",289,326,"1200x900",800,1,600,400,"False",103,482,231,-251,251,0
"D15DC",290,104,"1200x900",600,1,600,400,"False",448,584,311,-273,273,0
"D15DC",291,359,"1200x900",800,1,600,400,"False",653,241,317,76,76,0
"D15DC",292,446,"1200x900",1000,0,600,400,"True",72,298,273,-25,25,1
"D15DC",293,224,"1200x900",800,0,600,400,"False",161,474,380,-94,94,1
"D15DC",294,427,"1200x900",800,2,600,400,"False",812,380,489,109,109,0
"D15DC",295,570,"1200x900",1000,1,600,400,"False",315,352,430,78,78,0
"D15DC",296,363,"1200x900",800,2,600,400,"False",800,218,403,185,185,0
"D15DC",297,573,"1200x900",1000,1,600,400,"False",486,615,349,-266,266,0
"D15DC",298,37,"1200x900",600,0,600,400,"True",258,403,445,42,42,1
"D15DC",299,601,"1200x900",1000,2,600,400,"False",735,697,441,-256,256,0
"D15DC",300,214,"1200x900",600,2,600,400,"True",1046,305,305,0,0,0
"D15DC",301,360,"1200x900",800,1,600,400,"False",203,608,304,-304,304,0
"D15DC",302,478,"1200x900",1000,0,600,400,"True",79,672,630,-42,42,1
"D15DC",303,80,"1200x900",600,1,600,400,"True",616,423,386,-37,37,1
"D15DC",304,519,"1200x900",1000,1,600,400,"False",319,565,379,-186,186,1
"D15DC",305,413,"1200x900",800,2,600,400,"True",849,506,463,-43,43,0
"D15DC",306,441,"1200x900",1000,0,600,400,"True",85,684,621,-63,63,1
"D15DC",307,305,"1200x900",800,1,600,400,"False",471,716,407,-309,309,0
"D15DC",309,452,"1200x900",1000,0,600,400,"True",97,273,208,-65,65,1
"D15DC",310,489,"1200x900",1000,0,600,400,"True",88,604,572,-32,32,1
"D15DC",311,376,"1200x900",800,2,600,400,"False",788,275,662,387,387,0
"D15DC",312,495,"1200x900",1000,0,600,400,"True",93,692,687,-5,5,1
"D15DC",313,202,"1200x900",600,2,600,400,"False",966,460,370,-90,90,0
"D15DC",314,600,"1200x900",1000,2,600,400,"False",765,207,420,213,213,0
"D15DC",315,597,"1200x900",1000,2,600,400,"False",352,239,421,182,182,0
"D15DC",316,201,"1200x900",600,2,600,400,"False",1005,462,206,-256,256,0
"D15DC",317,237,"1200x900",800,0,600,400,"True",204,481,525,44,44,1
"D15DC",318,385,"1200x900",800,2,600,400,"False",740,456,563,107,107,0
"D15DC",319,286,"1200x900",800,0,600,400,"True",105,378,397,19,19,1
"D15DC",320,396,"1200x900",800,2,600,400,"False",678,663,518,-145,145,0
"D15DC",321,65,"1200x900",600,0,600,400,"True",442,645,632,-13,13,1
"D15DC",322,535,"1200x900",1000,1,600,400,"False",372,410,567,157,157,0
"D15DC",323,491,"1200x900",1000,0,600,400,"False",108,198,351,153,153,1
"D15DC",324,371,"1200x900",800,2,600,400,"True",730,560,572,12,12,0
"D15DC",325,461,"1200x900",1000,0,600,400,"False",95,711,546,-165,165,1
"D15DC",326,332,"1200x900",800,1,600,400,"True",260,699,723,24,24,0
"D15DC",327,215,"1200x900",600,2,600,400,"False",939,596,488,-108,108,0
"D15DC",328,377,"1200x900",800,2,600,400,"False",683,388,498,110,110,0
"D15DC",329,53,"1200x900",600,0,600,400,"True",177,189,227,38,38,0
"D15DC",330,619,"1200x900",1000,2,600,400,"False",803,247,499,252,252,0
"D15DC",331,255,"1200x900",800,0,600,400,"True",93,709,667,-42,42,1
"D15DC",332,394,"1200x900",800,2,600,400,"False",847,292,479,187,187,0
"D15DC",333,31,"1200x900",600,0,600,400,"True",365,338,295,-43,43,1
"D15DC",334,567,"1200x900",1000,1,600,400,"True",655,297,310,13,13,1
"D15DC",335,414,"1200x900",800,2,600,400,"False",831,592,445,-147,147,0
"D15DC",336,361,"1200x900",800,2,600,400,"False",931,328,242,-86,86,0
"D15DC",337,181,"1200x900",600,2,600,400,"True",1018,223,308,85,85,0
"D15DC",338,602,"1200x900",1000,2,600,400,"False",865,452,360,-92,92,0
"D15DC",339,59,"1200x900",600,0,600,400,"True",391,692,750,58,58,1
"D15DC",340,515,"1200x900",1000,1,600,400,"False",307,217,367,150,150,0
"D15DC",341,445,"1200x900",1000,0,600,400,"False",78,302,202,-100,100,1
"D15DC",342,443,"1200x900",1000,0,600,400,"True",99,651,595,-56,56,1
"D15DC",343,282,"1200x900",800,0,600,400,"False",109,246,313,67,67,1
"D15DC",344,388,"1200x900",800,2,600,400,"False",930,320,550,230,230,0
"D15DC",345,632,"1200x900",1000,2,600,400,"False",984,227,566,339,339,0
"D15DC",346,372,"1200x900",800,2,600,400,"False",833,620,336,-284,284,0
"D15DC",347,24,"1200x900",600,0,600,400,"False",430,538,663,125,125,1
"D15DC",348,608,"1200x900",1000,2,600,400,"False",742,250,382,132,132,0
"D15DC",349,381,"1200x900",800,2,600,400,"True",705,408,389,-19,19,0
"D15DC",350,620,"1200x900",1000,2,600,400,"False",832,649,546,-103,103,0
"D15DC",351,226,"1200x900",800,0,600,400,"True",187,229,239,10,10,1
"D15DC",352,207,"1200x900",600,2,600,400,"False",838,235,351,116,116,0
"D15DC",353,147,"1200x900",600,2,600,400,"False",942,418,527,109,109,0
"D15DC",354,43,"1200x900",600,0,600,400,"False",277,446,572,126,126,1
"D15DC",355,221,"1200x900",800,0,600,400,"True",132,520,541,21,21,1
"D15DC",356,561,"1200x900",1000,1,600,400,"False",231,406,496,90,90,0
"D15DC",357,38,"1200x900",600,0,600,400,"True",120,628,591,-37,37,1
"D15DC",358,208,"1200x900",600,2,600,400,"True",946,399,453,54,54,0
"D15DC",359,89,"1200x900",600,1,600,400,"False",917,366,458,92,92,1
"D15DC",360,56,"1200x900",600,0,600,400,"True",148,491,513,22,22,0
"D15DC",361,160,"1200x900",600,2,600,400,"False",863,606,462,-144,144,0
"D15DC",362,593,"1200x900",1000,2,600,400,"False",246,719,244,-475,475,0
"D15DC",363,180,"1200x900",600,2,600,400,"True",929,270,250,-20,20,0
"D15DC",364,317,"1200x900",800,1,600,400,"True",185,564,610,46,46,0
"D15DC",365,7,"1200x900",600,0,600,400,"True",431,654,680,26,26,1
"D15DC",366,437,"1200x900",1000,0,600,400,"True",74,667,638,-29,29,1
"D15DC",367,641,"1200x900",1000,2,600,400,"False",897,272,648,376,376,0
"D15DC",368,638,"1200x900",1000,2,600,400,"False",385,198,549,351,351,0
"D15DC",369,328,"1200x900",800,1,600,400,"False",104,649,537,-112,112,0
"D15DC",370,591,"1200x900",1000,2,600,400,"False",698,336,487,151,151,0
"D15DC",371,458,"1200x900",1000,0,600,400,"False",78,624,510,-114,114,1
"D15DC",372,35,"1200x900",600,0,600,400,"True",366,555,542,-13,13,1
"D15DC",373,460,"1200x900",1000,0,600,400,"True",155,189,233,44,44,1
"D15DC",374,366,"1200x900",800,2,600,400,"False",931,464,340,-124,124,0
"D15DC",375,409,"1200x900",800,2,600,400,"False",501,659,370,-289,289,0
"D15DC",376,3,"1200x900",600,0,600,400,"False",298,443,556,113,113,1
"D15DC",377,19,"1200x900",600,0,600,400,"False",286,686,587,-99,99,0
"D15DC",378,450,"1200x900",1000,0,600,400,"False",130,204,349,145,145,1
"D15DC",379,242,"1200x900",800,0,600,400,"True",117,448,437,-11,11,1
"D15DC",380,463,"1200x900",1000,0,600,400,"False",115,693,611,-82,82,1
"D15DC",381,118,"1200x900",600,1,600,400,"False",190,588,665,77,77,0
"D15DC",382,314,"1200x900",800,1,600,400,"False",277,616,519,-97,97,1
"D15DC",383,382,"1200x900",800,2,600,400,"True",870,523,532,9,9,0
"D15DC",384,505,"1200x900",1000,1,600,400,"False",191,484,658,174,174,1
"D15DC",385,404,"1200x900",800,2,600,400,"False",842,396,486,90,90,0
"D15DC",386,47,"1200x900",600,0,600,400,"True",303,499,515,16,16,1
"D15DC",387,348,"1200x900",800,1,600,400,"False",764,294,458,164,164,0
"D15DC",388,296,"1200x900",800,1,600,400,"False",89,279,373,94,94,0
"D15DC",389,352,"1200x900",800,1,600,400,"False",235,717,283,-434,434,0
"D15DC",390,529,"1200x900",1000,1,600,400,"True",267,412,463,51,51,1
"D15DC",391,447,"1200x900",1000,0,600,400,"True",71,339,307,-32,32,1
"D15DC",392,190,"1200x900",600,2,600,400,"True",977,238,254,16,16,0
"D15DC",393,507,"1200x900",1000,1,600,400,"False",608,583,389,-194,194,1
"D15DC",394,112,"1200x900",600,1,600,400,"True",681,490,444,-46,46,0
"D15DC",395,284,"1200x900",800,0,600,400,"True",135,293,350,57,57,1
"D15DC",396,76,"1200x900",600,1,600,400,"False",647,614,380,-234,234,0
"D15DC",397,637,"1200x900",1000,2,600,400,"True",750,460,464,4,4,0
"D15DC",398,4,"1200x900",600,0,600,400,"False",602,200,291,91,91,1
"D15DC",400,527,"1200x900",1000,1,600,400,"False",565,601,300,-301,301,0
"D15DC",401,184,"1200x900",600,2,600,400,"False",1067,441,563,122,122,0
"D15DC",402,501,"1200x900",1000,0,600,400,"False",96,323,389,66,66,1
"D15DC",403,417,"1200x900",800,2,600,400,"False",750,280,343,63,63,0
"D15DC",404,62,"1200x900",600,0,600,400,"True",345,346,354,8,8,1
"D15DC",405,399,"1200x900",800,2,600,400,"False",603,602,278,-324,324,0
"D15DC",406,522,"1200x900",1000,1,600,400,"False",223,379,444,65,65,0
"D15DC",407,457,"1200x900",1000,0,600,400,"False",97,630,485,-145,145,1
"D15DC",408,455,"1200x900",1000,0,600,400,"False",107,718,597,-121,121,1
"D15DC",409,315,"1200x900",800,1,600,400,"False",105,211,456,245,245,0
"D15DC",411,186,"1200x900",600,2,600,400,"True",997,197,282,85,85,0
"D15DC",412,194,"1200x900",600,2,600,400,"True",896,236,278,42,42,0
"D15DC",413,145,"1200x900",600,2,600,400,"False",1004,630,698,68,68,0
"D15DC",414,248,"1200x900",800,0,600,400,"False",94,240,425,185,185,1
"D15DC",415,48,"1200x900",600,0,600,400,"True",323,645,645,0,0,1
"D15DC",416,523,"1200x900",1000,1,600,400,"False",339,318,527,209,209,0
"D15DC",417,299,"1200x900",800,1,600,400,"False",779,274,478,204,204,0
"D15DC",418,556,"1200x900",1000,1,600,400,"False",415,420,511,91,91,0
"D15DC",420,479,"1200x900",1000,0,600,400,"False",74,705,639,-66,66,1
"D15DC",421,490,"1200x900",1000,0,600,400,"False",114,183,395,212,212,1
"D15DC",422,195,"1200x900",600,2,600,400,"True",942,249,288,39,39,0
"D15DC",423,42,"1200x900",600,0,600,400,"True",233,479,467,-12,12,0
"D15DC",424,200,"1200x900",600,2,600,400,"True",897,302,386,84,84,0
"D15DC",426,95,"1200x900",600,1,600,400,"False",749,425,287,-138,138,1
"D15DC",427,574,"1200x900",1000,1,600,400,"False",614,194,299,105,105,0
"D15DC",428,146,"1200x900",600,2,600,400,"False",989,492,283,-209,209,0
"D15DC",429,312,"1200x900",800,1,600,400,"False",238,683,453,-230,230,0
"D15DC",430,222,"1200x900",800,0,600,400,"False",152,206,362,156,156,1
"D15DC",431,454,"1200x900",1000,0,600,400,"False",78,687,598,-89,89,1
"D15DC",432,565,"1200x900",1000,1,600,400,"True",451,562,580,18,18,0
"D15DC",433,191,"1200x900",600,2,600,400,"False",962,396,571,175,175,0
"D15DC",434,120,"1200x900",600,1,600,400,"True",690,655,621,-34,34,0
"D15DC",435,49,"1200x900",600,0,600,400,"True",109,380,429,49,49,0
"D15DC",436,251,"1200x900",800,0,600,400,"True",88,352,328,-24,24,1
"D15DC",437,230,"1200x900",800,0,600,400,"False",99,678,594,-84,84,1
"D15DC",438,621,"1200x900",1000,2,600,400,"True",540,478,434,-44,44,0
"D15DC",439,213,"1200x900",600,2,600,400,"True",822,275,391,116,116,0
"D15DC",440,123,"1200x900",600,1,600,400,"True",761,365,356,-9,9,1
"D15DC",441,369,"1200x900",800,2,600,400,"True",903,594,617,23,23,0
"D15DC",442,39,"1200x900",600,0,600,400,"True",210,609,613,4,4,0
"D15DC",443,291,"1200x900",800,1,600,400,"False",522,694,620,-74,74,0
"D15DC",444,220,"1200x900",800,0,600,400,"True",108,699,706,7,7,1
"D15DC",445,115,"1200x900",600,1,600,400,"True",545,307,315,8,8,0
"D15DC",446,211,"1200x900",600,2,600,400,"False",986,407,320,-87,87,0
"D15DC",447,563,"1200x900",1000,1,600,400,"True",201,696,693,-3,3,0
"D15DC",448,106,"1200x900",600,1,600,400,"False",803,659,458,-201,201,1
"D15DC",449,135,"1200x900",600,1,600,400,"True",759,569,601,32,32,0
"D15DC",450,32,"1200x900",600,0,600,400,"True",152,563,549,-14,14,1
"D15DC",451,289,"1200x900",800,1,600,400,"False",421,703,461,-242,242,1
"D15DC",452,514,"1200x900",1000,1,600,400,"True",539,690,641,-49,49,0
"D15DC",453,645,"1200x900",1000,2,600,400,"False",619,396,480,84,84,0
"D15DC",454,244,"1200x900",800,0,600,400,"True",194,203,179,-24,24,1
"D15DC",455,481,"1200x900",1000,0,600,400,"True",80,185,217,32,32,1
"D15DC",456,429,"1200x900",800,2,600,400,"False",682,692,398,-294,294,0
"D15DC",457,210,"1200x900",600,2,600,400,"False",835,506,631,125,125,0
"D15DC",458,448,"1200x900",1000,0,600,400,"True",107,641,623,-18,18,1
"D15DC",459,108,"1200x900",600,1,600,400,"False",830,239,526,287,287,0
"D15DC",460,101,"1200x900",600,1,600,400,"False",541,656,711,55,55,0
"D15DC",461,272,"1200x900",800,0,600,400,"False",200,181,436,255,255,1
"D15DC",462,269,"1200x900",800,0,600,400,"True",160,295,355,60,60,1
"D15DC",463,267,"1200x900",800,0,600,400,"True",145,665,661,-4,4,1
"D15DC",464,586,"1200x900",1000,2,600,400,"False",802,262,692,430,430,0
"D15DC",465,252,"1200x900",800,0,600,400,"True",224,673,715,42,42,1
"D15DC",466,218,"1200x900",800,0,600,400,"False",106,397,470,73,73,1
"D15DC",467,346,"1200x900",800,1,600,400,"False",269,635,434,-201,201,0
"D15DC",468,64,"1200x900",600,0,600,400,"False",102,339,435,96,96,0
"D15DC",469,426,"1200x900",800,2,600,400,"True",830,263,305,42,42,0
"D15DC",470,113,"1200x900",600,1,600,400,"False",897,657,543,-114,114,0
"D15DC",471,159,"1200x900",600,2,600,400,"True",992,309,383,74,74,0
"D15DC",472,235,"1200x900",800,0,600,400,"False",146,646,576,-70,70,1
"D15DC",473,169,"1200x900",600,2,600,400,"False",924,290,396,106,106,0
"D15DC",474,548,"1200x900",1000,1,600,400,"True",103,278,310,32,32,0
"D15DC",475,520,"1200x900",1000,1,600,400,"False",564,260,341,81,81,0
"D15DC",476,310,"1200x900",800,1,600,400,"False",559,592,312,-280,280,0
"D15DC",477,260,"1200x900",800,0,600,400,"True",103,525,549,24,24,1
"D15DC",478,406,"1200x900",800,2,600,400,"False",971,233,544,311,311,0
"D15DC",479,206,"1200x900",600,2,600,400,"False",975,223,543,320,320,0
"D15DC",480,8,"1200x900",600,0,600,400,"True",156,679,653,-26,26,0
"D15DC",481,240,"1200x900",800,0,600,400,"True",330,656,712,56,56,1
"D15DC",482,630,"1200x900",1000,2,600,400,"False",754,559,694,135,135,0
"D15DC",483,631,"1200x900",1000,2,600,400,"False",699,479,579,100,100,0
"D15DC",485,549,"1200x900",1000,1,600,400,"False",657,366,684,318,318,0
"D15DC",486,265,"1200x900",800,0,600,400,"True",229,353,409,56,56,1
"D15DC",487,239,"1200x900",800,0,600,400,"False",114,231,339,108,108,1
"D15DC",488,100,"1200x900",600,1,600,400,"True",453,511,464,-47,47,0
"D15DC",489,436,"1200x900",1000,0,600,400,"True",82,617,593,-24,24,1
"D15DC",490,189,"1200x900",600,2,600,400,"False",881,397,592,195,195,0
"D15DC",491,475,"1200x900",1000,0,600,400,"False",101,715,602,-113,113,1
"D15DC",492,86,"1200x900",600,1,600,400,"True",692,388,369,-19,19,1
"D15DC",493,599,"1200x900",1000,2,600,400,"True",316,570,558,-12,12,0
"D15DC",494,532,"1200x900",1000,1,600,400,"False",215,207,388,181,181,0
"D15DC",495,472,"1200x900",1000,0,600,400,"False",77,685,535,-150,150,1
"D15DC",496,502,"1200x900",1000,0,600,400,"False",111,639,408,-231,231,1
"D15DC",497,60,"1200x900",600,0,600,400,"False",365,213,297,84,84,1
"D15DC",498,469,"1200x900",1000,0,600,400,"False",73,227,307,80,80,1
"D15DC",499,341,"1200x900",800,1,600,400,"False",735,632,561,-71,71,1
"D15DC",500,128,"1200x900",600,1,600,400,"False",661,258,352,94,94,1
"D15DC",501,107,"1200x900",600,1,600,400,"False",878,678,545,-133,133,0
"D15DC",502,183,"1200x900",600,2,600,400,"True",927,289,331,42,42,0
"D15DC",503,354,"1200x900",800,1,600,400,"False",118,236,421,185,185,0
"D15DC",504,432,"1200x900",800,2,600,400,"False",792,380,301,-79,79,0
"D15DC",505,435,"1200x900",1000,0,600,400,"False",119,200,265,65,65,1
"D15DC",506,603,"1200x900",1000,2,600,400,"True",693,280,340,60,60,0
"D15DC",507,544,"1200x900",1000,1,600,400,"False",602,620,473,-147,147,0
"D15DC",508,440,"1200x900",1000,0,600,400,"False",71,237,419,182,182,1
"D15DC",509,28,"1200x900",600,0,600,400,"True",336,410,427,17,17,1
"D15DC",510,551,"1200x900",1000,1,600,400,"False",146,445,529,84,84,1
"D15DC",511,234,"1200x900",800,0,600,400,"True",72,344,389,45,45,1
"D15DC",512,316,"1200x900",800,1,600,400,"True",362,319,339,20,20,0
"D15DC",513,164,"1200x900",600,2,600,400,"True",1051,268,343,75,75,0
"D15DC",514,52,"1200x900",600,0,600,400,"True",171,188,195,7,7,0
"D15DC",515,617,"1200x900",1000,2,600,400,"False",294,180,405,225,225,0
"D15DC",516,560,"1200x900",1000,1,600,400,"False",516,693,229,-464,464,0
"D15DC",517,271,"1200x900",800,0,600,400,"True",74,360,362,2,2,1
"D15DC",518,217,"1200x900",800,0,600,400,"False",85,573,502,-71,71,1
"D15DC",519,559,"1200x900",1000,1,600,400,"False",641,244,514,270,270,0
"D15DC",520,124,"1200x900",600,1,600,400,"True",345,467,418,-49,49,0
"D15DC",521,397,"1200x900",800,2,600,400,"False",817,692,457,-235,235,0
"D15DC",522,11,"1200x900",600,0,600,400,"True",372,670,657,-13,13,1
"D15DC",523,449,"1200x900",1000,0,600,400,"True",105,683,662,-21,21,1
"D15DC",524,327,"1200x900",800,1,600,400,"True",152,339,401,62,62,0
"D15DC",525,204,"1200x900",600,2,600,400,"False",1053,432,233,-199,199,0
"D15DC",526,20,"1200x900",600,0,600,400,"False",204,545,630,85,85,1
"D15DC",527,5,"1200x900",600,0,600,400,"True",228,587,593,6,6,0
"D15DC",528,411,"1200x900",800,2,600,400,"True",805,361,327,-34,34,0
"D15DC",529,614,"1200x900",1000,2,600,400,"False",823,563,429,-134,134,0
"D15DC",530,623,"1200x900",1000,2,600,400,"False",636,527,404,-123,123,0
"D15DC",531,225,"1200x900",800,0,600,400,"True",178,423,475,52,52,1
"D15DC",532,604,"1200x900",1000,2,600,400,"False",459,593,301,-292,292,0
"D15DC",533,232,"1200x900",800,0,600,400,"True",84,511,578,67,67,1
"D15DC",534,131,"1200x900",600,1,600,400,"True",531,367,362,-5,5,0
"D15DC",535,618,"1200x900",1000,2,600,400,"False",276,671,519,-152,152,0
"D15DC",536,562,"1200x900",1000,1,600,400,"True",347,540,476,-64,64,0
"D15DC",537,295,"1200x900",800,1,600,400,"True",471,334,365,31,31,0
"D15DC",538,576,"1200x900",1000,1,600,400,"True",376,713,663,-50,50,0
"D15DC",539,504,"1200x900",1000,0,600,400,"True",107,699,691,-8,8,1
"D15DC",540,624,"1200x900",1000,2,600,400,"True",693,501,442,-59,59,0
"D15DC",541,12,"1200x900",600,0,600,400,"True",365,336,345,9,9,1
"D15DC",542,373,"1200x900",800,2,600,400,"False",694,326,184,-142,142,0
"D15DC",543,70,"1200x900",600,0,600,400,"True",309,703,715,12,12,1
"D15DC",544,557,"1200x900",1000,1,600,400,"True",677,505,515,10,10,1
"D15DC",545,331,"1200x900",800,1,600,400,"False",240,620,697,77,77,0
"D15DC",546,219,"1200x900",800,0,600,400,"False",202,502,592,90,90,1
"D15DC",547,277,"1200x900",800,0,600,400,"False",140,310,383,73,73,1
"D15DC",548,71,"1200x900",600,0,600,400,"False",219,248,315,67,67,0
"D15DC",549,227,"1200x900",800,0,600,400,"False",196,551,623,72,72,1
"D15DC",550,67,"1200x900",600,0,600,400,"False",289,308,376,68,68,1
"D15DC",551,45,"1200x900",600,0,600,400,"False",487,678,582,-96,96,1
"D15DC",552,428,"1200x900",800,2,600,400,"False",732,665,305,-360,360,0
"D15DC",553,306,"1200x900",800,1,600,400,"True",164,524,529,5,5,0
"D15DC",554,99,"1200x900",600,1,600,400,"True",811,407,459,52,52,0
"D15DC",555,530,"1200x900",1000,1,600,400,"False",584,405,230,-175,175,1
"D15DC",556,41,"1200x900",600,0,600,400,"True",370,452,418,-34,34,1
"D15DC",557,10,"1200x900",600,0,600,400,"True",400,499,473,-26,26,1
"D15DC",558,127,"1200x900",600,1,600,400,"False",309,691,506,-185,185,0
"D15DC",559,581,"1200x900",1000,2,600,400,"False",310,357,526,169,169,0
"D15DC",560,153,"1200x900",600,2,600,400,"True",1037,601,609,8,8,0
"D15DC",561,543,"1200x900",1000,1,600,400,"False",88,202,551,349,349,0
"D15DC",562,87,"1200x900",600,1,600,400,"False",231,604,466,-138,138,0
"D15DC",563,16,"1200x900",600,0,600,400,"True",297,514,447,-67,67,1
"D15DC",564,554,"1200x900",1000,1,600,400,"False",79,309,201,-108,108,1
"D15DC",565,68,"1200x900",600,0,600,400,"False",165,367,285,-82,82,0
"D15DC",566,642,"1200x900",1000,2,600,400,"False",776,316,589,273,273,0
"D15DC",567,613,"1200x900",1000,2,600,400,"False",690,374,565,191,191,0
"D15DC",568,494,"1200x900",1000,0,600,400,"True",127,692,653,-39,39,1
"D15DC",569,564,"1200x900",1000,1,600,400,"False",215,264,418,154,154,0
"D15DC",570,579,"1200x900",1000,2,600,400,"True",803,394,331,-63,63,0
"D15DC",571,121,"1200x900",600,1,600,400,"False",884,364,538,174,174,0
"D15DC",572,23,"1200x900",600,0,600,400,"True",308,463,468,5,5,1
"D15DC",573,592,"1200x900",1000,2,600,400,"False",492,392,526,134,134,0
"D15DC",574,370,"1200x900",800,2,600,400,"True",874,336,324,-12,12,0
"D15DC",575,231,"1200x900",800,0,600,400,"False",251,718,640,-78,78,1
"D15DC",576,243,"1200x900",800,0,600,400,"True",114,332,373,41,41,1
"D15DC",577,97,"1200x900",600,1,600,400,"False",760,643,350,-293,293,1
"D15DC",578,636,"1200x900",1000,2,600,400,"True",575,583,534,-49,49,0
"D15DC",579,2,"1200x900",600,0,600,400,"True",159,323,380,57,57,0
"D15DC",580,540,"1200x900",1000,1,600,400,"True",389,568,581,13,13,1
"D15DC",581,508,"1200x900",1000,1,600,400,"False",596,485,580,95,95,0
"D15DC",582,79,"1200x900",600,1,600,400,"True",731,289,335,46,46,0
"D15DC",583,182,"1200x900",600,2,600,400,"True",933,389,433,44,44,0
"D15DC",584,353,"1200x900",800,1,600,400,"True",90,476,458,-18,18,0
"D15DC",585,294,"1200x900",800,1,600,400,"True",262,287,252,-35,35,0
"D15DC",586,615,"1200x900",1000,2,600,400,"False",736,634,297,-337,337,0
"D15DC",587,141,"1200x900",600,1,600,400,"False",671,582,439,-143,143,0
"D15DC",588,241,"1200x900",800,0,600,400,"False",129,227,344,117,117,1
"D15DC",589,185,"1200x900",600,2,600,400,"True",907,212,235,23,23,0
"D15DC",590,537,"1200x900",1000,1,600,400,"True",621,412,437,25,25,1
"D15DC",591,122,"1200x900",600,1,600,400,"False",817,709,528,-181,181,0
"D15DC",592,290,"1200x900",800,1,600,400,"True",789,603,571,-32,32,0
"D15DC",593,342,"1200x900",800,1,600,400,"False",677,204,551,347,347,0
"D15DC",594,212,"1200x900",600,2,600,400,"False",841,206,358,152,152,0
"D15DC",595,85,"1200x900",600,1,600,400,"False",434,347,556,209,209,0
"D15DC",596,434,"1200x900",1000,0,600,400,"False",89,657,593,-64,64,1
"D15DC",597,116,"1200x900",600,1,600,400,"False",767,289,236,-53,53,0
"D15DC",598,249,"1200x900",800,0,600,400,"True",126,306,365,59,59,1
"D15DC",599,155,"1200x900",600,2,600,400,"True",940,269,228,-41,41,0
"D15DC",600,516,"1200x900",1000,1,600,400,"False",440,559,421,-138,138,0
"D15DC",601,606,"1200x900",1000,2,600,400,"False",653,627,498,-129,129,0
"D15DC",602,78,"1200x900",600,1,600,400,"False",885,684,757,73,73,0
"D15DC",603,568,"1200x900",1000,1,600,400,"True",286,475,482,7,7,1
"D15DC",604,22,"1200x900",600,0,600,400,"True",398,591,547,-44,44,1
"D15DC",605,518,"1200x900",1000,1,600,400,"False",583,717,380,-337,337,0
"D15DC",606,578,"1200x900",1000,2,600,400,"False",966,276,575,299,299,0
"D15DC",607,301,"1200x900",800,1,600,400,"False",162,574,446,-128,128,0
"D15DC",608,17,"1200x900",600,0,600,400,"True",402,496,544,48,48,1
"D15DC",609,410,"1200x900",800,2,600,400,"False",916,477,312,-165,165,0
"D15DC",610,30,"1200x900",600,0,600,400,"True",107,353,411,58,58,0
"D15DC",611,126,"1200x900",600,1,600,400,"True",849,354,350,-4,4,0
"D15DC",612,470,"1200x900",1000,0,600,400,"False",91,666,538,-128,128,1
"D15DC",613,392,"1200x900",800,2,600,400,"False",1031,618,675,57,57,0
"D15DC",614,464,"1200x900",1000,0,600,400,"False",82,222,457,235,235,1
"D15DC",616,96,"1200x900",600,1,600,400,"True",433,458,440,-18,18,0
"D15DC",617,528,"1200x900",1000,1,600,400,"False",839,227,404,177,177,1
"D15DC",618,192,"1200x900",600,2,600,400,"False",1064,320,704,384,384,0
"D15DC",619,268,"1200x900",800,0,600,400,"False",148,400,312,-88,88,1
"D15DC",620,471,"1200x900",1000,0,600,400,"False",122,200,283,83,83,1
"D15DC",621,646,"1200x900",1000,2,600,400,"True",829,227,290,63,63,1
"D15DC",622,415,"1200x900",800,2,600,400,"False",823,684,399,-285,285,0
"D15DC",623,340,"1200x900",800,1,600,400,"True",226,240,189,-51,51,0
"D15DC",624,27,"1200x900",600,0,600,400,"False",373,309,222,-87,87,1
"D15DC",625,165,"1200x900",600,2,600,400,"False",912,554,399,-155,155,0
"D15DC",626,188,"1200x900",600,2,600,400,"False",900,195,303,108,108,0
"D15DC",627,26,"1200x900",600,0,600,400,"False",70,712,638,-74,74,0
"D15DC",628,386,"1200x900",800,2,600,400,"True",774,301,305,4,4,0
"D15DC",629,589,"1200x900",1000,2,600,400,"False",856,418,306,-112,112,0
"D15DC",630,350,"1200x900",800,1,600,400,"True",182,566,552,-14,14,0
"D15DC",631,534,"1200x900",1000,1,600,400,"False",328,504,586,82,82,1
"D15DC",632,379,"1200x900",800,2,600,400,"False",994,325,631,306,306,0
"D15DC",633,487,"1200x900",1000,0,600,400,"False",78,670,515,-155,155,1
"D15DC",634,36,"1200x900",600,0,600,400,"True",128,346,367,21,21,1
"D15DC",635,451,"1200x900",1000,0,600,400,"False",110,702,622,-80,80,1
"D15DC",636,525,"1200x900",1000,1,600,400,"False",123,690,557,-133,133,0
"D15DC",637,453,"1200x900",1000,0,600,400,"False",71,393,592,199,199,1
"D15DC",638,1,"1200x900",600,0,600,400,"True",136,502,484,-18,18,0
"D15DC",639,209,"1200x900",600,2,600,400,"True",937,637,575,-62,62,0
"D15DC",640,93,"1200x900",600,1,600,400,"True",139,540,460,-80,80,0
"D15DC",641,46,"1200x900",600,0,600,400,"True",193,355,385,30,30,1
"D15DC",642,167,"1200x900",600,2,600,400,"True",956,241,318,77,77,0
"D15DC",643,596,"1200x900",1000,2,600,400,"False",706,513,362,-151,151,0
"D15DC",644,61,"1200x900",600,0,600,400,"False",272,670,613,-57,57,1
"D15DC",645,477,"1200x900",1000,0,600,400,"False",88,640,523,-117,117,1
"D15DC",646,166,"1200x900",600,2,600,400,"True",896,274,343,69,69,0
"D15DC",647,486,"1200x900",1000,0,600,400,"False",102,676,549,-127,127,1
"D15DC",648,356,"1200x900",800,1,600,400,"True",123,484,486,2,2,0
"D16RT",1,552,"1200x900",1000,1,600,400,"False",255,412,477,65,65,0
"D16RT",2,204,"1200x900",600,2,600,400,"False",1053,432,613,181,181,0
"D16RT",3,205,"1200x900",600,2,600,400,"True",1021,504,469,-35,35,0
"D16RT",4,251,"1200x900",800,0,600,400,"False",88,352,251,-101,101,1
"D16RT",5,80,"1200x900",600,1,600,400,"False",616,423,688,265,265,1
"D16RT",6,58,"1200x900",600,0,600,400,"False",353,655,507,-148,148,1
"D16RT",7,593,"1200x900",1000,2,600,400,"False",246,719,502,-217,217,0
"D16RT",8,363,"1200x900",800,2,600,400,"False",800,218,614,396,396,0
"D16RT",9,381,"1200x900",800,2,600,400,"True",705,408,382,-26,26,0
"D16RT",10,325,"1200x900",800,1,600,400,"True",105,394,409,15,15,0
"D16RT",11,228,"1200x900",800,0,600,400,"True",174,687,675,-12,12,1
"D16RT",12,599,"1200x900",1000,2,600,400,"False",316,570,374,-196,196,0
"D16RT",13,305,"1200x900",800,1,600,400,"True",471,716,708,-8,8,0
"D16RT",14,487,"1200x900",1000,0,600,400,"True",78,670,611,-59,59,1
"D16RT",15,254,"1200x900",800,0,600,400,"True",136,583,530,-53,53,1
"D16RT",16,558,"1200x900",1000,1,600,400,"False",72,464,310,-154,154,1
"D16RT",17,177,"1200x900",600,2,600,400,"False",912,236,343,107,107,0
"D16RT",18,288,"1200x900",800,0,600,400,"True",180,547,521,-26,26,1
"D16RT",19,218,"1200x900",800,0,600,400,"True",106,397,365,-32,32,1
"D16RT",20,317,"1200x900",800,1,600,400,"False",185,564,830,266,266,0
"D16RT",21,424,"1200x900",800,2,600,400,"False",903,545,684,139,139,0
"D16RT",22,40,"1200x900",600,0,600,400,"True",143,513,494,-19,19,0
"D16RT",23,127,"1200x900",600,1,600,400,"True",309,691,632,-59,59,0
"D16RT",24,256,"1200x900",800,0,600,400,"True",192,656,599,-57,57,1
"D16RT",25,49,"1200x900",600,0,600,400,"True",109,380,435,55,55,0
"D16RT",26,153,"1200x900",600,2,600,400,"False",1037,601,689,88,88,0
"D16RT",27,511,"1200x900",1000,1,600,400,"False",408,390,696,306,306,1
"D16RT",28,415,"1200x900",800,2,600,400,"False",823,684,378,-306,306,0
"D16RT",29,542,"1200x900",1000,1,600,400,"True",304,401,449,48,48,0
"D16RT",30,627,"1200x900",1000,2,600,400,"False",760,510,311,-199,199,0
"D16RT",31,537,"1200x900",1000,1,600,400,"False",621,412,616,204,204,1
"D16RT",32,219,"1200x900",800,0,600,400,"True",202,502,500,-2,2,1
"D16RT",33,260,"1200x900",800,0,600,400,"True",103,525,479,-46,46,1
"D16RT",34,483,"1200x900",1000,0,600,400,"True",93,191,165,-26,26,1
"D16RT",35,582,"1200x900",1000,2,600,400,"False",554,347,489,142,142,0
"D16RT",36,249,"1200x900",800,0,600,400,"True",126,306,310,4,4,1
"D16RT",37,23,"1200x900",600,0,600,400,"True",308,463,415,-48,48,1
"D16RT",38,430,"1200x900",800,2,600,400,"False",922,254,423,169,169,0
"D16RT",39,203,"1200x900",600,2,600,400,"False",938,603,403,-200,200,0
"D16RT",40,416,"1200x900",800,2,600,400,"False",748,617,481,-136,136,0
"D16RT",41,136,"1200x900",600,1,600,400,"True",264,205,239,34,34,0
"D16RT",42,364,"1200x900",800,2,600,400,"True",1018,204,213,9,9,0
"D16RT",43,469,"1200x900",1000,0,600,400,"True",73,227,161,-66,66,1
"D16RT",44,125,"1200x900",600,1,600,400,"True",750,531,493,-38,38,0
"D16RT",45,353,"1200x900",800,1,600,400,"False",90,476,349,-127,127,0
"D16RT",46,291,"1200x900",800,1,600,400,"True",522,694,640,-54,54,0
"D16RT",47,479,"1200x900",1000,0,600,400,"True",74,705,742,37,37,1
"D16RT",48,92,"1200x900",600,1,600,400,"True",624,605,599,-6,6,0
"D16RT",49,296,"1200x900",800,1,600,400,"True",89,279,226,-53,53,0
"D16RT",50,460,"1200x900",1000,0,600,400,"True",155,189,165,-24,24,1
"D16RT",51,635,"1200x900",1000,2,600,400,"False",833,402,291,-111,111,0
"D16RT",52,563,"1200x900",1000,1,600,400,"True",201,696,636,-60,60,0
"D16RT",53,190,"1200x900",600,2,600,400,"True",977,238,240,2,2,0
"D16RT",54,406,"1200x900",800,2,600,400,"False",971,233,404,171,171,0
"D16RT",55,383,"1200x900",800,2,600,400,"True",855,407,354,-53,53,0
"D16RT",56,281,"1200x900",800,0,600,400,"False",112,611,544,-67,67,1
"D16RT",57,312,"1200x900",800,1,600,400,"False",238,683,552,-131,131,0
"D16RT",58,37,"1200x900",600,0,600,400,"True",258,403,425,22,22,1
"D16RT",59,3,"1200x900",600,0,600,400,"True",298,443,395,-48,48,1
"D16RT",60,457,"1200x900",1000,0,600,400,"False",97,630,516,-114,114,1
"D16RT",61,569,"1200x900",1000,1,600,400,"False",494,720,537,-183,183,0
"D16RT",62,282,"1200x900",800,0,600,400,"True",109,246,222,-24,24,1
"D16RT",63,403,"1200x900",800,2,600,400,"False",625,704,347,-357,357,0
"D16RT",64,596,"1200x900",1000,2,600,400,"False",706,513,353,-160,160,0
"D16RT",65,295,"1200x900",800,1,600,400,"False",471,334,433,99,99,0
"D16RT",66,180,"1200x900",600,2,600,400,"True",929,270,343,73,73,0
"D16RT",67,379,"1200x900",800,2,600,400,"True",994,325,347,22,22,0
"D16RT",68,171,"1200x900",600,2,600,400,"False",909,200,420,220,220,0
"D16RT",69,566,"1200x900",1000,1,600,400,"True",378,472,442,-30,30,1
"D16RT",70,557,"1200x900",1000,1,600,400,"False",677,505,622,117,117,1
"D16RT",71,22,"1200x900",600,0,600,400,"True",398,591,568,-23,23,1
"D16RT",72,536,"1200x900",1000,1,600,400,"True",580,213,251,38,38,0
"D16RT",73,342,"1200x900",800,1,600,400,"True",677,204,135,-69,69,0
"D16RT",74,575,"1200x900",1000,1,600,400,"True",272,693,709,16,16,0
"D16RT",75,549,"1200x900",1000,1,600,400,"True",657,366,384,18,18,0
"D16RT",76,645,"1200x900",1000,2,600,400,"True",619,396,461,65,65,0
"D16RT",77,631,"1200x900",1000,2,600,400,"False",699,479,670,191,191,0
"D16RT",78,576,"1200x900",1000,1,600,400,"True",376,713,692,-21,21,0
"D16RT",79,130,"1200x900",600,1,600,400,"True",741,428,475,47,47,0
"D16RT",80,105,"1200x900",600,1,600,400,"True",527,440,434,-6,6,0
"D16RT",81,505,"1200x900",1000,1,600,400,"True",191,484,492,8,8,1
"D16RT",82,210,"1200x900",600,2,600,400,"False",835,506,731,225,225,0
"D16RT",83,188,"1200x900",600,2,600,400,"False",900,195,439,244,244,0
"D16RT",84,181,"1200x900",600,2,600,400,"False",1018,223,512,289,289,0
"D16RT",85,357,"1200x900",800,1,600,400,"False",109,594,691,97,97,0
"D16RT",86,602,"1200x900",1000,2,600,400,"True",865,452,534,82,82,0
"D16RT",87,306,"1200x900",800,1,600,400,"True",164,524,456,-68,68,0
"D16RT",88,79,"1200x900",600,1,600,400,"True",731,289,324,35,35,0
"D16RT",89,346,"1200x900",800,1,600,400,"False",269,635,542,-93,93,0
"D16RT",90,481,"1200x900",1000,0,600,400,"False",80,185,294,109,109,1
"D16RT",91,164,"1200x900",600,2,600,400,"True",1051,268,196,-72,72,0
"D16RT",92,335,"1200x900",800,1,600,400,"False",124,360,539,179,179,0
"D16RT",93,186,"1200x900",600,2,600,400,"True",997,197,273,76,76,0
"D16RT",94,521,"1200x900",1000,1,600,400,"True",111,303,301,-2,2,1
"D16RT",95,470,"1200x900",1000,0,600,400,"False",91,666,504,-162,162,1
"D16RT",96,262,"1200x900",800,0,600,400,"False",196,481,351,-130,130,1
"D16RT",97,119,"1200x900",600,1,600,400,"True",168,563,524,-39,39,0
"D16RT",98,99,"1200x900",600,1,600,400,"False",811,407,565,158,158,0
"D16RT",99,179,"1200x900",600,2,600,400,"False",908,602,433,-169,169,0
"D16RT",100,29,"1200x900",600,0,600,400,"True",385,533,490,-43,43,1
"D16RT",101,459,"1200x900",1000,0,600,400,"False",70,645,561,-84,84,1
"D16RT",102,2,"1200x900",600,0,600,400,"True",159,323,295,-28,28,0
"D16RT",103,494,"1200x900",1000,0,600,400,"False",127,692,523,-169,169,1
"D16RT",104,160,"1200x900",600,2,600,400,"False",863,606,530,-76,76,0
"D16RT",105,517,"1200x900",1000,1,600,400,"True",548,182,243,61,61,0
"D16RT",106,572,"1200x900",1000,1,600,400,"True",302,260,206,-54,54,0
"D16RT",107,185,"1200x900",600,2,600,400,"True",907,212,232,20,20,0
"D16RT",108,226,"1200x900",800,0,600,400,"True",187,229,179,-50,50,1
"D16RT",109,267,"1200x900",800,0,600,400,"True",145,665,650,-15,15,1
"D16RT",110,140,"1200x900",600,1,600,400,"True",700,523,549,26,26,0
"D16RT",111,456,"1200x900",1000,0,600,400,"True",91,257,232,-25,25,1
"D16RT",112,385,"1200x900",800,2,600,400,"False",740,456,320,-136,136,0
"D16RT",113,476,"1200x900",1000,0,600,400,"False",76,359,282,-77,77,1
"D16RT",114,516,"1200x900",1000,1,600,400,"False",440,559,478,-81,81,0
"D16RT",115,263,"1200x900",800,0,600,400,"True",82,396,387,-9,9,1
"D16RT",116,107,"1200x900",600,1,600,400,"True",878,678,649,-29,29,0
"D16RT",117,341,"1200x900",800,1,600,400,"True",735,632,673,41,41,1
"D16RT",118,539,"1200x900",1000,1,600,400,"True",510,383,403,20,20,0
"D16RT",119,352,"1200x900",800,1,600,400,"True",235,717,638,-79,79,0
"D16RT",120,10,"1200x900",600,0,600,400,"False",400,499,360,-139,139,1
"D16RT",121,86,"1200x900",600,1,600,400,"False",692,388,274,-114,114,1
"D16RT",122,265,"1200x900",800,0,600,400,"False",229,353,254,-99,99,1
"D16RT",123,519,"1200x900",1000,1,600,400,"False",319,565,640,75,75,1
"D16RT",124,367,"1200x900",800,2,600,400,"True",613,464,452,-12,12,0
"D16RT",125,279,"1200x900",800,0,600,400,"False",252,202,309,107,107,1
"D16RT",126,400,"1200x900",800,2,600,400,"False",733,297,195,-102,102,0
"D16RT",127,268,"1200x900",800,0,600,400,"True",148,400,338,-62,62,1
"D16RT",128,54,"1200x900",600,0,600,400,"True",474,564,551,-13,13,1
"D16RT",129,75,"1200x900",600,1,600,400,"True",635,558,528,-30,30,0
"D16RT",130,411,"1200x900",800,2,600,400,"False",805,361,464,103,103,0
"D16RT",131,56,"1200x900",600,0,600,400,"False",148,491,389,-102,102,0
"D16RT",132,496,"1200x900",1000,0,600,400,"False",70,639,538,-101,101,1
"D16RT",133,547,"1200x900",1000,1,600,400,"False",369,384,540,156,156,1
"D16RT",134,433,"1200x900",1000,0,600,400,"True",76,222,161,-61,61,1
"D16RT",135,435,"1200x900",1000,0,600,400,"True",119,200,248,48,48,1
"D16RT",136,152,"1200x900",600,2,600,400,"False",971,399,249,-150,150,0
"D16RT",137,412,"1200x900",800,2,600,400,"True",842,280,321,41,41,0
"D16RT",138,546,"1200x900",1000,1,600,400,"True",305,374,355,-19,19,0
"D16RT",139,222,"1200x900",800,0,600,400,"True",152,206,160,-46,46,1
"D16RT",140,221,"1200x900",800,0,600,400,"False",132,520,408,-112,112,1
"D16RT",141,559,"1200x900",1000,1,600,400,"True",641,244,230,-14,14,0
"D16RT",142,371,"1200x900",800,2,600,400,"False",730,560,391,-169,169,0
"D16RT",143,271,"1200x900",800,0,600,400,"True",74,360,382,22,22,1
"D16RT",144,17,"1200x900",600,0,600,400,"True",402,496,445,-51,51,1
"D16RT",145,642,"1200x900",1000,2,600,400,"False",776,316,428,112,112,0
"D16RT",146,7,"1200x900",600,0,600,400,"True",431,654,683,29,29,1
"D16RT",147,59,"1200x900",600,0,600,400,"True",391,692,706,14,14,1
"D16RT",148,348,"1200x900",800,1,600,400,"True",764,294,232,-62,62,0
"D16RT",149,409,"1200x900",800,2,600,400,"True",501,659,585,-74,74,0
"D16RT",150,581,"1200x900",1000,2,600,400,"False",310,357,541,184,184,0
"D16RT",151,485,"1200x900",1000,0,600,400,"True",121,694,657,-37,37,1
"D16RT",152,78,"1200x900",600,1,600,400,"False",885,684,850,166,166,0
"D16RT",153,151,"1200x900",600,2,600,400,"True",828,680,682,2,2,0
"D16RT",154,616,"1200x900",1000,2,600,400,"False",854,357,646,289,289,1
"D16RT",155,27,"1200x900",600,0,600,400,"True",373,309,235,-74,74,1
"D16RT",156,354,"1200x900",800,1,600,400,"True",118,236,311,75,75,0
"D16RT",157,611,"1200x900",1000,2,600,400,"False",414,511,602,91,91,0
"D16RT",158,392,"1200x900",800,2,600,400,"False",1031,618,480,-138,138,0
"D16RT",159,1,"1200x900",600,0,600,400,"True",136,502,455,-47,47,0
"D16RT",160,318,"1200x900",800,1,600,400,"True",788,534,557,23,23,0
"D16RT",161,44,"1200x900",600,0,600,400,"True",305,554,567,13,13,1
"D16RT",162,250,"1200x900",800,0,600,400,"True",290,248,271,23,23,1
"D16RT",163,194,"1200x900",600,2,600,400,"False",896,236,421,185,185,0
"D16RT",164,332,"1200x900",800,1,600,400,"False",260,699,510,-189,189,0
"D16RT",165,198,"1200x900",600,2,600,400,"False",976,500,357,-143,143,0
"D16RT",166,490,"1200x900",1000,0,600,400,"False",114,183,257,74,74,1
"D16RT",167,89,"1200x900",600,1,600,400,"False",917,366,572,206,206,1
"D16RT",168,209,"1200x900",600,2,600,400,"False",937,637,412,-225,225,0
"D16RT",169,26,"1200x900",600,0,600,400,"True",70,712,690,-22,22,0
"D16RT",170,143,"1200x900",600,1,600,400,"False",479,284,222,-62,62,1
"D16RT",171,162,"1200x900",600,2,600,400,"True",849,279,348,69,69,0
"D16RT",172,264,"1200x900",800,0,600,400,"True",198,660,689,29,29,1
"D16RT",173,217,"1200x900",800,0,600,400,"True",85,573,627,54,54,1
"D16RT",174,361,"1200x900",800,2,600,400,"False",931,328,616,288,288,0
"D16RT",175,633,"1200x900",1000,2,600,400,"False",564,253,338,85,85,0
"D16RT",176,440,"1200x900",1000,0,600,400,"True",71,237,180,-57,57,1
"D16RT",177,570,"1200x900",1000,1,600,400,"False",315,352,234,-118,118,0
"D16RT",178,47,"1200x900",600,0,600,400,"False",303,499,369,-130,130,1
"D16RT",179,374,"1200x900",800,2,600,400,"False",755,450,324,-126,126,0
"D16RT",180,303,"1200x900",800,1,600,400,"True",241,431,378,-53,53,0
"D16RT",181,480,"1200x900",1000,0,600,400,"True",100,231,228,-3,3,1
"D16RT",182,137,"1200x900",600,1,600,400,"True",789,577,516,-61,61,0
"D16RT",183,97,"1200x900",600,1,600,400,"False",760,643,721,78,78,1
"D16RT",184,270,"1200x900",800,0,600,400,"True",192,418,466,48,48,1
"D16RT",185,131,"1200x900",600,1,600,400,"False",531,367,562,195,195,0
"D16RT",186,567,"1200x900",1000,1,600,400,"False",655,297,713,416,416,1
"D16RT",187,100,"1200x900",600,1,600,400,"False",453,511,338,-173,173,0
"D16RT",188,187,"1200x900",600,2,600,400,"False",857,639,411,-228,228,0
"D16RT",189,370,"1200x900",800,2,600,400,"False",874,336,479,143,143,0
"D16RT",190,439,"1200x900",1000,0,600,400,"False",110,229,395,166,166,1
"D16RT",191,369,"1200x900",800,2,600,400,"False",903,594,314,-280,280,0
"D16RT",192,91,"1200x900",600,1,600,400,"True",417,630,560,-70,70,1
"D16RT",193,48,"1200x900",600,0,600,400,"True",323,645,694,49,49,1
"D16RT",194,396,"1200x900",800,2,600,400,"True",678,663,625,-38,38,0
"D16RT",195,422,"1200x900",800,2,600,400,"False",712,558,636,78,78,0
"D16RT",196,201,"1200x900",600,2,600,400,"True",1005,462,423,-39,39,0
"D16RT",197,612,"1200x900",1000,2,600,400,"False",706,198,320,122,122,0
"D16RT",198,646,"1200x900",1000,2,600,400,"False",829,227,451,224,224,1
"D16RT",199,528,"1200x900",1000,1,600,400,"False",839,227,348,121,121,1
"D16RT",200,128,"1200x900",600,1,600,400,"False",661,258,396,138,138,1
"D16RT",201,615,"1200x900",1000,2,600,400,"True",736,634,597,-37,37,0
"D16RT",202,343,"1200x900",800,1,600,400,"False",407,557,442,-115,115,0
"D16RT",204,438,"1200x900",1000,0,600,400,"True",77,713,675,-38,38,1
"D16RT",205,639,"1200x900",1000,2,600,400,"False",504,456,579,123,123,0
"D16RT",206,191,"1200x900",600,2,600,400,"False",962,396,538,142,142,0
"D16RT",207,285,"1200x900",800,0,600,400,"True",237,396,350,-46,46,1
"D16RT",208,77,"1200x900",600,1,600,400,"False",780,525,630,105,105,0
"D16RT",209,417,"1200x900",800,2,600,400,"False",750,280,421,141,141,0
"D16RT",210,41,"1200x900",600,0,600,400,"True",370,452,409,-43,43,1
"D16RT",211,65,"1200x900",600,0,600,400,"True",442,645,639,-6,6,1
"D16RT",212,31,"1200x900",600,0,600,400,"True",365,338,328,-10,10,1
"D16RT",213,106,"1200x900",600,1,600,400,"True",803,659,621,-38,38,1
"D16RT",214,139,"1200x900",600,1,600,400,"True",192,695,669,-26,26,0
"D16RT",215,196,"1200x900",600,2,600,400,"True",1030,397,346,-51,51,0
"D16RT",216,313,"1200x900",800,1,600,400,"True",588,421,441,20,20,0
"D16RT",217,118,"1200x900",600,1,600,400,"False",190,588,659,71,71,0
"D16RT",218,387,"1200x900",800,2,600,400,"False",990,444,315,-129,129,0
"D16RT",219,377,"1200x900",800,2,600,400,"False",683,388,507,119,119,0
"D16RT",220,453,"1200x900",1000,0,600,400,"False",71,393,201,-192,192,1
"D16RT",221,564,"1200x900",1000,1,600,400,"True",215,264,332,68,68,0
"D16RT",222,359,"1200x900",800,1,600,400,"False",653,241,368,127,127,0
"D16RT",223,114,"1200x900",600,1,600,400,"False",183,697,373,-324,324,0
"D16RT",224,329,"1200x900",800,1,600,400,"False",517,239,351,112,112,0
"D16RT",225,159,"1200x900",600,2,600,400,"True",992,309,358,49,49,0
"D16RT",226,502,"1200x900",1000,0,600,400,"True",111,639,613,-26,26,1
"D16RT",227,227,"1200x900",800,0,600,400,"True",196,551,545,-6,6,1
"D16RT",228,101,"1200x900",600,1,600,400,"False",541,656,769,113,113,0
"D16RT",229,405,"1200x900",800,2,600,400,"False",790,307,217,-90,90,0
"D16RT",230,102,"1200x900",600,1,600,400,"False",861,603,688,85,85,0
"D16RT",231,126,"1200x900",600,1,600,400,"False",849,354,560,206,206,0
"D16RT",232,154,"1200x900",600,2,600,400,"False",941,454,390,-64,64,0
"D16RT",233,534,"1200x900",1000,1,600,400,"True",328,504,469,-35,35,1
"D16RT",234,34,"1200x900",600,0,600,400,"True",361,242,259,17,17,1
"D16RT",235,287,"1200x900",800,0,600,400,"True",120,567,509,-58,58,1
"D16RT",236,258,"1200x900",800,0,600,400,"False",126,664,510,-154,154,1
"D16RT",237,276,"1200x900",800,0,600,400,"True",281,217,222,5,5,1
"D16RT",238,339,"1200x900",800,1,600,400,"True",273,545,575,30,30,1
"D16RT",239,16,"1200x900",600,0,600,400,"True",297,514,531,17,17,1
"D16RT",240,53,"1200x900",600,0,600,400,"True",177,189,217,28,28,0
"D16RT",241,9,"1200x900",600,0,600,400,"False",509,654,538,-116,116,1
"D16RT",242,535,"1200x900",1000,1,600,400,"False",372,410,293,-117,117,0
"D16RT",243,123,"1200x900",600,1,600,400,"False",761,365,565,200,200,1
"D16RT",244,609,"1200x900",1000,2,600,400,"False",697,627,470,-157,157,0
"D16RT",245,266,"1200x900",800,0,600,400,"False",126,303,225,-78,78,1
"D16RT",246,82,"1200x900",600,1,600,400,"True",108,213,255,42,42,0
"D16RT",247,580,"1200x900",1000,2,600,400,"False",651,267,380,113,113,0
"D16RT",248,13,"1200x900",600,0,600,400,"False",296,211,116,-95,95,1
"D16RT",249,45,"1200x900",600,0,600,400,"False",487,678,565,-113,113,1
"D16RT",250,199,"1200x900",600,2,600,400,"False",992,467,326,-141,141,0
"D16RT",251,52,"1200x900",600,0,600,400,"True",171,188,148,-40,40,0
"D16RT",252,189,"1200x900",600,2,600,400,"True",881,397,383,-14,14,0
"D16RT",253,73,"1200x900",600,1,600,400,"True",94,665,581,-84,84,0
"D16RT",254,366,"1200x900",800,2,600,400,"False",931,464,370,-94,94,0
"D16RT",255,504,"1200x900",1000,0,600,400,"True",107,699,673,-26,26,1
"D16RT",256,319,"1200x900",800,1,600,400,"False",494,587,653,66,66,1
"D16RT",257,350,"1200x900",800,1,600,400,"True",182,566,511,-55,55,0
"D16RT",258,24,"1200x900",600,0,600,400,"True",430,538,535,-3,3,1
"D16RT",259,314,"1200x900",800,1,600,400,"False",277,616,700,84,84,1
"D16RT",260,113,"1200x900",600,1,600,400,"False",897,657,738,81,81,0
"D16RT",261,617,"1200x900",1000,2,600,400,"False",294,180,468,288,288,0
"D16RT",262,586,"1200x900",1000,2,600,400,"False",802,262,369,107,107,0
"D16RT",263,358,"1200x900",800,1,600,400,"True",263,635,679,44,44,0
"D16RT",264,514,"1200x900",1000,1,600,400,"False",539,690,596,-94,94,0
"D16RT",265,225,"1200x900",800,0,600,400,"True",178,423,373,-50,50,1
"D16RT",266,19,"1200x900",600,0,600,400,"False",286,686,568,-118,118,0
"D16RT",267,647,"1200x900",1000,2,600,400,"False",560,637,463,-174,174,0
"D16RT",268,493,"1200x900",1000,0,600,400,"True",80,582,556,-26,26,1
"D16RT",269,608,"1200x900",1000,2,600,400,"True",742,250,274,24,24,0
"D16RT",270,253,"1200x900",800,0,600,400,"False",177,424,307,-117,117,1
"D16RT",271,255,"1200x900",800,0,600,400,"True",93,709,717,8,8,1
"D16RT",272,641,"1200x900",1000,2,600,400,"False",897,272,615,343,343,0
"D16RT",273,500,"1200x900",1000,0,600,400,"True",105,700,716,16,16,1
"D16RT",274,129,"1200x900",600,1,600,400,"False",859,482,394,-88,88,1
"D16RT",275,5,"1200x900",600,0,600,400,"True",228,587,541,-46,46,0
"D16RT",276,408,"1200x900",800,2,600,400,"False",758,567,484,-83,83,0
"D16RT",277,200,"1200x900",600,2,600,400,"True",897,302,255,-47,47,0
"D16RT",278,345,"1200x900",800,1,600,400,"True",841,566,483,-83,83,1
"D16RT",279,134,"1200x900",600,1,600,400,"False",300,188,468,280,280,0
"D16RT",280,30,"1200x900",600,0,600,400,"True",107,353,377,24,24,0
"D16RT",281,445,"1200x900",1000,0,600,400,"True",78,302,283,-19,19,1
"D16RT",282,452,"1200x900",1000,0,600,400,"True",97,273,292,19,19,1
"D16RT",283,477,"1200x900",1000,0,600,400,"True",88,640,630,-10,10,1
"D16RT",284,600,"1200x900",1000,2,600,400,"False",765,207,305,98,98,0
"D16RT",285,533,"1200x900",1000,1,600,400,"False",355,483,258,-225,225,0
"D16RT",286,223,"1200x900",800,0,600,400,"True",179,191,202,11,11,1
"D16RT",287,605,"1200x900",1000,2,600,400,"False",493,665,330,-335,335,0
"D16RT",288,630,"1200x900",1000,2,600,400,"False",754,559,331,-228,228,0
"D16RT",289,407,"1200x900",800,2,600,400,"False",989,340,274,-66,66,0
"D16RT",290,592,"1200x900",1000,2,600,400,"True",492,392,388,-4,4,0
"D16RT",291,441,"1200x900",1000,0,600,400,"True",85,684,638,-46,46,1
"D16RT",292,525,"1200x900",1000,1,600,400,"False",123,690,440,-250,250,0
"D16RT",293,541,"1200x900",1000,1,600,400,"True",339,478,459,-19,19,0
"D16RT",294,193,"1200x900",600,2,600,400,"False",874,588,430,-158,158,0
"D16RT",295,157,"1200x900",600,2,600,400,"False",1016,323,445,122,122,0
"D16RT",296,39,"1200x900",600,0,600,400,"False",210,609,480,-129,129,0
"D16RT",297,588,"1200x900",1000,2,600,400,"False",585,350,287,-63,63,0
"D16RT",298,327,"1200x900",800,1,600,400,"True",152,339,307,-32,32,0
"D16RT",299,437,"1200x900",1000,0,600,400,"True",74,667,617,-50,50,1
"D16RT",300,455,"1200x900",1000,0,600,400,"False",107,718,637,-81,81,1
"D16RT",301,398,"1200x900",800,2,600,400,"False",944,698,382,-316,316,0
"D16RT",302,568,"1200x900",1000,1,600,400,"False",286,475,552,77,77,1
"D16RT",303,613,"1200x900",1000,2,600,400,"True",690,374,335,-39,39,0
"D16RT",304,372,"1200x900",800,2,600,400,"False",833,620,360,-260,260,0
"D16RT",305,72,"1200x900",600,0,600,400,"True",158,537,515,-22,22,0
"D16RT",306,373,"1200x900",800,2,600,400,"False",694,326,492,166,166,0
"D16RT",307,168,"1200x900",600,2,600,400,"True",1001,439,384,-55,55,0
"D16RT",308,207,"1200x900",600,2,600,400,"False",838,235,357,122,122,0
"D16RT",309,184,"1200x900",600,2,600,400,"True",1067,441,452,11,11,0
"D16RT",310,548,"1200x900",1000,1,600,400,"True",103,278,272,-6,6,0
"D16RT",312,231,"1200x900",800,0,600,400,"False",251,718,650,-68,68,1
"D16RT",313,46,"1200x900",600,0,600,400,"True",193,355,373,18,18,1
"D16RT",314,4,"1200x900",600,0,600,400,"False",602,200,292,92,92,1
"D16RT",315,195,"1200x900",600,2,600,400,"True",942,249,207,-42,42,0
"D16RT",316,155,"1200x900",600,2,600,400,"False",940,269,358,89,89,0
"D16RT",317,307,"1200x900",800,1,600,400,"True",716,247,184,-63,63,0
"D16RT",318,38,"1200x900",600,0,600,400,"True",120,628,685,57,57,1
"D16RT",319,467,"1200x900",1000,0,600,400,"True",74,712,724,12,12,1
"D16RT",320,66,"1200x900",600,0,600,400,"True",155,673,665,-8,8,0
"D16RT",321,74,"1200x900",600,1,600,400,"True",115,358,318,-40,40,0
"D16RT",322,67,"1200x900",600,0,600,400,"True",289,308,324,16,16,1
"D16RT",323,293,"1200x900",800,1,600,400,"True",561,396,402,6,6,0
"D16RT",324,277,"1200x900",800,0,600,400,"False",140,310,177,-133,133,1
"D16RT",325,513,"1200x900",1000,1,600,400,"True",235,602,599,-3,3,0
"D16RT",326,176,"1200x900",600,2,600,400,"True",1033,281,260,-21,21,0
"D16RT",327,648,"1200x900",1000,2,600,400,"False",557,394,234,-160,160,0
"D16RT",328,21,"1200x900",600,0,600,400,"True",314,383,324,-59,59,1
"D16RT",329,632,"1200x900",1000,2,600,400,"False",984,227,620,393,393,0
"D16RT",330,450,"1200x900",1000,0,600,400,"True",130,204,188,-16,16,1
"D16RT",331,458,"1200x900",1000,0,600,400,"True",78,624,603,-21,21,1
"D16RT",332,286,"1200x900",800,0,600,400,"True",105,378,403,25,25,1
"D16RT",333,62,"1200x900",600,0,600,400,"True",345,346,359,13,13,1
"D16RT",334,474,"1200x900",1000,0,600,400,"True",85,339,274,-65,65,1
"D16RT",335,84,"1200x900",600,1,600,400,"False",144,184,288,104,104,0
"D16RT",336,320,"1200x900",800,1,600,400,"True",644,376,389,13,13,0
"D16RT",337,334,"1200x900",800,1,600,400,"True",481,665,700,35,35,0
"D16RT",338,463,"1200x900",1000,0,600,400,"True",115,693,763,70,70,1
"D16RT",339,508,"1200x900",1000,1,600,400,"True",596,485,458,-27,27,0
"D16RT",340,122,"1200x900",600,1,600,400,"True",817,709,735,26,26,0
"D16RT",341,33,"1200x900",600,0,600,400,"True",198,533,563,30,30,1
"D16RT",342,69,"1200x900",600,0,600,400,"True",322,268,251,-17,17,0
"D16RT",343,475,"1200x900",1000,0,600,400,"True",101,715,689,-26,26,1
"D16RT",344,63,"1200x900",600,0,600,400,"True",311,188,169,-19,19,1
"D16RT",345,436,"1200x900",1000,0,600,400,"True",82,617,569,-48,48,1
"D16RT",346,589,"1200x900",1000,2,600,400,"False",856,418,288,-130,130,0
"D16RT",347,144,"1200x900",600,1,600,400,"False",718,371,553,182,182,0
"D16RT",348,133,"1200x900",600,1,600,400,"True",345,551,472,-79,79,0
"D16RT",349,259,"1200x900",800,0,600,400,"True",156,180,213,33,33,1
"D16RT",350,368,"1200x900",800,2,600,400,"True",778,515,598,83,83,0
"D16RT",351,83,"1200x900",600,1,600,400,"True",763,568,563,-5,5,1
"D16RT",352,202,"1200x900",600,2,600,400,"True",966,460,539,79,79,0
"D16RT",353,428,"1200x900",800,2,600,400,"False",732,665,449,-216,216,0
"D16RT",354,292,"1200x900",800,1,600,400,"False",88,565,642,77,77,0
"D16RT",355,175,"1200x900",600,2,600,400,"True",1028,432,472,40,40,0
"D16RT",356,578,"1200x900",1000,2,600,400,"False",966,276,421,145,145,0
"D16RT",357,603,"1200x900",1000,2,600,400,"False",693,280,454,174,174,0
"D16RT",358,163,"1200x900",600,2,600,400,"True",1046,665,567,-98,98,0
"D16RT",359,643,"1200x900",1000,2,600,400,"True",740,325,359,34,34,0
"D16RT",360,584,"1200x900",1000,2,600,400,"False",731,413,298,-115,115,0
"D16RT",361,330,"1200x900",800,1,600,400,"False",759,301,442,141,141,1
"D16RT",362,15,"1200x900",600,0,600,400,"True",473,352,306,-46,46,1
"D16RT",363,448,"1200x900",1000,0,600,400,"False",107,641,531,-110,110,1
"D16RT",364,624,"1200x900",1000,2,600,400,"True",693,501,455,-46,46,0
"D16RT",365,529,"1200x900",1000,1,600,400,"True",267,412,417,5,5,1
"D16RT",366,431,"1200x900",800,2,600,400,"True",694,382,341,-41,41,0
"D16RT",368,87,"1200x900",600,1,600,400,"False",231,604,496,-108,108,0
"D16RT",369,344,"1200x900",800,1,600,400,"True",589,408,446,38,38,0
"D16RT",370,311,"1200x900",800,1,600,400,"False",710,261,518,257,257,0
"D16RT",371,349,"1200x900",800,1,600,400,"False",402,665,739,74,74,0
"D16RT",372,213,"1200x900",600,2,600,400,"True",822,275,320,45,45,0
"D16RT",373,421,"1200x900",800,2,600,400,"False",898,394,260,-134,134,0
"D16RT",374,512,"1200x900",1000,1,600,400,"False",139,261,491,230,230,0
"D16RT",375,482,"1200x900",1000,0,600,400,"False",79,686,615,-71,71,1
"D16RT",376,492,"1200x900",1000,0,600,400,"True",76,692,667,-25,25,1
"D16RT",377,68,"1200x900",600,0,600,400,"True",165,367,402,35,35,0
"D16RT",378,449,"1200x900",1000,0,600,400,"True",105,683,631,-52,52,1
"D16RT",379,211,"1200x900",600,2,600,400,"True",986,407,357,-50,50,0
"D16RT",380,121,"1200x900",600,1,600,400,"False",884,364,458,94,94,0
"D16RT",381,501,"1200x900",1000,0,600,400,"False",96,323,400,77,77,1
"D16RT",382,11,"1200x900",600,0,600,400,"False",372,670,592,-78,78,1
"D16RT",383,81,"1200x900",600,1,600,400,"True",696,225,258,33,33,0
"D16RT",384,32,"1200x900",600,0,600,400,"False",152,563,658,95,95,1
"D16RT",385,284,"1200x900",800,0,600,400,"False",135,293,388,95,95,1
"D16RT",386,272,"1200x900",800,0,600,400,"True",200,181,119,-62,62,1
"D16RT",387,380,"1200x900",800,2,600,400,"True",942,228,214,-14,14,0
"D16RT",388,401,"1200x900",800,2,600,400,"True",821,260,251,-9,9,0
"D16RT",389,309,"1200x900",800,1,600,400,"True",186,225,189,-36,36,0
"D16RT",390,192,"1200x900",600,2,600,400,"False",1064,320,170,-150,150,0
"D16RT",391,562,"1200x900",1000,1,600,400,"True",347,540,591,51,51,0
"D16RT",392,273,"1200x900",800,0,600,400,"True",180,309,348,39,39,1
"D16RT",393,506,"1200x900",1000,1,600,400,"True",559,567,575,8,8,1
"D16RT",394,278,"1200x900",800,0,600,400,"False",251,711,628,-83,83,1
"D16RT",395,522,"1200x900",1000,1,600,400,"True",223,379,285,-94,94,0
"D16RT",396,425,"1200x900",800,2,600,400,"True",621,438,415,-23,23,0
"D16RT",397,462,"1200x900",1000,0,600,400,"True",102,672,736,64,64,1
"D16RT",398,489,"1200x900",1000,0,600,400,"True",88,604,649,45,45,1
"D16RT",399,621,"1200x900",1000,2,600,400,"False",540,478,396,-82,82,0
"D16RT",400,183,"1200x900",600,2,600,400,"True",927,289,333,44,44,0
"D16RT",401,297,"1200x900",800,1,600,400,"False",625,244,353,109,109,0
"D16RT",402,261,"1200x900",800,0,600,400,"True",86,713,744,31,31,1
"D16RT",403,606,"1200x900",1000,2,600,400,"True",653,627,551,-76,76,0
"D16RT",404,545,"1200x900",1000,1,600,400,"True",358,562,555,-7,7,0
"D16RT",405,473,"1200x900",1000,0,600,400,"False",75,323,465,142,142,1
"D16RT",406,530,"1200x900",1000,1,600,400,"False",584,405,522,117,117,1
"D16RT",407,90,"1200x900",600,1,600,400,"False",560,474,289,-185,185,0
"D16RT",408,55,"1200x900",600,0,600,400,"True",211,305,361,56,56,1
"D16RT",409,93,"1200x900",600,1,600,400,"False",139,540,629,89,89,0
"D16RT",410,116,"1200x900",600,1,600,400,"False",767,289,513,224,224,0
"D16RT",411,18,"1200x900",600,0,600,400,"True",400,318,348,30,30,1
"D16RT",412,178,"1200x900",600,2,600,400,"False",1041,510,275,-235,235,0
"D16RT",413,96,"1200x900",600,1,600,400,"True",433,458,477,19,19,0
"D16RT",414,426,"1200x900",800,2,600,400,"False",830,263,417,154,154,0
"D16RT",415,150,"1200x900",600,2,600,400,"False",897,345,277,-68,68,0
"D16RT",416,64,"1200x900",600,0,600,400,"True",102,339,331,-8,8,0
"D16RT",417,488,"1200x900",1000,0,600,400,"True",129,687,739,52,52,1
"D16RT",418,161,"1200x900",600,2,600,400,"False",939,553,667,114,114,0
"D16RT",419,614,"1200x900",1000,2,600,400,"False",823,563,434,-129,129,0
"D16RT",420,112,"1200x900",600,1,600,400,"False",681,490,382,-108,108,0
"D16RT",421,472,"1200x900",1000,0,600,400,"True",77,685,744,59,59,1
"D16RT",422,138,"1200x900",600,1,600,400,"False",844,580,674,94,94,1
"D16RT",423,532,"1200x900",1000,1,600,400,"False",215,207,401,194,194,0
"D16RT",424,206,"1200x900",600,2,600,400,"True",975,223,304,81,81,0
"D16RT",425,397,"1200x900",800,2,600,400,"False",817,692,527,-165,165,0
"D16RT",426,446,"1200x900",1000,0,600,400,"True",72,298,232,-66,66,1
"D16RT",427,634,"1200x900",1000,2,600,400,"False",735,313,406,93,93,0
"D16RT",428,560,"1200x900",1000,1,600,400,"True",516,693,753,60,60,0
"D16RT",429,538,"1200x900",1000,1,600,400,"True",308,457,419,-38,38,1
"D16RT",430,8,"1200x900",600,0,600,400,"False",156,679,571,-108,108,0
"D16RT",431,607,"1200x900",1000,2,600,400,"True",900,573,478,-95,95,1
"D16RT",432,338,"1200x900",800,1,600,400,"True",813,253,312,59,59,1
"D16RT",433,98,"1200x900",600,1,600,400,"True",625,530,506,-24,24,0
"D16RT",434,465,"1200x900",1000,0,600,400,"False",85,203,301,98,98,1
"D16RT",435,619,"1200x900",1000,2,600,400,"True",803,247,283,36,36,0
"D16RT",436,591,"1200x900",1000,2,600,400,"False",698,336,423,87,87,0
"D16RT",437,169,"1200x900",600,2,600,400,"True",924,290,370,80,80,0
"D16RT",438,598,"1200x900",1000,2,600,400,"False",706,559,386,-173,173,0
"D16RT",439,257,"1200x900",800,0,600,400,"True",97,219,156,-63,63,1
"D16RT",440,442,"1200x900",1000,0,600,400,"False",87,183,305,122,122,1
"D16RT",441,142,"1200x900",600,1,600,400,"False",286,474,536,62,62,0
"D16RT",442,509,"1200x900",1000,1,600,400,"True",509,434,452,18,18,0
"D16RT",443,336,"1200x900",800,1,600,400,"True",251,587,616,29,29,0
"D16RT",444,182,"1200x900",600,2,600,400,"False",933,389,247,-142,142,0
"D16RT",445,622,"1200x900",1000,2,600,400,"False",307,683,382,-301,301,0
"D16RT",446,242,"1200x900",800,0,600,400,"True",117,448,423,-25,25,1
"D16RT",447,637,"1200x900",1000,2,600,400,"True",750,460,399,-61,61,0
"D16RT",448,551,"1200x900",1000,1,600,400,"True",146,445,501,56,56,1
"D16RT",449,324,"1200x900",800,1,600,400,"False",719,712,438,-274,274,1
"D16RT",450,239,"1200x900",800,0,600,400,"True",114,231,211,-20,20,1
"D16RT",451,498,"1200x900",1000,0,600,400,"True",100,260,184,-76,76,1
"D16RT",452,579,"1200x900",1000,2,600,400,"False",803,394,451,57,57,0
"D16RT",453,628,"1200x900",1000,2,600,400,"False",768,410,514,104,104,0
"D16RT",454,360,"1200x900",800,1,600,400,"True",203,608,586,-22,22,0
"D16RT",455,212,"1200x900",600,2,600,400,"False",841,206,371,165,165,0
"D16RT",456,427,"1200x900",800,2,600,400,"True",812,380,404,24,24,0
"D16RT",457,451,"1200x900",1000,0,600,400,"True",110,702,746,44,44,1
"D16RT",458,146,"1200x900",600,2,600,400,"True",989,492,452,-40,40,0
"D16RT",459,393,"1200x900",800,2,600,400,"False",657,620,340,-280,280,0
"D16RT",460,322,"1200x900",800,1,600,400,"False",703,206,323,117,117,1
"D16RT",461,640,"1200x900",1000,2,600,400,"True",361,334,304,-30,30,0
"D16RT",462,220,"1200x900",800,0,600,400,"True",108,699,700,1,1,1
"D16RT",463,321,"1200x900",800,1,600,400,"True",601,190,231,41,41,0
"D16RT",464,215,"1200x900",600,2,600,400,"False",939,596,421,-175,175,0
"D16RT",465,124,"1200x900",600,1,600,400,"True",345,467,513,46,46,0
"D16RT",466,447,"1200x900",1000,0,600,400,"False",71,339,256,-83,83,1
"D16RT",467,376,"1200x900",800,2,600,400,"True",788,275,321,46,46,0
"D16RT",468,420,"1200x900",800,2,600,400,"False",519,223,354,131,131,0
"D16RT",469,638,"1200x900",1000,2,600,400,"False",385,198,392,194,194,0
"D16RT",470,523,"1200x900",1000,1,600,400,"True",339,318,368,50,50,0
"D16RT",471,466,"1200x900",1000,0,600,400,"True",82,205,162,-43,43,1
"D16RT",472,577,"1200x900",1000,2,600,400,"False",455,420,295,-125,125,0
"D16RT",473,104,"1200x900",600,1,600,400,"False",448,584,715,131,131,0
"D16RT",474,429,"1200x900",800,2,600,400,"False",682,692,533,-159,159,0
"D16RT",475,170,"1200x900",600,2,600,400,"False",996,468,398,-70,70,0
"D16RT",476,625,"1200x900",1000,2,600,400,"True",279,228,271,43,43,0
"D16RT",477,520,"1200x900",1000,1,600,400,"True",564,260,299,39,39,0
"D16RT",478,386,"1200x900",800,2,600,400,"True",774,301,354,53,53,0
"D16RT",479,337,"1200x900",800,1,600,400,"False",299,622,421,-201,201,0
"D16RT",480,626,"1200x900",1000,2,600,400,"True",329,449,494,45,45,0
"D16RT",481,550,"1200x900",1000,1,600,400,"False",301,459,582,123,123,0
"D16RT",482,362,"1200x900",800,2,600,400,"False",819,338,464,126,126,0
"D16RT",483,229,"1200x900",800,0,600,400,"True",117,697,682,-15,15,1
"D16RT",484,208,"1200x900",600,2,600,400,"True",946,399,456,57,57,0
"D16RT",485,644,"1200x900",1000,2,600,400,"False",495,486,401,-85,85,0
"D16RT",486,432,"1200x900",800,2,600,400,"True",792,380,337,-43,43,0
"D16RT",487,471,"1200x900",1000,0,600,400,"False",122,200,122,-78,78,1
"D16RT",488,585,"1200x900",1000,2,600,400,"False",698,688,492,-196,196,1
"D16RT",489,571,"1200x900",1000,1,600,400,"True",239,522,506,-16,16,1
"D16RT",490,57,"1200x900",600,0,600,400,"True",354,508,501,-7,7,1
"D16RT",491,527,"1200x900",1000,1,600,400,"False",565,601,448,-153,153,0
"D16RT",492,540,"1200x900",1000,1,600,400,"False",389,568,325,-243,243,1
"D16RT",493,454,"1200x900",1000,0,600,400,"False",78,687,814,127,127,1
"D16RT",494,149,"1200x900",600,2,600,400,"True",890,289,355,66,66,0
"D16RT",495,484,"1200x900",1000,0,600,400,"True",100,223,172,-51,51,1
"D16RT",496,394,"1200x900",800,2,600,400,"False",847,292,366,74,74,0
"D16RT",497,43,"1200x900",600,0,600,400,"True",277,446,463,17,17,1
"D16RT",498,561,"1200x900",1000,1,600,400,"False",231,406,509,103,103,0
"D16RT",499,304,"1200x900",800,1,600,400,"False",667,605,321,-284,284,0
"D16RT",500,76,"1200x900",600,1,600,400,"True",647,614,520,-94,94,0
"D16RT",501,340,"1200x900",800,1,600,400,"True",226,240,248,8,8,0
"D16RT",502,388,"1200x900",800,2,600,400,"False",930,320,473,153,153,0
"D16RT",503,629,"1200x900",1000,2,600,400,"True",681,257,298,41,41,0
"D16RT",504,310,"1200x900",800,1,600,400,"True",559,592,532,-60,60,0
"D16RT",505,402,"1200x900",800,2,600,400,"True",878,234,257,23,23,0
"D16RT",506,316,"1200x900",800,1,600,400,"False",362,319,448,129,129,0
"D16RT",507,419,"1200x900",800,2,600,400,"True",769,351,327,-24,24,0
"D16RT",508,410,"1200x900",800,2,600,400,"False",916,477,262,-215,215,0
"D16RT",509,301,"1200x900",800,1,600,400,"False",162,574,844,270,270,0
"D16RT",510,491,"1200x900",1000,0,600,400,"False",108,198,321,123,123,1
"D16RT",511,216,"1200x900",600,2,600,400,"True",1029,286,231,-55,55,0
"D16RT",512,117,"1200x900",600,1,600,400,"False",711,456,345,-111,111,0
"D16RT",513,623,"1200x900",1000,2,600,400,"False",636,527,292,-235,235,0
"D16RT",514,85,"1200x900",600,1,600,400,"False",434,347,440,93,93,0
"D16RT",515,95,"1200x900",600,1,600,400,"False",749,425,256,-169,169,1
"D16RT",516,326,"1200x900",800,1,600,400,"True",103,482,408,-74,74,0
"D16RT",517,583,"1200x900",1000,2,600,400,"False",949,284,413,129,129,1
"D16RT",518,20,"1200x900",600,0,600,400,"True",204,545,525,-20,20,1
"D16RT",519,241,"1200x900",800,0,600,400,"False",129,227,293,66,66,1
"D16RT",520,145,"1200x900",600,2,600,400,"False",1004,630,427,-203,203,0
"D16RT",521,232,"1200x900",800,0,600,400,"True",84,511,486,-25,25,1
"D16RT",522,478,"1200x900",1000,0,600,400,"False",79,672,587,-85,85,1
"D16RT",523,604,"1200x900",1000,2,600,400,"True",459,593,540,-53,53,0
"D16RT",524,274,"1200x900",800,0,600,400,"True",146,497,553,56,56,1
"D16RT",525,399,"1200x900",800,2,600,400,"True",603,602,528,-74,74,0
"D16RT",526,132,"1200x900",600,1,600,400,"False",333,185,373,188,188,0
"D16RT",527,507,"1200x900",1000,1,600,400,"False",608,583,422,-161,161,1
"D16RT",528,510,"1200x900",1000,1,600,400,"True",486,338,429,91,91,1
"D16RT",529,594,"1200x900",1000,2,600,400,"True",537,637,645,8,8,0
"D16RT",530,574,"1200x900",1000,1,600,400,"False",614,194,403,209,209,0
"D16RT",531,620,"1200x900",1000,2,600,400,"False",832,649,590,-59,59,0
"D16RT",532,167,"1200x900",600,2,600,400,"False",956,241,413,172,172,0
"D16RT",533,147,"1200x900",600,2,600,400,"False",942,418,356,-62,62,0
"D16RT",534,553,"1200x900",1000,1,600,400,"True",116,712,711,-1,1,0
"D16RT",535,418,"1200x900",800,2,600,400,"True",754,507,466,-41,41,0
"D16RT",536,347,"1200x900",800,1,600,400,"True",757,295,247,-48,48,1
"D16RT",537,234,"1200x900",800,0,600,400,"True",72,344,289,-55,55,1
"D16RT",538,25,"1200x900",600,0,600,400,"True",263,403,396,-7,7,1
"D16RT",539,246,"1200x900",800,0,600,400,"True",196,418,403,-15,15,1
"D16RT",540,35,"1200x900",600,0,600,400,"True",366,555,539,-16,16,1
"D16RT",541,333,"1200x900",800,1,600,400,"False",521,548,690,142,142,0
"D16RT",542,283,"1200x900",800,0,600,400,"True",90,264,321,57,57,1
"D16RT",543,565,"1200x900",1000,1,600,400,"True",451,562,559,-3,3,0
"D16RT",544,503,"1200x900",1000,0,600,400,"False",86,279,437,158,158,1
"D16RT",545,395,"1200x900",800,2,600,400,"True",743,334,376,42,42,0
"D16RT",546,61,"1200x900",600,0,600,400,"True",272,670,636,-34,34,1
"D16RT",547,556,"1200x900",1000,1,600,400,"False",415,420,656,236,236,0
"D16RT",548,245,"1200x900",800,0,600,400,"False",296,235,372,137,137,1
"D16RT",549,378,"1200x900",800,2,600,400,"False",1018,708,477,-231,231,0
"D16RT",550,384,"1200x900",800,2,600,400,"False",821,707,495,-212,212,0
"D16RT",552,289,"1200x900",800,1,600,400,"False",421,703,567,-136,136,1
"D16RT",553,103,"1200x900",600,1,600,400,"True",528,320,302,-18,18,1
"D16RT",554,50,"1200x900",600,0,600,400,"True",75,582,560,-22,22,0
"D16RT",555,595,"1200x900",1000,2,600,400,"False",687,640,340,-300,300,0
"D16RT",556,499,"1200x900",1000,0,600,400,"True",93,271,271,0,0,1
"D16RT",557,601,"1200x900",1000,2,600,400,"False",735,697,407,-290,290,0
"D16RT",558,94,"1200x900",600,1,600,400,"True",729,482,519,37,37,0
"D16RT",559,356,"1200x900",800,1,600,400,"False",123,484,644,160,160,0
"D16RT",560,174,"1200x900",600,2,600,400,"True",998,457,438,-19,19,0
"D16RT",561,166,"1200x900",600,2,600,400,"True",896,274,352,78,78,0
"D16RT",562,214,"1200x900",600,2,600,400,"False",1046,305,237,-68,68,0
"D16RT",563,120,"1200x900",600,1,600,400,"True",690,655,607,-48,48,0
"D16RT",564,308,"1200x900",800,1,600,400,"True",437,425,444,19,19,0
"D16RT",565,14,"1200x900",600,0,600,400,"True",399,224,264,40,40,1
"D16RT",566,515,"1200x900",1000,1,600,400,"False",307,217,338,121,121,0
"D16RT",567,148,"1200x900",600,2,600,400,"True",907,330,364,34,34,0
"D16RT",568,434,"1200x900",1000,0,600,400,"False",89,657,569,-88,88,1
"D16RT",569,109,"1200x900",600,1,600,400,"False",691,589,508,-81,81,0
"D16RT",570,468,"1200x900",1000,0,600,400,"False",121,219,336,117,117,1
"D16RT",571,237,"1200x900",800,0,600,400,"True",204,481,504,23,23,1
"D16RT",572,252,"1200x900",800,0,600,400,"True",224,673,634,-39,39,1
"D16RT",573,461,"1200x900",1000,0,600,400,"True",95,711,745,34,34,1
"D16RT",574,12,"1200x900",600,0,600,400,"False",365,336,475,139,139,1
"D16RT",575,173,"1200x900",600,2,600,400,"True",948,693,627,-66,66,0
"D16RT",576,42,"1200x900",600,0,600,400,"True",233,479,470,-9,9,0
"D16RT",577,224,"1200x900",800,0,600,400,"True",161,474,511,37,37,1
"D16RT",578,36,"1200x900",600,0,600,400,"True",128,346,390,44,44,1
"D16RT",579,299,"1200x900",800,1,600,400,"False",779,274,347,73,73,0
"D16RT",580,414,"1200x900",800,2,600,400,"True",831,592,526,-66,66,0
"D16RT",581,70,"1200x900",600,0,600,400,"True",309,703,695,-8,8,1
"D16RT",582,6,"1200x900",600,0,600,400,"False",217,689,620,-69,69,1
"D16RT",583,590,"1200x900",1000,2,600,400,"False",636,278,442,164,164,0
"D16RT",584,443,"1200x900",1000,0,600,400,"True",99,651,673,22,22,1
"D16RT",585,351,"1200x900",800,1,600,400,"False",122,581,682,101,101,0
"D16RT",586,636,"1200x900",1000,2,600,400,"True",575,583,555,-28,28,0
"D16RT",587,391,"1200x900",800,2,600,400,"True",895,521,493,-28,28,0
"D16RT",588,355,"1200x900",800,1,600,400,"False",77,386,563,177,177,0
"D16RT",589,423,"1200x900",800,2,600,400,"True",1051,710,633,-77,77,1
"D16RT",590,531,"1200x900",1000,1,600,400,"False",233,362,731,369,369,0
"D16RT",591,597,"1200x900",1000,2,600,400,"True",352,239,217,-22,22,0
"D16RT",592,60,"1200x900",600,0,600,400,"True",365,213,209,-4,4,1
"D16RT",593,236,"1200x900",800,0,600,400,"False",162,350,274,-76,76,1
"D16RT",594,544,"1200x900",1000,1,600,400,"True",602,620,681,61,61,0
"D16RT",595,404,"1200x900",800,2,600,400,"True",842,396,375,-21,21,0
"D16RT",596,390,"1200x900",800,2,600,400,"True",982,674,712,38,38,1
"D16RT",597,331,"1200x900",800,1,600,400,"False",240,620,434,-186,186,0
"D16RT",598,51,"1200x900",600,0,600,400,"True",272,181,202,21,21,1
"D16RT",599,158,"1200x900",600,2,600,400,"False",939,300,188,-112,112,0
"D16RT",600,248,"1200x900",800,0,600,400,"False",94,240,109,-131,131,1
"D16RT",601,543,"1200x900",1000,1,600,400,"False",88,202,424,222,222,0
"D16RT",602,610,"1200x900",1000,2,600,400,"True",702,293,315,22,22,0
"D16RT",603,389,"1200x900",800,2,600,400,"False",843,530,322,-208,208,0
"D16RT",604,554,"1200x900",1000,1,600,400,"False",79,309,417,108,108,1
"D16RT",605,28,"1200x900",600,0,600,400,"True",336,410,453,43,43,1
"D16RT",606,172,"1200x900",600,2,600,400,"False",912,444,352,-92,92,0
"D16RT",607,244,"1200x900",800,0,600,400,"True",194,203,234,31,31,1
"D16RT",608,111,"1200x900",600,1,600,400,"False",922,552,715,163,163,1
"D16RT",609,233,"1200x900",800,0,600,400,"True",164,700,703,3,3,1
"D16RT",610,280,"1200x900",800,0,600,400,"True",104,302,320,18,18,1
"D16RT",611,618,"1200x900",1000,2,600,400,"False",276,671,506,-165,165,0
"D16RT",612,518,"1200x900",1000,1,600,400,"True",583,717,670,-47,47,0
"D16RT",613,464,"1200x900",1000,0,600,400,"True",82,222,216,-6,6,1
"D16RT",614,302,"1200x900",800,1,600,400,"False",479,467,552,85,85,1
"D16RT",615,300,"1200x900",800,1,600,400,"True",620,693,732,39,39,0
"D16RT",616,526,"1200x900",1000,1,600,400,"True",497,710,658,-52,52,0
"D16RT",617,240,"1200x900",800,0,600,400,"True",330,656,648,-8,8,1
"D16RT",618,328,"1200x900",800,1,600,400,"True",104,649,643,-6,6,0
"D16RT",619,238,"1200x900",800,0,600,400,"True",162,283,340,57,57,1
"D16RT",620,495,"1200x900",1000,0,600,400,"False",93,692,594,-98,98,1
"D16RT",621,235,"1200x900",800,0,600,400,"True",146,646,651,5,5,1
"D16RT",622,247,"1200x900",800,0,600,400,"True",160,424,421,-3,3,1
"D16RT",623,275,"1200x900",800,0,600,400,"True",120,594,608,14,14,0
"D16RT",624,555,"1200x900",1000,1,600,400,"False",444,556,467,-89,89,0
"D16RT",625,108,"1200x900",600,1,600,400,"False",830,239,531,292,292,0
"D16RT",626,573,"1200x900",1000,1,600,400,"True",486,615,587,-28,28,0
"D16RT",627,269,"1200x900",800,0,600,400,"True",160,295,361,66,66,1
"D16RT",628,71,"1200x900",600,0,600,400,"True",219,248,194,-54,54,0
"D16RT",629,413,"1200x900",800,2,600,400,"True",849,506,504,-2,2,0
"D16RT",630,294,"1200x900",800,1,600,400,"True",262,287,334,47,47,0
"D16RT",631,524,"1200x900",1000,1,600,400,"False",534,470,245,-225,225,0
"D16RT",632,156,"1200x900",600,2,600,400,"True",913,197,253,56,56,0
"D16RT",633,315,"1200x900",800,1,600,400,"False",105,211,513,302,302,0
"D16RT",634,115,"1200x900",600,1,600,400,"False",545,307,492,185,185,0
"D16RT",635,375,"1200x900",800,2,600,400,"False",716,384,322,-62,62,0
"D16RT",636,230,"1200x900",800,0,600,400,"True",99,678,715,37,37,1
"D16RT",637,290,"1200x900",800,1,600,400,"False",789,603,729,126,126,0
"D16RT",638,382,"1200x900",800,2,600,400,"True",870,523,498,-25,25,0
"D16RT",639,444,"1200x900",1000,0,600,400,"True",101,714,776,62,62,1
"D16RT",640,497,"1200x900",1000,0,600,400,"False",106,696,795,99,99,1
"D16RT",641,243,"1200x900",800,0,600,400,"True",114,332,358,26,26,1
"D16RT",642,486,"1200x900",1000,0,600,400,"False",102,676,591,-85,85,1
"D16RT",643,298,"1200x900",800,1,600,400,"True",311,457,435,-22,22,0
"D16RT",644,88,"1200x900",600,1,600,400,"True",186,554,587,33,33,0
"D16RT",645,141,"1200x900",600,1,600,400,"False",671,582,749,167,167,0
"D16RT",646,165,"1200x900",600,2,600,400,"True",912,554,605,51,51,0
"D16RT",647,323,"1200x900",800,1,600,400,"False",388,348,478,130,130,0
"D16RT",648,135,"1200x900",600,1,600,400,"True",759,569,565,-4,4,0
"D17JO",1,326,"1200x900",800,1,600,400,"False",103,482,224,-258,258,0
"D17JO",2,248,"1200x900",800,0,600,400,"True",94,240,252,12,12,1
"D17JO",3,424,"1200x900",800,2,600,400,"False",903,545,239,-306,306,0
"D17JO",4,257,"1200x900",800,0,600,400,"True",97,219,235,16,16,1
"D17JO",5,279,"1200x900",800,0,600,400,"False",252,202,391,189,189,1
"D17JO",6,416,"1200x900",800,2,600,400,"False",748,617,457,-160,160,0
"D17JO",7,614,"1200x900",1000,2,600,400,"True",823,563,580,17,17,0
"D17JO",8,569,"1200x900",1000,1,600,400,"True",494,720,699,-21,21,0
"D17JO",9,87,"1200x900",600,1,600,400,"False",231,604,163,-441,441,0
"D17JO",10,17,"1200x900",600,0,600,400,"False",402,496,606,110,110,1
"D17JO",11,183,"1200x900",600,2,600,400,"False",927,289,125,-164,164,0
"D17JO",12,172,"1200x900",600,2,600,400,"False",912,444,300,-144,144,0
"D17JO",13,397,"1200x900",800,2,600,400,"False",817,692,330,-362,362,0
"D17JO",14,138,"1200x900",600,1,600,400,"False",844,580,850,270,270,1
"D17JO",15,639,"1200x900",1000,2,600,400,"True",504,456,453,-3,3,0
"D17JO",16,130,"1200x900",600,1,600,400,"False",741,428,597,169,169,0
"D17JO",17,556,"1200x900",1000,1,600,400,"False",415,420,533,113,113,0
"D17JO",18,290,"1200x900",800,1,600,400,"False",789,603,411,-192,192,0
"D17JO",19,3,"1200x900",600,0,600,400,"False",298,443,264,-179,179,1
"D17JO",21,375,"1200x900",800,2,600,400,"False",716,384,141,-243,243,0
"D17JO",22,493,"1200x900",1000,0,600,400,"False",80,582,754,172,172,1
"D17JO",23,212,"1200x900",600,2,600,400,"False",841,206,711,505,505,0
"D17JO",24,6,"1200x900",600,0,600,400,"True",217,689,665,-24,24,1
"D17JO",25,347,"1200x900",800,1,600,400,"False",757,295,520,225,225,1
"D17JO",26,564,"1200x900",1000,1,600,400,"True",215,264,216,-48,48,0
"D17JO",27,244,"1200x900",800,0,600,400,"False",194,203,369,166,166,1
"D17JO",28,354,"1200x900",800,1,600,400,"False",118,236,700,464,464,0
"D17JO",30,365,"1200x900",800,2,600,400,"True",1055,305,333,28,28,0
"D17JO",31,71,"1200x900",600,0,600,400,"False",219,248,332,84,84,0
"D17JO",32,201,"1200x900",600,2,600,400,"False",1005,462,594,132,132,0
"D17JO",33,146,"1200x900",600,2,600,400,"True",989,492,508,16,16,0
"D17JO",34,339,"1200x900",800,1,600,400,"True",273,545,485,-60,60,1
"D17JO",35,238,"1200x900",800,0,600,400,"True",162,283,234,-49,49,1
"D17JO",36,377,"1200x900",800,2,600,400,"False",683,388,482,94,94,0
"D17JO",37,547,"1200x900",1000,1,600,400,"False",369,384,630,246,246,1
"D17JO",38,549,"1200x900",1000,1,600,400,"True",657,366,324,-42,42,0
"D17JO",39,391,"1200x900",800,2,600,400,"False",895,521,462,-59,59,0
"D17JO",40,420,"1200x900",800,2,600,400,"False",519,223,547,324,324,0
"D17JO",41,42,"1200x900",600,0,600,400,"False",233,479,398,-81,81,0
"D17JO",42,593,"1200x900",1000,2,600,400,"False",246,719,266,-453,453,0
"D17JO",43,94,"1200x900",600,1,600,400,"False",729,482,313,-169,169,0
"D17JO",45,206,"1200x900",600,2,600,400,"False",975,223,595,372,372,0
"D17JO",46,481,"1200x900",1000,0,600,400,"True",80,185,210,25,25,1
"D17JO",47,26,"1200x900",600,0,600,400,"False",70,712,254,-458,458,0
"D17JO",48,22,"1200x900",600,0,600,400,"False",398,591,683,92,92,1
"D17JO",49,242,"1200x900",800,0,600,400,"True",117,448,404,-44,44,1
"D17JO",50,358,"1200x900",800,1,600,400,"False",263,635,515,-120,120,0
"D17JO",51,438,"1200x900",1000,0,600,400,"True",77,713,725,12,12,1
"D17JO",52,276,"1200x900",800,0,600,400,"False",281,217,357,140,140,1
"D17JO",53,470,"1200x900",1000,0,600,400,"True",91,666,703,37,37,1
"D17JO",54,120,"1200x900",600,1,600,400,"True",690,655,632,-23,23,0
"D17JO",56,554,"1200x900",1000,1,600,400,"False",79,309,172,-137,137,1
"D17JO",57,274,"1200x900",800,0,600,400,"True",146,497,434,-63,63,1
"D17JO",58,447,"1200x900",1000,0,600,400,"True",71,339,390,51,51,1
"D17JO",59,14,"1200x900",600,0,600,400,"False",399,224,389,165,165,1
"D17JO",60,270,"1200x900",800,0,600,400,"True",192,418,425,7,7,1
"D17JO",62,76,"1200x900",600,1,600,400,"True",647,614,604,-10,10,0
"D17JO",63,350,"1200x900",800,1,600,400,"True",182,566,613,47,47,0
"D17JO",64,251,"1200x900",800,0,600,400,"False",88,352,464,112,112,1
"D17JO",65,464,"1200x900",1000,0,600,400,"False",82,222,428,206,206,1
"D17JO",66,457,"1200x900",1000,0,600,400,"False",97,630,550,-80,80,1
"D17JO",67,432,"1200x900",800,2,600,400,"False",792,380,166,-214,214,0
"D17JO",68,376,"1200x900",800,2,600,400,"False",788,275,103,-172,172,0
"D17JO",69,598,"1200x900",1000,2,600,400,"False",706,559,387,-172,172,0
"D17JO",70,133,"1200x900",600,1,600,400,"False",345,551,382,-169,169,0
"D17JO",71,608,"1200x900",1000,2,600,400,"False",742,250,384,134,134,0
"D17JO",72,99,"1200x900",600,1,600,400,"True",811,407,382,-25,25,0
"D17JO",73,51,"1200x900",600,0,600,400,"True",272,181,210,29,29,1
"D17JO",74,33,"1200x900",600,0,600,400,"True",198,533,499,-34,34,1
"D17JO",75,161,"1200x900",600,2,600,400,"False",939,553,401,-152,152,0
"D17JO",76,507,"1200x900",1000,1,600,400,"False",608,583,484,-99,99,1
"D17JO",77,16,"1200x900",600,0,600,400,"True",297,514,525,11,11,1
"D17JO",78,574,"1200x900",1000,1,600,400,"False",614,194,464,270,270,0
"D17JO",79,303,"1200x900",800,1,600,400,"False",241,431,565,134,134,0
"D17JO",80,178,"1200x900",600,2,600,400,"True",1041,510,423,-87,87,0
"D17JO",81,514,"1200x900",1000,1,600,400,"True",539,690,715,25,25,0
"D17JO",82,191,"1200x900",600,2,600,400,"False",962,396,674,278,278,0
"D17JO",83,436,"1200x900",1000,0,600,400,"False",82,617,447,-170,170,1
"D17JO",84,488,"1200x900",1000,0,600,400,"False",129,687,585,-102,102,1
"D17JO",85,624,"1200x900",1000,2,600,400,"False",693,501,596,95,95,0
"D17JO",86,8,"1200x900",600,0,600,400,"False",156,679,595,-84,84,0
"D17JO",87,184,"1200x900",600,2,600,400,"False",1067,441,520,79,79,0
"D17JO",88,217,"1200x900",800,0,600,400,"True",85,573,559,-14,14,1
"D17JO",89,437,"1200x900",1000,0,600,400,"False",74,667,581,-86,86,1
"D17JO",90,335,"1200x900",800,1,600,400,"False",124,360,489,129,129,0
"D17JO",91,288,"1200x900",800,0,600,400,"True",180,547,501,-46,46,1
"D17JO",93,518,"1200x900",1000,1,600,400,"False",583,717,579,-138,138,0
"D17JO",94,536,"1200x900",1000,1,600,400,"False",580,213,300,87,87,0
"D17JO",95,606,"1200x900",1000,2,600,400,"False",653,627,511,-116,116,0
"D17JO",96,175,"1200x900",600,2,600,400,"False",1028,432,196,-236,236,0
"D17JO",97,15,"1200x900",600,0,600,400,"False",473,352,466,114,114,1
"D17JO",98,524,"1200x900",1000,1,600,400,"False",534,470,328,-142,142,0
"D17JO",99,406,"1200x900",800,2,600,400,"False",971,233,448,215,215,0
"D17JO",100,460,"1200x900",1000,0,600,400,"False",155,189,294,105,105,1
"D17JO",101,351,"1200x900",800,1,600,400,"False",122,581,247,-334,334,0
"D17JO",102,95,"1200x900",600,1,600,400,"False",749,425,511,86,86,1
"D17JO",103,575,"1200x900",1000,1,600,400,"False",272,693,600,-93,93,0
"D17JO",104,119,"1200x900",600,1,600,400,"True",168,563,515,-48,48,0
"D17JO",105,480,"1200x900",1000,0,600,400,"False",100,231,424,193,193,1
"D17JO",106,277,"1200x900",800,0,600,400,"False",140,310,413,103,103,1
"D17JO",107,36,"1200x900",600,0,600,400,"True",128,346,420,74,74,1
"D17JO",108,286,"1200x900",800,0,600,400,"True",105,378,405,27,27,1
"D17JO",109,513,"1200x900",1000,1,600,400,"False",235,602,521,-81,81,0
"D17JO",110,90,"1200x900",600,1,600,400,"False",560,474,718,244,244,0
"D17JO",111,584,"1200x900",1000,2,600,400,"False",731,413,590,177,177,0
"D17JO",112,353,"1200x900",800,1,600,400,"True",90,476,438,-38,38,0
"D17JO",113,192,"1200x900",600,2,600,400,"False",1064,320,521,201,201,0
"D17JO",114,602,"1200x900",1000,2,600,400,"True",865,452,476,24,24,0
"D17JO",115,169,"1200x900",600,2,600,400,"False",924,290,125,-165,165,0
"D17JO",116,472,"1200x900",1000,0,600,400,"False",77,685,547,-138,138,1
"D17JO",117,645,"1200x900",1000,2,600,400,"False",619,396,582,186,186,0
"D17JO",118,387,"1200x900",800,2,600,400,"False",990,444,695,251,251,0
"D17JO",119,111,"1200x900",600,1,600,400,"False",922,552,475,-77,77,1
"D17JO",120,452,"1200x900",1000,0,600,400,"True",97,273,298,25,25,1
"D17JO",121,509,"1200x900",1000,1,600,400,"False",509,434,330,-104,104,0
"D17JO",122,269,"1200x900",800,0,600,400,"True",160,295,305,10,10,1
"D17JO",123,106,"1200x900",600,1,600,400,"True",803,659,641,-18,18,1
"D17JO",124,313,"1200x900",800,1,600,400,"True",588,421,414,-7,7,0
"D17JO",125,425,"1200x900",800,2,600,400,"False",621,438,739,301,301,0
"D17JO",126,57,"1200x900",600,0,600,400,"True",354,508,555,47,47,1
"D17JO",127,580,"1200x900",1000,2,600,400,"False",651,267,363,96,96,0
"D17JO",128,296,"1200x900",800,1,600,400,"False",89,279,436,157,157,0
"D17JO",129,86,"1200x900",600,1,600,400,"True",692,388,381,-7,7,1
"D17JO",130,401,"1200x900",800,2,600,400,"True",821,260,242,-18,18,0
"D17JO",131,89,"1200x900",600,1,600,400,"False",917,366,545,179,179,1
"D17JO",132,418,"1200x900",800,2,600,400,"False",754,507,422,-85,85,0
"D17JO",133,552,"1200x900",1000,1,600,400,"True",255,412,384,-28,28,0
"D17JO",134,249,"1200x900",800,0,600,400,"True",126,306,322,16,16,1
"D17JO",135,582,"1200x900",1000,2,600,400,"False",554,347,428,81,81,0
"D17JO",136,305,"1200x900",800,1,600,400,"False",471,716,562,-154,154,0
"D17JO",137,344,"1200x900",800,1,600,400,"True",589,408,390,-18,18,0
"D17JO",138,478,"1200x900",1000,0,600,400,"True",79,672,677,5,5,1
"D17JO",139,311,"1200x900",800,1,600,400,"False",710,261,528,267,267,0
"D17JO",140,167,"1200x900",600,2,600,400,"False",956,241,455,214,214,0
"D17JO",141,308,"1200x900",800,1,600,400,"True",437,425,448,23,23,0
"D17JO",142,43,"1200x900",600,0,600,400,"False",277,446,569,123,123,1
"D17JO",143,495,"1200x900",1000,0,600,400,"True",93,692,687,-5,5,1
"D17JO",144,431,"1200x900",800,2,600,400,"False",694,382,545,163,163,0
"D17JO",145,28,"1200x900",600,0,600,400,"False",336,410,514,104,104,1
"D17JO",146,512,"1200x900",1000,1,600,400,"False",139,261,351,90,90,0
"D17JO",147,129,"1200x900",600,1,600,400,"False",859,482,655,173,173,1
"D17JO",148,118,"1200x900",600,1,600,400,"True",190,588,536,-52,52,0
"D17JO",149,453,"1200x900",1000,0,600,400,"False",71,393,518,125,125,1
"D17JO",150,235,"1200x900",800,0,600,400,"False",146,646,728,82,82,1
"D17JO",151,91,"1200x900",600,1,600,400,"True",417,630,648,18,18,1
"D17JO",152,102,"1200x900",600,1,600,400,"False",861,603,736,133,133,0
"D17JO",153,306,"1200x900",800,1,600,400,"False",164,524,391,-133,133,0
"D17JO",154,589,"1200x900",1000,2,600,400,"True",856,418,444,26,26,0
"D17JO",155,544,"1200x900",1000,1,600,400,"True",602,620,654,34,34,0
"D17JO",156,543,"1200x900",1000,1,600,400,"False",88,202,453,251,251,0
"D17JO",157,627,"1200x900",1000,2,600,400,"False",760,510,412,-98,98,0
"D17JO",158,612,"1200x900",1000,2,600,400,"False",706,198,471,273,273,0
"D17JO",159,259,"1200x900",800,0,600,400,"False",156,180,331,151,151,1
"D17JO",160,38,"1200x900",600,0,600,400,"False",120,628,341,-287,287,1
"D17JO",161,314,"1200x900",800,1,600,400,"False",277,616,734,118,118,1
"D17JO",162,254,"1200x900",800,0,600,400,"False",136,583,713,130,130,1
"D17JO",163,373,"1200x900",800,2,600,400,"False",694,326,526,200,200,0
"D17JO",164,101,"1200x900",600,1,600,400,"False",541,656,424,-232,232,0
"D17JO",165,181,"1200x900",600,2,600,400,"False",1018,223,567,344,344,0
"D17JO",166,327,"1200x900",800,1,600,400,"True",152,339,404,65,65,0
"D17JO",167,40,"1200x900",600,0,600,400,"True",143,513,546,33,33,0
"D17JO",168,176,"1200x900",600,2,600,400,"True",1033,281,301,20,20,0
"D17JO",169,533,"1200x900",1000,1,600,400,"True",355,483,515,32,32,0
"D17JO",170,361,"1200x900",800,2,600,400,"False",931,328,445,117,117,0
"D17JO",171,528,"1200x900",1000,1,600,400,"False",839,227,489,262,262,1
"D17JO",172,371,"1200x900",800,2,600,400,"True",730,560,507,-53,53,0
"D17JO",173,338,"1200x900",800,1,600,400,"False",813,253,413,160,160,1
"D17JO",174,187,"1200x900",600,2,600,400,"False",857,639,318,-321,321,0
"D17JO",175,405,"1200x900",800,2,600,400,"False",790,307,537,230,230,0
"D17JO",176,83,"1200x900",600,1,600,400,"False",763,568,485,-83,83,1
"D17JO",177,592,"1200x900",1000,2,600,400,"False",492,392,552,160,160,0
"D17JO",178,473,"1200x900",1000,0,600,400,"True",75,323,259,-64,64,1
"D17JO",180,262,"1200x900",800,0,600,400,"True",196,481,510,29,29,1
"D17JO",181,505,"1200x900",1000,1,600,400,"False",191,484,647,163,163,1
"D17JO",182,362,"1200x900",800,2,600,400,"False",819,338,475,137,137,0
"D17JO",183,283,"1200x900",800,0,600,400,"True",90,264,291,27,27,1
"D17JO",184,253,"1200x900",800,0,600,400,"True",177,424,461,37,37,1
"D17JO",186,604,"1200x900",1000,2,600,400,"False",459,593,531,-62,62,0
"D17JO",187,638,"1200x900",1000,2,600,400,"False",385,198,348,150,150,0
"D17JO",188,243,"1200x900",800,0,600,400,"True",114,332,382,50,50,1
"D17JO",189,9,"1200x900",600,0,600,400,"True",509,654,613,-41,41,1
"D17JO",190,268,"1200x900",800,0,600,400,"False",148,400,482,82,82,1
"D17JO",191,566,"1200x900",1000,1,600,400,"True",378,472,535,63,63,1
"D17JO",192,78,"1200x900",600,1,600,400,"False",885,684,430,-254,254,0
"D17JO",193,474,"1200x900",1000,0,600,400,"False",85,339,406,67,67,1
"D17JO",194,535,"1200x900",1000,1,600,400,"True",372,410,462,52,52,0
"D17JO",195,153,"1200x900",600,2,600,400,"False",1037,601,461,-140,140,0
"D17JO",196,63,"1200x900",600,0,600,400,"True",311,188,194,6,6,1
"D17JO",197,471,"1200x900",1000,0,600,400,"True",122,200,255,55,55,1
"D17JO",198,19,"1200x900",600,0,600,400,"True",286,686,723,37,37,0
"D17JO",199,459,"1200x900",1000,0,600,400,"True",70,645,652,7,7,1
"D17JO",200,621,"1200x900",1000,2,600,400,"True",540,478,507,29,29,0
"D17JO",201,260,"1200x900",800,0,600,400,"False",103,525,435,-90,90,1
"D17JO",202,114,"1200x900",600,1,600,400,"False",183,697,417,-280,280,0
"D17JO",203,158,"1200x900",600,2,600,400,"True",939,300,290,-10,10,0
"D17JO",204,643,"1200x900",1000,2,600,400,"False",740,325,83,-242,242,0
"D17JO",205,241,"1200x900",800,0,600,400,"True",129,227,158,-69,69,1
"D17JO",206,300,"1200x900",800,1,600,400,"False",620,693,552,-141,141,0
"D17JO",207,104,"1200x900",600,1,600,400,"False",448,584,419,-165,165,0
"D17JO",208,423,"1200x900",800,2,600,400,"True",1051,710,716,6,6,1
"D17JO",209,72,"1200x900",600,0,600,400,"True",158,537,574,37,37,0
"D17JO",210,341,"1200x900",800,1,600,400,"True",735,632,711,79,79,1
"D17JO",211,93,"1200x900",600,1,600,400,"False",139,540,641,101,101,0
"D17JO",212,199,"1200x900",600,2,600,400,"False",992,467,222,-245,245,0
"D17JO",213,541,"1200x900",1000,1,600,400,"True",339,478,437,-41,41,0
"D17JO",214,58,"1200x900",600,0,600,400,"True",353,655,676,21,21,1
"D17JO",215,312,"1200x900",800,1,600,400,"False",238,683,594,-89,89,0
"D17JO",216,77,"1200x900",600,1,600,400,"True",780,525,538,13,13,0
"D17JO",217,11,"1200x900",600,0,600,400,"True",372,670,688,18,18,1
"D17JO",218,285,"1200x900",800,0,600,400,"False",237,396,547,151,151,1
"D17JO",219,448,"1200x900",1000,0,600,400,"True",107,641,683,42,42,1
"D17JO",220,18,"1200x900",600,0,600,400,"False",400,318,482,164,164,1
"D17JO",221,390,"1200x900",800,2,600,400,"False",982,674,788,114,114,1
"D17JO",222,378,"1200x900",800,2,600,400,"False",1018,708,386,-322,322,0
"D17JO",223,531,"1200x900",1000,1,600,400,"False",233,362,268,-94,94,0
"D17JO",224,122,"1200x900",600,1,600,400,"False",817,709,530,-179,179,0
"D17JO",225,295,"1200x900",800,1,600,400,"False",471,334,427,93,93,0
"D17JO",226,482,"1200x900",1000,0,600,400,"False",79,686,619,-67,67,1
"D17JO",227,372,"1200x900",800,2,600,400,"False",833,620,495,-125,125,0
"D17JO",228,348,"1200x900",800,1,600,400,"False",764,294,471,177,177,0
"D17JO",229,573,"1200x900",1000,1,600,400,"False",486,615,503,-112,112,0
"D17JO",230,149,"1200x900",600,2,600,400,"True",890,289,317,28,28,0
"D17JO",231,389,"1200x900",800,2,600,400,"False",843,530,400,-130,130,0
"D17JO",232,368,"1200x900",800,2,600,400,"True",778,515,546,31,31,0
"D17JO",233,558,"1200x900",1000,1,600,400,"False",72,464,835,371,371,1
"D17JO",234,522,"1200x900",1000,1,600,400,"False",223,379,602,223,223,0
"D17JO",235,572,"1200x900",1000,1,600,400,"False",302,260,440,180,180,0
"D17JO",236,113,"1200x900",600,1,600,400,"False",897,657,441,-216,216,0
"D17JO",237,532,"1200x900",1000,1,600,400,"False",215,207,312,105,105,0
"D17JO",238,284,"1200x900",800,0,600,400,"True",135,293,292,-1,1,1
"D17JO",239,410,"1200x900",800,2,600,400,"True",916,477,468,-9,9,0
"D17JO",240,194,"1200x900",600,2,600,400,"False",896,236,420,184,184,0
"D17JO",241,289,"1200x900",800,1,600,400,"False",421,703,356,-347,347,1
"D17JO",242,293,"1200x900",800,1,600,400,"True",561,396,418,22,22,0
"D17JO",243,619,"1200x900",1000,2,600,400,"False",803,247,502,255,255,0
"D17JO",244,202,"1200x900",600,2,600,400,"False",966,460,399,-61,61,0
"D17JO",245,84,"1200x900",600,1,600,400,"False",144,184,512,328,328,0
"D17JO",246,393,"1200x900",800,2,600,400,"False",657,620,395,-225,225,0
"D17JO",247,374,"1200x900",800,2,600,400,"False",755,450,564,114,114,0
"D17JO",248,117,"1200x900",600,1,600,400,"False",711,456,200,-256,256,0
"D17JO",249,449,"1200x900",1000,0,600,400,"True",105,683,696,13,13,1
"D17JO",250,256,"1200x900",800,0,600,400,"True",192,656,667,11,11,1
"D17JO",251,165,"1200x900",600,2,600,400,"True",912,554,612,58,58,0
"D17JO",252,174,"1200x900",600,2,600,400,"True",998,457,494,37,37,0
"D17JO",253,204,"1200x900",600,2,600,400,"True",1053,432,454,22,22,0
"D17JO",254,1,"1200x900",600,0,600,400,"True",136,502,479,-23,23,0
"D17JO",255,220,"1200x900",800,0,600,400,"True",108,699,647,-52,52,1
"D17JO",256,506,"1200x900",1000,1,600,400,"False",559,567,482,-85,85,1
"D17JO",257,626,"1200x900",1000,2,600,400,"False",329,449,199,-250,250,0
"D17JO",258,560,"1200x900",1000,1,600,400,"False",516,693,446,-247,247,0
"D17JO",259,37,"1200x900",600,0,600,400,"True",258,403,385,-18,18,1
"D17JO",260,345,"1200x900",800,1,600,400,"True",841,566,610,44,44,1
"D17JO",261,355,"1200x900",800,1,600,400,"False",77,386,682,296,296,0
"D17JO",262,136,"1200x900",600,1,600,400,"True",264,205,117,-88,88,0
"D17JO",263,427,"1200x900",800,2,600,400,"False",812,380,223,-157,157,0
"D17JO",264,75,"1200x900",600,1,600,400,"True",635,558,532,-26,26,0
"D17JO",265,367,"1200x900",800,2,600,400,"True",613,464,449,-15,15,0
"D17JO",266,150,"1200x900",600,2,600,400,"True",897,345,359,14,14,0
"D17JO",267,546,"1200x900",1000,1,600,400,"True",305,374,358,-16,16,0
"D17JO",268,635,"1200x900",1000,2,600,400,"False",833,402,506,104,104,0
"D17JO",269,456,"1200x900",1000,0,600,400,"False",91,257,321,64,64,1
"D17JO",270,234,"1200x900",800,0,600,400,"True",72,344,299,-45,45,1
"D17JO",271,208,"1200x900",600,2,600,400,"True",946,399,364,-35,35,0
"D17JO",272,529,"1200x900",1000,1,600,400,"True",267,412,392,-20,20,1
"D17JO",273,571,"1200x900",1000,1,600,400,"True",239,522,488,-34,34,1
"D17JO",274,255,"1200x900",800,0,600,400,"True",93,709,727,18,18,1
"D17JO",275,496,"1200x900",1000,0,600,400,"True",70,639,622,-17,17,1
"D17JO",276,250,"1200x900",800,0,600,400,"False",290,248,410,162,162,1
"D17JO",277,264,"1200x900",800,0,600,400,"True",198,660,642,-18,18,1
"D17JO",278,394,"1200x900",800,2,600,400,"False",847,292,510,218,218,0
"D17JO",279,388,"1200x900",800,2,600,400,"False",930,320,411,91,91,0
"D17JO",280,409,"1200x900",800,2,600,400,"False",501,659,771,112,112,0
"D17JO",281,155,"1200x900",600,2,600,400,"False",940,269,436,167,167,0
"D17JO",282,107,"1200x900",600,1,600,400,"False",878,678,785,107,107,0
"D17JO",283,615,"1200x900",1000,2,600,400,"False",736,634,525,-109,109,0
"D17JO",284,609,"1200x900",1000,2,600,400,"False",697,627,487,-140,140,0
"D17JO",285,597,"1200x900",1000,2,600,400,"False",352,239,52,-187,187,0
"D17JO",286,62,"1200x900",600,0,600,400,"True",345,346,338,-8,8,1
"D17JO",287,565,"1200x900",1000,1,600,400,"True",451,562,566,4,4,0
"D17JO",288,559,"1200x900",1000,1,600,400,"True",641,244,213,-31,31,0
"D17JO",289,330,"1200x900",800,1,600,400,"True",759,301,295,-6,6,1
"D17JO",290,123,"1200x900",600,1,600,400,"False",761,365,628,263,263,1
"D17JO",291,218,"1200x900",800,0,600,400,"False",106,397,301,-96,96,1
"D17JO",292,404,"1200x900",800,2,600,400,"True",842,396,356,-40,40,0
"D17JO",293,144,"1200x900",600,1,600,400,"False",718,371,184,-187,187,0
"D17JO",294,110,"1200x900",600,1,600,400,"False",776,550,348,-202,202,1
"D17JO",295,498,"1200x900",1000,0,600,400,"True",100,260,223,-37,37,1
"D17JO",296,586,"1200x900",1000,2,600,400,"False",802,262,445,183,183,0
"D17JO",297,630,"1200x900",1000,2,600,400,"False",754,559,411,-148,148,0
"D17JO",298,489,"1200x900",1000,0,600,400,"False",88,604,737,133,133,1
"D17JO",299,237,"1200x900",800,0,600,400,"False",204,481,611,130,130,1
"D17JO",300,227,"1200x900",800,0,600,400,"True",196,551,601,50,50,1
"D17JO",301,55,"1200x900",600,0,600,400,"True",211,305,367,62,62,1
"D17JO",302,67,"1200x900",600,0,600,400,"True",289,308,304,-4,4,1
"D17JO",303,381,"1200x900",800,2,600,400,"False",705,408,494,86,86,0
"D17JO",304,422,"1200x900",800,2,600,400,"False",712,558,448,-110,110,0
"D17JO",305,527,"1200x900",1000,1,600,400,"False",565,601,497,-104,104,0
"D17JO",306,44,"1200x900",600,0,600,400,"False",305,554,652,98,98,1
"D17JO",307,292,"1200x900",800,1,600,400,"True",88,565,545,-20,20,0
"D17JO",308,463,"1200x900",1000,0,600,400,"True",115,693,748,55,55,1
"D17JO",309,579,"1200x900",1000,2,600,400,"False",803,394,563,169,169,0
"D17JO",310,147,"1200x900",600,2,600,400,"False",942,418,580,162,162,0
"D17JO",311,561,"1200x900",1000,1,600,400,"False",231,406,612,206,206,0
"D17JO",312,219,"1200x900",800,0,600,400,"False",202,502,588,86,86,1
"D17JO",313,266,"1200x900",800,0,600,400,"False",126,303,427,124,124,1
"D17JO",314,325,"1200x900",800,1,600,400,"True",105,394,386,-8,8,0
"D17JO",315,581,"1200x900",1000,2,600,400,"False",310,357,50,-307,307,0
"D17JO",316,523,"1200x900",1000,1,600,400,"True",339,318,270,-48,48,0
"D17JO",317,450,"1200x900",1000,0,600,400,"False",130,204,297,93,93,1
"D17JO",318,360,"1200x900",800,1,600,400,"True",203,608,563,-45,45,0
"D17JO",319,98,"1200x900",600,1,600,400,"True",625,530,527,-3,3,0
"D17JO",320,59,"1200x900",600,0,600,400,"True",391,692,700,8,8,1
"D17JO",321,511,"1200x900",1000,1,600,400,"False",408,390,545,155,155,1
"D17JO",322,530,"1200x900",1000,1,600,400,"True",584,405,514,109,109,1
"D17JO",323,247,"1200x900",800,0,600,400,"True",160,424,474,50,50,1
"D17JO",324,190,"1200x900",600,2,600,400,"False",977,238,386,148,148,0
"D17JO",325,411,"1200x900",800,2,600,400,"True",805,361,365,4,4,0
"D17JO",326,419,"1200x900",800,2,600,400,"False",769,351,161,-190,190,0
"D17JO",327,349,"1200x900",800,1,600,400,"True",402,665,724,59,59,0
"D17JO",328,49,"1200x900",600,0,600,400,"True",109,380,330,-50,50,0
"D17JO",329,189,"1200x900",600,2,600,400,"True",881,397,404,7,7,0
"D17JO",330,154,"1200x900",600,2,600,400,"False",941,454,259,-195,195,0
"D17JO",331,301,"1200x900",800,1,600,400,"True",162,574,572,-2,2,0
"D17JO",332,603,"1200x900",1000,2,600,400,"False",693,280,376,96,96,0
"D17JO",333,443,"1200x900",1000,0,600,400,"False",99,651,486,-165,165,1
"D17JO",334,216,"1200x900",600,2,600,400,"True",1029,286,365,79,79,0
"D17JO",335,214,"1200x900",600,2,600,400,"True",1046,305,272,-33,33,0
"D17JO",336,321,"1200x900",800,1,600,400,"True",601,190,145,-45,45,0
"D17JO",337,510,"1200x900",1000,1,600,400,"True",486,338,290,-48,48,1
"D17JO",338,599,"1200x900",1000,2,600,400,"False",316,570,320,-250,250,0
"D17JO",339,5,"1200x900",600,0,600,400,"True",228,587,584,-3,3,0
"D17JO",340,275,"1200x900",800,0,600,400,"True",120,594,619,25,25,0
"D17JO",341,539,"1200x900",1000,1,600,400,"False",510,383,684,301,301,0
"D17JO",342,85,"1200x900",600,1,600,400,"False",434,347,692,345,345,0
"D17JO",343,340,"1200x900",800,1,600,400,"False",226,240,439,199,199,0
"D17JO",344,66,"1200x900",600,0,600,400,"False",155,673,520,-153,153,0
"D17JO",345,182,"1200x900",600,2,600,400,"True",933,389,351,-38,38,0
"D17JO",346,435,"1200x900",1000,0,600,400,"True",119,200,240,40,40,1
"D17JO",347,492,"1200x900",1000,0,600,400,"False",76,692,530,-162,162,1
"D17JO",348,322,"1200x900",800,1,600,400,"True",703,206,239,33,33,1
"D17JO",349,180,"1200x900",600,2,600,400,"True",929,270,336,66,66,0
"D17JO",350,337,"1200x900",800,1,600,400,"False",299,622,409,-213,213,0
"D17JO",352,109,"1200x900",600,1,600,400,"True",691,589,571,-18,18,0
"D17JO",353,145,"1200x900",600,2,600,400,"False",1004,630,488,-142,142,0
"D17JO",354,408,"1200x900",800,2,600,400,"True",758,567,548,-19,19,0
"D17JO",355,590,"1200x900",1000,2,600,400,"True",636,278,250,-28,28,0
"D17JO",356,412,"1200x900",800,2,600,400,"False",842,280,50,-230,230,0
"D17JO",357,336,"1200x900",800,1,600,400,"False",251,587,347,-240,240,0
"D17JO",358,563,"1200x900",1000,1,600,400,"False",201,696,606,-90,90,0
"D17JO",359,392,"1200x900",800,2,600,400,"True",1031,618,566,-52,52,0
"D17JO",360,12,"1200x900",600,0,600,400,"True",365,336,291,-45,45,1
"D17JO",361,417,"1200x900",800,2,600,400,"False",750,280,394,114,114,0
"D17JO",362,139,"1200x900",600,1,600,400,"False",192,695,479,-216,216,0
"D17JO",363,50,"1200x900",600,0,600,400,"True",75,582,646,64,64,0
"D17JO",364,226,"1200x900",800,0,600,400,"False",187,229,141,-88,88,1
"D17JO",365,413,"1200x900",800,2,600,400,"True",849,506,485,-21,21,0
"D17JO",366,553,"1200x900",1000,1,600,400,"False",116,712,640,-72,72,0
"D17JO",367,548,"1200x900",1000,1,600,400,"True",103,278,303,25,25,0
"D17JO",368,21,"1200x900",600,0,600,400,"True",314,383,325,-58,58,1
"D17JO",369,310,"1200x900",800,1,600,400,"False",559,592,507,-85,85,0
"D17JO",370,258,"1200x900",800,0,600,400,"True",126,664,615,-49,49,1
"D17JO",371,357,"1200x900",800,1,600,400,"False",109,594,499,-95,95,0
"D17JO",372,400,"1200x900",800,2,600,400,"False",733,297,181,-116,116,0
"D17JO",373,591,"1200x900",1000,2,600,400,"True",698,336,313,-23,23,0
"D17JO",374,195,"1200x900",600,2,600,400,"False",942,249,88,-161,161,0
"D17JO",375,170,"1200x900",600,2,600,400,"False",996,468,247,-221,221,0
"D17JO",376,207,"1200x900",600,2,600,400,"False",838,235,390,155,155,0
"D17JO",377,197,"1200x900",600,2,600,400,"True",903,212,220,8,8,0
"D17JO",378,10,"1200x900",600,0,600,400,"False",400,499,368,-131,131,1
"D17JO",379,332,"1200x900",800,1,600,400,"False",260,699,550,-149,149,0
"D17JO",380,203,"1200x900",600,2,600,400,"True",938,603,544,-59,59,0
"D17JO",381,316,"1200x900",800,1,600,400,"False",362,319,652,333,333,0
"D17JO",382,225,"1200x900",800,0,600,400,"True",178,423,342,-81,81,1
"D17JO",383,366,"1200x900",800,2,600,400,"False",931,464,322,-142,142,0
"D17JO",384,396,"1200x900",800,2,600,400,"False",678,663,443,-220,220,0
"D17JO",385,304,"1200x900",800,1,600,400,"False",667,605,314,-291,291,0
"D17JO",386,616,"1200x900",1000,2,600,400,"False",854,357,255,-102,102,1
"D17JO",387,320,"1200x900",800,1,600,400,"True",644,376,420,44,44,0
"D17JO",388,278,"1200x900",800,0,600,400,"False",251,711,552,-159,159,1
"D17JO",389,273,"1200x900",800,0,600,400,"False",180,309,502,193,193,1
"D17JO",390,466,"1200x900",1000,0,600,400,"False",82,205,355,150,150,1
"D17JO",391,323,"1200x900",800,1,600,400,"True",388,348,304,-44,44,0
"D17JO",392,644,"1200x900",1000,2,600,400,"True",495,486,541,55,55,0
"D17JO",393,469,"1200x900",1000,0,600,400,"False",73,227,420,193,193,1
"D17JO",394,634,"1200x900",1000,2,600,400,"True",735,313,319,6,6,0
"D17JO",395,462,"1200x900",1000,0,600,400,"False",102,672,563,-109,109,1
"D17JO",396,230,"1200x900",800,0,600,400,"True",99,678,643,-35,35,1
"D17JO",397,291,"1200x900",800,1,600,400,"True",522,694,674,-20,20,0
"D17JO",398,501,"1200x900",1000,0,600,400,"False",96,323,448,125,125,1
"D17JO",399,440,"1200x900",1000,0,600,400,"False",71,237,451,214,214,1
"D17JO",400,633,"1200x900",1000,2,600,400,"False",564,253,576,323,323,0
"D17JO",401,287,"1200x900",800,0,600,400,"True",120,567,610,43,43,1
"D17JO",402,159,"1200x900",600,2,600,400,"True",992,309,336,27,27,0
"D17JO",403,515,"1200x900",1000,1,600,400,"False",307,217,342,125,125,0
"D17JO",404,27,"1200x900",600,0,600,400,"True",373,309,261,-48,48,1
"D17JO",405,359,"1200x900",800,1,600,400,"False",653,241,404,163,163,0
"D17JO",406,550,"1200x900",1000,1,600,400,"True",301,459,500,41,41,0
"D17JO",407,171,"1200x900",600,2,600,400,"True",909,200,223,23,23,0
"D17JO",408,319,"1200x900",800,1,600,400,"False",494,587,409,-178,178,1
"D17JO",409,185,"1200x900",600,2,600,400,"False",907,212,345,133,133,0
"D17JO",410,24,"1200x900",600,0,600,400,"False",430,538,623,85,85,1
"D17JO",411,632,"1200x900",1000,2,600,400,"False",984,227,499,272,272,0
"D17JO",412,433,"1200x900",1000,0,600,400,"False",76,222,372,150,150,1
"D17JO",413,141,"1200x900",600,1,600,400,"True",671,582,529,-53,53,0
"D17JO",414,128,"1200x900",600,1,600,400,"True",661,258,343,85,85,1
"D17JO",415,162,"1200x900",600,2,600,400,"True",849,279,224,-55,55,0
"D17JO",416,186,"1200x900",600,2,600,400,"False",997,197,75,-122,122,0
"D17JO",417,188,"1200x900",600,2,600,400,"False",900,195,62,-133,133,0
"D17JO",418,439,"1200x900",1000,0,600,400,"True",110,229,175,-54,54,1
"D17JO",419,228,"1200x900",800,0,600,400,"False",174,687,770,83,83,1
"D17JO",420,69,"1200x900",600,0,600,400,"True",322,268,268,0,0,0
"D17JO",421,177,"1200x900",600,2,600,400,"False",912,236,84,-152,152,0
"D17JO",422,105,"1200x900",600,1,600,400,"False",527,440,536,96,96,0
"D17JO",423,484,"1200x900",1000,0,600,400,"False",100,223,397,174,174,1
"D17JO",424,465,"1200x900",1000,0,600,400,"False",85,203,456,253,253,1
"D17JO",425,297,"1200x900",800,1,600,400,"True",625,244,281,37,37,0
"D17JO",426,329,"1200x900",800,1,600,400,"True",517,239,238,-1,1,0
"D17JO",427,74,"1200x900",600,1,600,400,"False",115,358,293,-65,65,0
"D17JO",428,442,"1200x900",1000,0,600,400,"False",87,183,336,153,153,1
"D17JO",429,68,"1200x900",600,0,600,400,"True",165,367,427,60,60,0
"D17JO",430,7,"1200x900",600,0,600,400,"True",431,654,639,-15,15,1
"D17JO",431,64,"1200x900",600,0,600,400,"True",102,339,403,64,64,0
"D17JO",432,454,"1200x900",1000,0,600,400,"True",78,687,635,-52,52,1
"D17JO",433,583,"1200x900",1000,2,600,400,"True",949,284,272,-12,12,1
"D17JO",434,346,"1200x900",800,1,600,400,"True",269,635,595,-40,40,0
"D17JO",435,343,"1200x900",800,1,600,400,"True",407,557,639,82,82,0
"D17JO",436,551,"1200x900",1000,1,600,400,"True",146,445,516,71,71,1
"D17JO",437,356,"1200x900",800,1,600,400,"True",123,484,414,-70,70,0
"D17JO",438,398,"1200x900",800,2,600,400,"False",944,698,389,-309,309,0
"D17JO",439,132,"1200x900",600,1,600,400,"False",333,185,397,212,212,0
"D17JO",440,486,"1200x900",1000,0,600,400,"False",102,676,591,-85,85,1
"D17JO",441,601,"1200x900",1000,2,600,400,"False",735,697,306,-391,391,0
"D17JO",442,61,"1200x900",600,0,600,400,"True",272,670,726,56,56,1
"D17JO",443,282,"1200x900",800,0,600,400,"True",109,246,255,9,9,1
"D17JO",444,265,"1200x900",800,0,600,400,"True",229,353,330,-23,23,1
"D17JO",445,209,"1200x900",600,2,600,400,"False",937,637,460,-177,177,0
"D17JO",446,382,"1200x900",800,2,600,400,"False",870,523,403,-120,120,0
"D17JO",447,143,"1200x900",600,1,600,400,"True",479,284,336,52,52,1
"D17JO",448,407,"1200x900",800,2,600,400,"False",989,340,165,-175,175,0
"D17JO",449,461,"1200x900",1000,0,600,400,"True",95,711,693,-18,18,1
"D17JO",450,618,"1200x900",1000,2,600,400,"False",276,671,553,-118,118,0
"D17JO",451,245,"1200x900",800,0,600,400,"False",296,235,441,206,206,1
"D17JO",452,160,"1200x900",600,2,600,400,"False",863,606,829,223,223,0
"D17JO",453,640,"1200x900",1000,2,600,400,"True",361,334,303,-31,31,0
"D17JO",454,622,"1200x900",1000,2,600,400,"True",307,683,609,-74,74,0
"D17JO",455,444,"1200x900",1000,0,600,400,"False",101,714,620,-94,94,1
"D17JO",456,2,"1200x900",600,0,600,400,"True",159,323,286,-37,37,0
"D17JO",457,236,"1200x900",800,0,600,400,"True",162,350,348,-2,2,1
"D17JO",458,477,"1200x900",1000,0,600,400,"False",88,640,461,-179,179,1
"D17JO",459,468,"1200x900",1000,0,600,400,"False",121,219,404,185,185,1
"D17JO",460,97,"1200x900",600,1,600,400,"True",760,643,571,-72,72,1
"D17JO",461,126,"1200x900",600,1,600,400,"False",849,354,511,157,157,0
"D17JO",462,39,"1200x900",600,0,600,400,"True",210,609,561,-48,48,0
"D17JO",463,331,"1200x900",800,1,600,400,"True",240,620,613,-7,7,0
"D17JO",464,631,"1200x900",1000,2,600,400,"False",699,479,560,81,81,0
"D17JO",465,568,"1200x900",1000,1,600,400,"True",286,475,431,-44,44,1
"D17JO",466,537,"1200x900",1000,1,600,400,"False",621,412,481,69,69,1
"D17JO",467,500,"1200x900",1000,0,600,400,"False",105,700,451,-249,249,1
"D17JO",468,246,"1200x900",800,0,600,400,"True",196,418,355,-63,63,1
"D17JO",469,125,"1200x900",600,1,600,400,"True",750,531,530,-1,1,0
"D17JO",470,476,"1200x900",1000,0,600,400,"False",76,359,446,87,87,1
"D17JO",471,163,"1200x900",600,2,600,400,"False",1046,665,532,-133,133,0
"D17JO",472,23,"1200x900",600,0,600,400,"True",308,463,470,7,7,1
"D17JO",473,385,"1200x900",800,2,600,400,"False",740,456,329,-127,127,0
"D17JO",474,557,"1200x900",1000,1,600,400,"False",677,505,576,71,71,1
"D17JO",475,483,"1200x900",1000,0,600,400,"False",93,191,346,155,155,1
"D17JO",476,363,"1200x900",800,2,600,400,"False",800,218,447,229,229,0
"D17JO",477,29,"1200x900",600,0,600,400,"True",385,533,492,-41,41,1
"D17JO",478,542,"1200x900",1000,1,600,400,"True",304,401,369,-32,32,0
"D17JO",479,213,"1200x900",600,2,600,400,"False",822,275,368,93,93,0
"D17JO",480,383,"1200x900",800,2,600,400,"False",855,407,296,-111,111,0
"D17JO",481,647,"1200x900",1000,2,600,400,"True",560,637,560,-77,77,0
"D17JO",482,200,"1200x900",600,2,600,400,"False",897,302,218,-84,84,0
"D17JO",483,613,"1200x900",1000,2,600,400,"False",690,374,557,183,183,0
"D17JO",484,434,"1200x900",1000,0,600,400,"True",89,657,611,-46,46,1
"D17JO",485,610,"1200x900",1000,2,600,400,"False",702,293,475,182,182,0
"D17JO",486,32,"1200x900",600,0,600,400,"False",152,563,478,-85,85,1
"D17JO",487,80,"1200x900",600,1,600,400,"False",616,423,583,160,160,1
"D17JO",488,519,"1200x900",1000,1,600,400,"True",319,565,499,-66,66,1
"D17JO",489,309,"1200x900",800,1,600,400,"False",186,225,416,191,191,0
"D17JO",490,299,"1200x900",800,1,600,400,"False",779,274,677,403,403,0
"D17JO",491,502,"1200x900",1000,0,600,400,"False",111,639,411,-228,228,1
"D17JO",492,34,"1200x900",600,0,600,400,"True",361,242,204,-38,38,1
"D17JO",493,641,"1200x900",1000,2,600,400,"False",897,272,715,443,443,0
"D17JO",494,508,"1200x900",1000,1,600,400,"True",596,485,443,-42,42,0
"D17JO",495,576,"1200x900",1000,1,600,400,"True",376,713,685,-28,28,0
"D17JO",496,229,"1200x900",800,0,600,400,"False",117,697,612,-85,85,1
"D17JO",497,414,"1200x900",800,2,600,400,"False",831,592,683,91,91,0
"D17JO",498,267,"1200x900",800,0,600,400,"True",145,665,671,6,6,1
"D17JO",499,223,"1200x900",800,0,600,400,"True",179,191,151,-40,40,1
"D17JO",500,577,"1200x900",1000,2,600,400,"False",455,420,278,-142,142,0
"D17JO",501,520,"1200x900",1000,1,600,400,"True",564,260,307,47,47,0
"D17JO",502,115,"1200x900",600,1,600,400,"True",545,307,327,20,20,0
"D17JO",503,620,"1200x900",1000,2,600,400,"False",832,649,128,-521,521,0
"D17JO",504,617,"1200x900",1000,2,600,400,"False",294,180,351,171,171,0
"D17JO",505,594,"1200x900",1000,2,600,400,"False",537,637,332,-305,305,0
"D17JO",506,280,"1200x900",800,0,600,400,"True",104,302,308,6,6,1
"D17JO",507,605,"1200x900",1000,2,600,400,"False",493,665,582,-83,83,0
"D17JO",508,88,"1200x900",600,1,600,400,"False",186,554,638,84,84,0
"D17JO",509,334,"1200x900",800,1,600,400,"True",481,665,699,34,34,0
"D17JO",510,46,"1200x900",600,0,600,400,"True",193,355,358,3,3,1
"D17JO",511,127,"1200x900",600,1,600,400,"False",309,691,572,-119,119,0
"D17JO",512,103,"1200x900",600,1,600,400,"False",528,320,647,327,327,1
"D17JO",513,446,"1200x900",1000,0,600,400,"True",72,298,324,26,26,1
"D17JO",514,525,"1200x900",1000,1,600,400,"False",123,690,487,-203,203,0
"D17JO",515,4,"1200x900",600,0,600,400,"True",602,200,211,11,11,1
"D17JO",516,302,"1200x900",800,1,600,400,"True",479,467,503,36,36,1
"D17JO",517,142,"1200x900",600,1,600,400,"True",286,474,413,-61,61,0
"D17JO",518,196,"1200x900",600,2,600,400,"False",1030,397,329,-68,68,0
"D17JO",519,53,"1200x900",600,0,600,400,"True",177,189,172,-17,17,0
"D17JO",520,415,"1200x900",800,2,600,400,"False",823,684,549,-135,135,0
"D17JO",521,79,"1200x900",600,1,600,400,"False",731,289,427,138,138,0
"D17JO",522,629,"1200x900",1000,2,600,400,"False",681,257,558,301,301,0
"D17JO",523,369,"1200x900",800,2,600,400,"True",903,594,644,50,50,0
"D17JO",524,54,"1200x900",600,0,600,400,"True",474,564,588,24,24,1
"D17JO",525,451,"1200x900",1000,0,600,400,"True",110,702,693,-9,9,1
"D17JO",526,45,"1200x900",600,0,600,400,"False",487,678,602,-76,76,1
"D17JO",527,642,"1200x900",1000,2,600,400,"False",776,316,688,372,372,0
"D17JO",528,485,"1200x900",1000,0,600,400,"False",121,694,516,-178,178,1
"D17JO",529,152,"1200x900",600,2,600,400,"False",971,399,200,-199,199,0
"D17JO",530,52,"1200x900",600,0,600,400,"False",171,188,107,-81,81,0
"D17JO",531,324,"1200x900",800,1,600,400,"False",719,712,328,-384,384,1
"D17JO",532,545,"1200x900",1000,1,600,400,"True",358,562,506,-56,56,0
"D17JO",533,578,"1200x900",1000,2,600,400,"False",966,276,677,401,401,0
"D17JO",534,173,"1200x900",600,2,600,400,"False",948,693,472,-221,221,0
"D17JO",535,379,"1200x900",800,2,600,400,"False",994,325,526,201,201,0
"D17JO",536,386,"1200x900",800,2,600,400,"False",774,301,133,-168,168,0
"D17JO",537,491,"1200x900",1000,0,600,400,"True",108,198,174,-24,24,1
"D17JO",538,504,"1200x900",1000,0,600,400,"False",107,699,825,126,126,1
"D17JO",539,458,"1200x900",1000,0,600,400,"True",78,624,623,-1,1,1
"D17JO",540,281,"1200x900",800,0,600,400,"True",112,611,603,-8,8,1
"D17JO",541,395,"1200x900",800,2,600,400,"True",743,334,320,-14,14,0
"D17JO",542,625,"1200x900",1000,2,600,400,"True",279,228,228,0,0,0
"D17JO",543,82,"1200x900",600,1,600,400,"True",108,213,204,-9,9,0
"D17JO",544,271,"1200x900",800,0,600,400,"True",74,360,335,-25,25,1
"D17JO",545,179,"1200x900",600,2,600,400,"False",908,602,342,-260,260,0
"D17JO",546,637,"1200x900",1000,2,600,400,"True",750,460,505,45,45,0
"D17JO",547,499,"1200x900",1000,0,600,400,"False",93,271,344,73,73,1
"D17JO",548,317,"1200x900",800,1,600,400,"True",185,564,579,15,15,0
"D17JO",549,168,"1200x900",600,2,600,400,"False",1001,439,100,-339,339,0
"D17JO",550,628,"1200x900",1000,2,600,400,"False",768,410,175,-235,235,0
"D17JO",551,611,"1200x900",1000,2,600,400,"False",414,511,115,-396,396,0
"D17JO",552,648,"1200x900",1000,2,600,400,"False",557,394,289,-105,105,0
"D17JO",553,503,"1200x900",1000,0,600,400,"True",86,279,219,-60,60,1
"D17JO",554,13,"1200x900",600,0,600,400,"False",296,211,294,83,83,1
"D17JO",555,342,"1200x900",800,1,600,400,"True",677,204,133,-71,71,0
"D17JO",556,646,"1200x900",1000,2,600,400,"True",829,227,311,84,84,1
"D17JO",557,151,"1200x900",600,2,600,400,"False",828,680,278,-402,402,0
"D17JO",558,205,"1200x900",600,2,600,400,"False",1021,504,375,-129,129,0
"D17JO",559,70,"1200x900",600,0,600,400,"True",309,703,762,59,59,1
"D17JO",560,31,"1200x900",600,0,600,400,"True",365,338,302,-36,36,1
"D17JO",561,224,"1200x900",800,0,600,400,"False",161,474,371,-103,103,1
"D17JO",562,157,"1200x900",600,2,600,400,"False",1016,323,188,-135,135,0
"D17JO",563,587,"1200x900",1000,2,600,400,"False",741,686,313,-373,373,0
"D17JO",564,494,"1200x900",1000,0,600,400,"True",127,692,657,-35,35,1
"D17JO",565,164,"1200x900",600,2,600,400,"True",1051,268,414,146,146,0
"D17JO",566,479,"1200x900",1000,0,600,400,"False",74,705,610,-95,95,1
"D17JO",567,318,"1200x900",800,1,600,400,"True",788,534,489,-45,45,0
"D17JO",568,562,"1200x900",1000,1,600,400,"False",347,540,456,-84,84,0
"D17JO",569,48,"1200x900",600,0,600,400,"True",323,645,611,-34,34,1
"D17JO",570,534,"1200x900",1000,1,600,400,"False",328,504,370,-134,134,1
"D17JO",571,555,"1200x900",1000,1,600,400,"True",444,556,509,-47,47,0
"D17JO",572,540,"1200x900",1000,1,600,400,"False",389,568,449,-119,119,1
"D17JO",573,421,"1200x900",800,2,600,400,"False",898,394,172,-222,222,0
"D17JO",574,25,"1200x900",600,0,600,400,"False",263,403,301,-102,102,1
"D17JO",575,399,"1200x900",800,2,600,400,"False",603,602,310,-292,292,0
"D17JO",576,600,"1200x900",1000,2,600,400,"False",765,207,536,329,329,0
"D17JO",577,131,"1200x900",600,1,600,400,"False",531,367,555,188,188,0
"D17JO",578,221,"1200x900",800,0,600,400,"False",132,520,452,-68,68,1
"D17JO",579,402,"1200x900",800,2,600,400,"True",878,234,253,19,19,0
"D17JO",580,516,"1200x900",1000,1,600,400,"False",440,559,472,-87,87,0
"D17JO",581,517,"1200x900",1000,1,600,400,"False",548,182,271,89,89,0
"D17JO",582,92,"1200x900",600,1,600,400,"True",624,605,554,-51,51,0
"D17JO",583,364,"1200x900",800,2,600,400,"False",1018,204,447,243,243,0
"D17JO",584,222,"1200x900",800,0,600,400,"True",152,206,158,-48,48,1
"D17JO",585,403,"1200x900",800,2,600,400,"True",625,704,705,1,1,0
"D17JO",586,211,"1200x900",600,2,600,400,"True",986,407,359,-48,48,0
"D17JO",587,352,"1200x900",800,1,600,400,"False",235,717,578,-139,139,0
"D17JO",588,210,"1200x900",600,2,600,400,"False",835,506,647,141,141,0
"D17JO",589,636,"1200x900",1000,2,600,400,"False",575,583,434,-149,149,0
"D17JO",590,47,"1200x900",600,0,600,400,"False",303,499,427,-72,72,1
"D17JO",591,193,"1200x900",600,2,600,400,"True",874,588,628,40,40,0
"D17JO",592,596,"1200x900",1000,2,600,400,"True",706,513,450,-63,63,0
"D17JO",593,298,"1200x900",800,1,600,400,"False",311,457,341,-116,116,0
"D17JO",594,239,"1200x900",800,0,600,400,"True",114,231,233,2,2,1
"D17JO",595,445,"1200x900",1000,0,600,400,"True",78,302,341,39,39,1
"D17JO",596,96,"1200x900",600,1,600,400,"False",433,458,610,152,152,0
"D17JO",597,121,"1200x900",600,1,600,400,"False",884,364,573,209,209,0
"D17JO",598,441,"1200x900",1000,0,600,400,"True",85,684,691,7,7,1
"D17JO",599,261,"1200x900",800,0,600,400,"False",86,713,629,-84,84,1
"D17JO",600,35,"1200x900",600,0,600,400,"True",366,555,574,19,19,1
"D17JO",601,623,"1200x900",1000,2,600,400,"False",636,527,399,-128,128,0
"D17JO",602,232,"1200x900",800,0,600,400,"False",84,511,445,-66,66,1
"D17JO",603,380,"1200x900",800,2,600,400,"False",942,228,59,-169,169,0
"D17JO",604,487,"1200x900",1000,0,600,400,"False",78,670,523,-147,147,1
"D17JO",605,137,"1200x900",600,1,600,400,"True",789,577,570,-7,7,0
"D17JO",606,588,"1200x900",1000,2,600,400,"False",585,350,271,-79,79,0
"D17JO",607,81,"1200x900",600,1,600,400,"True",696,225,262,37,37,0
"D17JO",608,370,"1200x900",800,2,600,400,"False",874,336,182,-154,154,0
"D17JO",609,135,"1200x900",600,1,600,400,"True",759,569,566,-3,3,0
"D17JO",610,65,"1200x900",600,0,600,400,"True",442,645,613,-32,32,1
"D17JO",611,252,"1200x900",800,0,600,400,"True",224,673,620,-53,53,1
"D17JO",612,148,"1200x900",600,2,600,400,"False",907,330,493,163,163,0
"D17JO",613,538,"1200x900",1000,1,600,400,"False",308,457,332,-125,125,1
"D17JO",614,272,"1200x900",800,0,600,400,"False",200,181,268,87,87,1
"D17JO",615,108,"1200x900",600,1,600,400,"False",830,239,382,143,143,0
"D17JO",616,233,"1200x900",800,0,600,400,"True",164,700,665,-35,35,1
"D17JO",617,240,"1200x900",800,0,600,400,"False",330,656,591,-65,65,1
"D17JO",618,215,"1200x900",600,2,600,400,"False",939,596,507,-89,89,0
"D17JO",619,116,"1200x900",600,1,600,400,"False",767,289,89,-200,200,0
"D17JO",620,156,"1200x900",600,2,600,400,"True",913,197,196,-1,1,0
"D17JO",621,30,"1200x900",600,0,600,400,"True",107,353,297,-56,56,0
"D17JO",622,497,"1200x900",1000,0,600,400,"False",106,696,606,-90,90,1
"D17JO",623,328,"1200x900",800,1,600,400,"False",104,649,488,-161,161,0
"D17JO",624,20,"1200x900",600,0,600,400,"True",204,545,554,9,9,1
"D17JO",625,140,"1200x900",600,1,600,400,"True",700,523,530,7,7,0
"D17JO",626,607,"1200x900",1000,2,600,400,"False",900,573,449,-124,124,1
"D17JO",627,490,"1200x900",1000,0,600,400,"False",114,183,338,155,155,1
"D17JO",628,315,"1200x900",800,1,600,400,"True",105,211,176,-35,35,0
"D17JO",629,73,"1200x900",600,1,600,400,"False",94,665,525,-140,140,0
"D17JO",630,429,"1200x900",800,2,600,400,"False",682,692,489,-203,203,0
"D17JO",631,430,"1200x900",800,2,600,400,"False",922,254,160,-94,94,0
"D17JO",632,567,"1200x900",1000,1,600,400,"False",655,297,201,-96,96,1
"D17JO",633,384,"1200x900",800,2,600,400,"False",821,707,441,-266,266,0
"D17JO",634,263,"1200x900",800,0,600,400,"True",82,396,397,1,1,1
"D17JO",635,56,"1200x900",600,0,600,400,"True",148,491,497,6,6,0
"D17JO",636,124,"1200x900",600,1,600,400,"False",345,467,338,-129,129,0
"D17JO",637,570,"1200x900",1000,1,600,400,"True",315,352,374,22,22,0
"D17JO",638,475,"1200x900",1000,0,600,400,"False",101,715,501,-214,214,1
"D17JO",639,231,"1200x900",800,0,600,400,"False",251,718,598,-120,120,1
"D17JO",640,100,"1200x900",600,1,600,400,"False",453,511,307,-204,204,0
"D17JO",641,294,"1200x900",800,1,600,400,"False",262,287,494,207,207,0
"D17JO",642,521,"1200x900",1000,1,600,400,"False",111,303,512,209,209,1
"D17JO",643,467,"1200x900",1000,0,600,400,"False",74,712,641,-71,71,1
"D17JO",644,526,"1200x900",1000,1,600,400,"False",497,710,514,-196,196,0
"D17JO",645,333,"1200x900",800,1,600,400,"True",521,548,596,48,48,0
"D17JO",646,455,"1200x900",1000,0,600,400,"False",107,718,545,-173,173,1
"D17JO",647,41,"1200x900",600,0,600,400,"True",370,452,490,38,38,1
"D17JO",648,585,"1200x900",1000,2,600,400,"True",698,688,608,-80,80,1
"D18TE",1,249,"1200x900",800,0,600,400,"True",126,306,285,-21,21,1
"D18TE",2,85,"1200x900",600,1,600,400,"False",434,347,506,159,159,0
"D18TE",3,42,"1200x900",600,0,600,400,"False",233,479,343,-136,136,0
"D18TE",4,62,"1200x900",600,0,600,400,"True",345,346,347,1,1,1
"D18TE",5,487,"1200x900",1000,0,600,400,"False",78,670,518,-152,152,1
"D18TE",6,443,"1200x900",1000,0,600,400,"False",99,651,512,-139,139,1
"D18TE",7,373,"1200x900",800,2,600,400,"True",694,326,382,56,56,0
"D18TE",8,59,"1200x900",600,0,600,400,"False",391,692,781,89,89,1
"D18TE",9,530,"1200x900",1000,1,600,400,"True",584,405,478,73,73,1
"D18TE",10,491,"1200x900",1000,0,600,400,"False",108,198,297,99,99,1
"D18TE",11,184,"1200x900",600,2,600,400,"False",1067,441,816,375,375,0
"D18TE",12,334,"1200x900",800,1,600,400,"False",481,665,336,-329,329,0
"D18TE",13,282,"1200x900",800,0,600,400,"True",109,246,246,0,0,1
"D18TE",14,519,"1200x900",1000,1,600,400,"True",319,565,614,49,49,1
"D18TE",15,385,"1200x900",800,2,600,400,"False",740,456,726,270,270,0
"D18TE",16,176,"1200x900",600,2,600,400,"False",1033,281,151,-130,130,0
"D18TE",17,309,"1200x900",800,1,600,400,"False",186,225,576,351,351,0
"D18TE",18,228,"1200x900",800,0,600,400,"False",174,687,616,-71,71,1
"D18TE",19,167,"1200x900",600,2,600,400,"False",956,241,87,-154,154,0
"D18TE",20,116,"1200x900",600,1,600,400,"False",767,289,54,-235,235,0
"D18TE",21,88,"1200x900",600,1,600,400,"False",186,554,763,209,209,0
"D18TE",22,621,"1200x900",1000,2,600,400,"False",540,478,273,-205,205,0
"D18TE",23,136,"1200x900",600,1,600,400,"True",264,205,158,-47,47,0
"D18TE",24,265,"1200x900",800,0,600,400,"False",229,353,195,-158,158,1
"D18TE",25,319,"1200x900",800,1,600,400,"True",494,587,601,14,14,1
"D18TE",26,177,"1200x900",600,2,600,400,"True",912,236,243,7,7,0
"D18TE",27,647,"1200x900",1000,2,600,400,"True",560,637,651,14,14,0
"D18TE",28,562,"1200x900",1000,1,600,400,"True",347,540,586,46,46,0
"D18TE",29,648,"1200x900",1000,2,600,400,"False",557,394,670,276,276,0
"D18TE",30,507,"1200x900",1000,1,600,400,"False",608,583,278,-305,305,1
"D18TE",31,151,"1200x900",600,2,600,400,"False",828,680,554,-126,126,0
"D18TE",32,587,"1200x900",1000,2,600,400,"False",741,686,487,-199,199,0
"D18TE",33,39,"1200x900",600,0,600,400,"False",210,609,524,-85,85,0
"D18TE",34,490,"1200x900",1000,0,600,400,"False",114,183,327,144,144,1
"D18TE",35,113,"1200x900",600,1,600,400,"False",897,657,504,-153,153,0
"D18TE",36,330,"1200x900",800,1,600,400,"False",759,301,235,-66,66,1
"D18TE",37,592,"1200x900",1000,2,600,400,"True",492,392,333,-59,59,0
"D18TE",38,26,"1200x900",600,0,600,400,"True",70,712,674,-38,38,0
"D18TE",39,84,"1200x900",600,1,600,400,"True",144,184,161,-23,23,0
"D18TE",40,606,"1200x900",1000,2,600,400,"True",653,627,623,-4,4,0
"D18TE",41,359,"1200x900",800,1,600,400,"True",653,241,232,-9,9,0
"D18TE",42,34,"1200x900",600,0,600,400,"False",361,242,398,156,156,1
"D18TE",43,166,"1200x900",600,2,600,400,"True",896,274,243,-31,31,0
"D18TE",44,421,"1200x900",800,2,600,400,"False",898,394,160,-234,234,0
"D18TE",45,515,"1200x900",1000,1,600,400,"False",307,217,294,77,77,0
"D18TE",46,485,"1200x900",1000,0,600,400,"False",121,694,562,-132,132,1
"D18TE",47,313,"1200x900",800,1,600,400,"True",588,421,425,4,4,0
"D18TE",48,413,"1200x900",800,2,600,400,"False",849,506,577,71,71,0
"D18TE",49,568,"1200x900",1000,1,600,400,"True",286,475,419,-56,56,1
"D18TE",50,465,"1200x900",1000,0,600,400,"False",85,203,306,103,103,1
"D18TE",51,289,"1200x900",800,1,600,400,"False",421,703,562,-141,141,1
"D18TE",52,134,"1200x900",600,1,600,400,"False",300,188,135,-53,53,0
"D18TE",53,474,"1200x900",1000,0,600,400,"False",85,339,236,-103,103,1
"D18TE",54,80,"1200x900",600,1,600,400,"True",616,423,415,-8,8,1
"D18TE",55,406,"1200x900",800,2,600,400,"False",971,233,461,228,228,0
"D18TE",56,244,"1200x900",800,0,600,400,"True",194,203,198,-5,5,1
"D18TE",57,197,"1200x900",600,2,600,400,"False",903,212,342,130,130,0
"D18TE",58,430,"1200x900",800,2,600,400,"True",922,254,229,-25,25,0
"D18TE",59,245,"1200x900",800,0,600,400,"True",296,235,199,-36,36,1
"D18TE",60,104,"1200x900",600,1,600,400,"True",448,584,617,33,33,0
"D18TE",61,452,"1200x900",1000,0,600,400,"False",97,273,395,122,122,1
"D18TE",62,513,"1200x900",1000,1,600,400,"False",235,602,124,-478,478,0
"D18TE",63,47,"1200x900",600,0,600,400,"False",303,499,397,-102,102,1
"D18TE",64,117,"1200x900",600,1,600,400,"False",711,456,178,-278,278,0
"D18TE",65,520,"1200x900",1000,1,600,400,"True",564,260,215,-45,45,0
"D18TE",66,361,"1200x900",800,2,600,400,"False",931,328,145,-183,183,0
"D18TE",67,505,"1200x900",1000,1,600,400,"False",191,484,214,-270,270,1
"D18TE",68,299,"1200x900",800,1,600,400,"False",779,274,666,392,392,0
"D18TE",69,227,"1200x900",800,0,600,400,"True",196,551,535,-16,16,1
"D18TE",70,49,"1200x900",600,0,600,400,"True",109,380,405,25,25,0
"D18TE",71,335,"1200x900",800,1,600,400,"True",124,360,344,-16,16,0
"D18TE",72,148,"1200x900",600,2,600,400,"True",907,330,308,-22,22,0
"D18TE",73,639,"1200x900",1000,2,600,400,"False",504,456,318,-138,138,0
"D18TE",74,300,"1200x900",800,1,600,400,"False",620,693,544,-149,149,0
"D18TE",75,190,"1200x900",600,2,600,400,"False",977,238,346,108,108,0
"D18TE",76,556,"1200x900",1000,1,600,400,"False",415,420,325,-95,95,0
"D18TE",77,619,"1200x900",1000,2,600,400,"False",803,247,481,234,234,0
"D18TE",78,629,"1200x900",1000,2,600,400,"False",681,257,461,204,204,0
"D18TE",79,107,"1200x900",600,1,600,400,"False",878,678,457,-221,221,0
"D18TE",80,181,"1200x900",600,2,600,400,"False",1018,223,362,139,139,0
"D18TE",81,18,"1200x900",600,0,600,400,"True",400,318,261,-57,57,1
"D18TE",82,523,"1200x900",1000,1,600,400,"False",339,318,393,75,75,0
"D18TE",83,123,"1200x900",600,1,600,400,"False",761,365,165,-200,200,1
"D18TE",84,271,"1200x900",800,0,600,400,"True",74,360,294,-66,66,1
"D18TE",85,304,"1200x900",800,1,600,400,"False",667,605,237,-368,368,0
"D18TE",86,426,"1200x900",800,2,600,400,"False",830,263,419,156,156,0
"D18TE",87,193,"1200x900",600,2,600,400,"True",874,588,568,-20,20,0
"D18TE",88,564,"1200x900",1000,1,600,400,"False",215,264,427,163,163,0
"D18TE",89,396,"1200x900",800,2,600,400,"False",678,663,544,-119,119,0
"D18TE",90,36,"1200x900",600,0,600,400,"True",128,346,306,-40,40,1
"D18TE",91,633,"1200x900",1000,2,600,400,"False",564,253,513,260,260,0
"D18TE",92,114,"1200x900",600,1,600,400,"False",183,697,545,-152,152,0
"D18TE",93,206,"1200x900",600,2,600,400,"True",975,223,268,45,45,0
"D18TE",94,120,"1200x900",600,1,600,400,"False",690,655,495,-160,160,0
"D18TE",95,196,"1200x900",600,2,600,400,"False",1030,397,222,-175,175,0
"D18TE",96,455,"1200x900",1000,0,600,400,"True",107,718,692,-26,26,1
"D18TE",97,283,"1200x900",800,0,600,400,"True",90,264,222,-42,42,1
"D18TE",98,353,"1200x900",800,1,600,400,"False",90,476,677,201,201,0
"D18TE",99,325,"1200x900",800,1,600,400,"False",105,394,217,-177,177,0
"D18TE",100,185,"1200x900",600,2,600,400,"False",907,212,69,-143,143,0
"D18TE",101,459,"1200x900",1000,0,600,400,"False",70,645,791,146,146,1
"D18TE",102,376,"1200x900",800,2,600,400,"False",788,275,135,-140,140,0
"D18TE",103,448,"1200x900",1000,0,600,400,"False",107,641,557,-84,84,1
"D18TE",104,600,"1200x900",1000,2,600,400,"True",765,207,262,55,55,0
"D18TE",105,135,"1200x900",600,1,600,400,"False",759,569,485,-84,84,0
"D18TE",106,366,"1200x900",800,2,600,400,"True",931,464,456,-8,8,0
"D18TE",107,243,"1200x900",800,0,600,400,"True",114,332,395,63,63,1
"D18TE",108,381,"1200x900",800,2,600,400,"False",705,408,334,-74,74,0
"D18TE",109,627,"1200x900",1000,2,600,400,"True",760,510,535,25,25,0
"D18TE",110,229,"1200x900",800,0,600,400,"True",117,697,710,13,13,1
"D18TE",111,77,"1200x900",600,1,600,400,"True",780,525,565,40,40,0
"D18TE",112,472,"1200x900",1000,0,600,400,"True",77,685,679,-6,6,1
"D18TE",113,580,"1200x900",1000,2,600,400,"True",651,267,146,-121,121,0
"D18TE",114,311,"1200x900",800,1,600,400,"False",710,261,433,172,172,0
"D18TE",115,60,"1200x900",600,0,600,400,"False",365,213,92,-121,121,1
"D18TE",116,276,"1200x900",800,0,600,400,"True",281,217,222,5,5,1
"D18TE",117,574,"1200x900",1000,1,600,400,"True",614,194,152,-42,42,0
"D18TE",118,189,"1200x900",600,2,600,400,"False",881,397,295,-102,102,0
"D18TE",119,23,"1200x900",600,0,600,400,"True",308,463,406,-57,57,1
"D18TE",120,527,"1200x900",1000,1,600,400,"True",565,601,614,13,13,0
"D18TE",121,571,"1200x900",1000,1,600,400,"True",239,522,534,12,12,1
"D18TE",122,337,"1200x900",800,1,600,400,"False",299,622,497,-125,125,0
"D18TE",123,441,"1200x900",1000,0,600,400,"True",85,684,751,67,67,1
"D18TE",124,473,"1200x900",1000,0,600,400,"False",75,323,242,-81,81,1
"D18TE",125,22,"1200x900",600,0,600,400,"True",398,591,575,-16,16,1
"D18TE",126,324,"1200x900",800,1,600,400,"False",719,712,409,-303,303,1
"D18TE",127,612,"1200x900",1000,2,600,400,"False",706,198,355,157,157,0
"D18TE",128,298,"1200x900",800,1,600,400,"True",311,457,416,-41,41,0
"D18TE",129,179,"1200x900",600,2,600,400,"False",908,602,762,160,160,0
"D18TE",130,548,"1200x900",1000,1,600,400,"False",103,278,385,107,107,0
"D18TE",131,30,"1200x900",600,0,600,400,"True",107,353,325,-28,28,0
"D18TE",132,99,"1200x900",600,1,600,400,"True",811,407,439,32,32,0
"D18TE",133,219,"1200x900",800,0,600,400,"True",202,502,449,-53,53,1
"D18TE",134,466,"1200x900",1000,0,600,400,"True",82,205,242,37,37,1
"D18TE",135,521,"1200x900",1000,1,600,400,"False",111,303,499,196,196,1
"D18TE",136,616,"1200x900",1000,2,600,400,"False",854,357,176,-181,181,1
"D18TE",137,3,"1200x900",600,0,600,400,"False",298,443,354,-89,89,1
"D18TE",138,415,"1200x900",800,2,600,400,"False",823,684,601,-83,83,0
"D18TE",139,362,"1200x900",800,2,600,400,"False",819,338,602,264,264,0
"D18TE",140,463,"1200x900",1000,0,600,400,"False",115,693,624,-69,69,1
"D18TE",141,482,"1200x900",1000,0,600,400,"False",79,686,792,106,106,1
"D18TE",142,642,"1200x900",1000,2,600,400,"False",776,316,600,284,284,0
"D18TE",143,591,"1200x900",1000,2,600,400,"False",698,336,190,-146,146,0
"D18TE",144,636,"1200x900",1000,2,600,400,"False",575,583,492,-91,91,0
"D18TE",145,267,"1200x900",800,0,600,400,"False",145,665,773,108,108,1
"D18TE",146,297,"1200x900",800,1,600,400,"True",625,244,249,5,5,0
"D18TE",147,383,"1200x900",800,2,600,400,"False",855,407,631,224,224,0
"D18TE",148,287,"1200x900",800,0,600,400,"True",120,567,578,11,11,1
"D18TE",149,295,"1200x900",800,1,600,400,"False",471,334,179,-155,155,0
"D18TE",150,371,"1200x900",800,2,600,400,"False",730,560,463,-97,97,0
"D18TE",151,65,"1200x900",600,0,600,400,"True",442,645,595,-50,50,1
"D18TE",152,569,"1200x900",1000,1,600,400,"False",494,720,440,-280,280,0
"D18TE",153,7,"1200x900",600,0,600,400,"True",431,654,661,7,7,1
"D18TE",154,468,"1200x900",1000,0,600,400,"False",121,219,99,-120,120,1
"D18TE",155,144,"1200x900",600,1,600,400,"True",718,371,323,-48,48,0
"D18TE",156,498,"1200x900",1000,0,600,400,"True",100,260,207,-53,53,1
"D18TE",157,6,"1200x900",600,0,600,400,"False",217,689,565,-124,124,1
"D18TE",158,357,"1200x900",800,1,600,400,"False",109,594,440,-154,154,0
"D18TE",159,529,"1200x900",1000,1,600,400,"True",267,412,423,11,11,1
"D18TE",160,8,"1200x900",600,0,600,400,"True",156,679,705,26,26,0
"D18TE",161,274,"1200x900",800,0,600,400,"True",146,497,473,-24,24,1
"D18TE",162,115,"1200x900",600,1,600,400,"False",545,307,94,-213,213,0
"D18TE",163,169,"1200x900",600,2,600,400,"True",924,290,334,44,44,0
"D18TE",164,553,"1200x900",1000,1,600,400,"False",116,712,259,-453,453,0
"D18TE",165,15,"1200x900",600,0,600,400,"False",473,352,555,203,203,1
"D18TE",166,451,"1200x900",1000,0,600,400,"False",110,702,581,-121,121,1
"D18TE",167,398,"1200x900",800,2,600,400,"True",944,698,672,-26,26,0
"D18TE",168,162,"1200x900",600,2,600,400,"True",849,279,254,-25,25,0
"D18TE",169,620,"1200x900",1000,2,600,400,"False",832,649,474,-175,175,0
"D18TE",170,146,"1200x900",600,2,600,400,"False",989,492,204,-288,288,0
"D18TE",171,58,"1200x900",600,0,600,400,"False",353,655,535,-120,120,1
"D18TE",172,503,"1200x900",1000,0,600,400,"True",86,279,217,-62,62,1
"D18TE",173,158,"1200x900",600,2,600,400,"True",939,300,374,74,74,0
"D18TE",174,1,"1200x900",600,0,600,400,"True",136,502,467,-35,35,0
"D18TE",175,438,"1200x900",1000,0,600,400,"False",77,713,611,-102,102,1
"D18TE",176,200,"1200x900",600,2,600,400,"True",897,302,323,21,21,0
"D18TE",177,380,"1200x900",800,2,600,400,"False",942,228,98,-130,130,0
"D18TE",178,432,"1200x900",800,2,600,400,"False",792,380,185,-195,195,0
"D18TE",179,212,"1200x900",600,2,600,400,"True",841,206,259,53,53,0
"D18TE",180,224,"1200x900",800,0,600,400,"False",161,474,400,-74,74,1
"D18TE",181,127,"1200x900",600,1,600,400,"True",309,691,628,-63,63,0
"D18TE",182,531,"1200x900",1000,1,600,400,"True",233,362,372,10,10,0
"D18TE",183,442,"1200x900",1000,0,600,400,"True",87,183,220,37,37,1
"D18TE",184,305,"1200x900",800,1,600,400,"False",471,716,479,-237,237,0
"D18TE",185,66,"1200x900",600,0,600,400,"True",155,673,710,37,37,0
"D18TE",186,501,"1200x900",1000,0,600,400,"True",96,323,327,4,4,1
"D18TE",187,504,"1200x900",1000,0,600,400,"True",107,699,726,27,27,1
"D18TE",188,188,"1200x900",600,2,600,400,"True",900,195,135,-60,60,0
"D18TE",189,560,"1200x900",1000,1,600,400,"False",516,693,423,-270,270,0
"D18TE",190,43,"1200x900",600,0,600,400,"True",277,446,442,-4,4,1
"D18TE",191,280,"1200x900",800,0,600,400,"True",104,302,249,-53,53,1
"D18TE",192,76,"1200x900",600,1,600,400,"True",647,614,659,45,45,0
"D18TE",193,97,"1200x900",600,1,600,400,"False",760,643,706,63,63,1
"D18TE",194,638,"1200x900",1000,2,600,400,"False",385,198,425,227,227,0
"D18TE",195,500,"1200x900",1000,0,600,400,"True",105,700,724,24,24,1
"D18TE",196,105,"1200x900",600,1,600,400,"False",527,440,633,193,193,0
"D18TE",197,153,"1200x900",600,2,600,400,"False",1037,601,676,75,75,0
"D18TE",198,528,"1200x900",1000,1,600,400,"False",839,227,680,453,453,1
"D18TE",199,460,"1200x900",1000,0,600,400,"False",155,189,328,139,139,1
"D18TE",200,572,"1200x900",1000,1,600,400,"False",302,260,391,131,131,0
"D18TE",201,291,"1200x900",800,1,600,400,"False",522,694,514,-180,180,0
"D18TE",202,542,"1200x900",1000,1,600,400,"True",304,401,384,-17,17,0
"D18TE",203,239,"1200x900",800,0,600,400,"True",114,231,241,10,10,1
"D18TE",204,567,"1200x900",1000,1,600,400,"False",655,297,58,-239,239,1
"D18TE",205,112,"1200x900",600,1,600,400,"True",681,490,446,-44,44,0
"D18TE",206,292,"1200x900",800,1,600,400,"True",88,565,505,-60,60,0
"D18TE",207,72,"1200x900",600,0,600,400,"True",158,537,509,-28,28,0
"D18TE",208,570,"1200x900",1000,1,600,400,"True",315,352,365,13,13,0
"D18TE",209,323,"1200x900",800,1,600,400,"False",388,348,490,142,142,0
"D18TE",210,264,"1200x900",800,0,600,400,"False",198,660,763,103,103,1
"D18TE",211,394,"1200x900",800,2,600,400,"False",847,292,750,458,458,0
"D18TE",212,336,"1200x900",800,1,600,400,"False",251,587,501,-86,86,0
"D18TE",213,522,"1200x900",1000,1,600,400,"True",223,379,374,-5,5,0
"D18TE",214,232,"1200x900",800,0,600,400,"True",84,511,506,-5,5,1
"D18TE",215,624,"1200x900",1000,2,600,400,"False",693,501,309,-192,192,0
"D18TE",216,159,"1200x900",600,2,600,400,"True",992,309,300,-9,9,0
"D18TE",217,262,"1200x900",800,0,600,400,"True",196,481,519,38,38,1
"D18TE",218,617,"1200x900",1000,2,600,400,"True",294,180,219,39,39,0
"D18TE",219,467,"1200x900",1000,0,600,400,"True",74,712,690,-22,22,1
"D18TE",220,355,"1200x900",800,1,600,400,"False",77,386,496,110,110,0
"D18TE",221,631,"1200x900",1000,2,600,400,"False",699,479,546,67,67,0
"D18TE",222,222,"1200x900",800,0,600,400,"False",152,206,282,76,76,1
"D18TE",223,71,"1200x900",600,0,600,400,"True",219,248,236,-12,12,0
"D18TE",224,55,"1200x900",600,0,600,400,"True",211,305,279,-26,26,1
"D18TE",225,628,"1200x900",1000,2,600,400,"False",768,410,163,-247,247,0
"D18TE",226,395,"1200x900",800,2,600,400,"False",743,334,171,-163,163,0
"D18TE",227,11,"1200x900",600,0,600,400,"True",372,670,626,-44,44,1
"D18TE",228,512,"1200x900",1000,1,600,400,"False",139,261,541,280,280,0
"D18TE",229,318,"1200x900",800,1,600,400,"False",788,534,599,65,65,0
"D18TE",230,133,"1200x900",600,1,600,400,"True",345,551,561,10,10,0
"D18TE",231,288,"1200x900",800,0,600,400,"True",180,547,611,64,64,1
"D18TE",232,479,"1200x900",1000,0,600,400,"False",74,705,622,-83,83,1
"D18TE",233,599,"1200x900",1000,2,600,400,"True",316,570,564,-6,6,0
"D18TE",234,399,"1200x900",800,2,600,400,"True",603,602,652,50,50,0
"D18TE",235,74,"1200x900",600,1,600,400,"False",115,358,276,-82,82,0
"D18TE",236,365,"1200x900",800,2,600,400,"False",1055,305,773,468,468,0
"D18TE",237,256,"1200x900",800,0,600,400,"False",192,656,552,-104,104,1
"D18TE",238,246,"1200x900",800,0,600,400,"True",196,418,438,20,20,1
"D18TE",239,37,"1200x900",600,0,600,400,"True",258,403,348,-55,55,1
"D18TE",240,581,"1200x900",1000,2,600,400,"True",310,357,303,-54,54,0
"D18TE",241,67,"1200x900",600,0,600,400,"True",289,308,254,-54,54,1
"D18TE",242,54,"1200x900",600,0,600,400,"True",474,564,551,-13,13,1
"D18TE",243,24,"1200x900",600,0,600,400,"True",430,538,527,-11,11,1
"D18TE",244,449,"1200x900",1000,0,600,400,"True",105,683,660,-23,23,1
"D18TE",245,95,"1200x900",600,1,600,400,"True",749,425,436,11,11,1
"D18TE",246,593,"1200x900",1000,2,600,400,"False",246,719,630,-89,89,0
"D18TE",247,109,"1200x900",600,1,600,400,"True",691,589,536,-53,53,0
"D18TE",248,618,"1200x900",1000,2,600,400,"False",276,671,496,-175,175,0
"D18TE",249,407,"1200x900",800,2,600,400,"True",989,340,339,-1,1,0
"D18TE",250,573,"1200x900",1000,1,600,400,"True",486,615,557,-58,58,0
"D18TE",251,202,"1200x900",600,2,600,400,"False",966,460,241,-219,219,0
"D18TE",252,547,"1200x900",1000,1,600,400,"False",369,384,646,262,262,1
"D18TE",253,634,"1200x900",1000,2,600,400,"True",735,313,303,-10,10,0
"D18TE",254,502,"1200x900",1000,0,600,400,"True",111,639,689,50,50,1
"D18TE",255,251,"1200x900",800,0,600,400,"False",88,352,163,-189,189,1
"D18TE",256,338,"1200x900",800,1,600,400,"False",813,253,422,169,169,1
"D18TE",257,259,"1200x900",800,0,600,400,"True",156,180,191,11,11,1
"D18TE",258,535,"1200x900",1000,1,600,400,"False",372,410,254,-156,156,0
"D18TE",259,82,"1200x900",600,1,600,400,"True",108,213,253,40,40,0
"D18TE",260,456,"1200x900",1000,0,600,400,"False",91,257,153,-104,104,1
"D18TE",261,175,"1200x900",600,2,600,400,"False",1028,432,363,-69,69,0
"D18TE",262,439,"1200x900",1000,0,600,400,"False",110,229,61,-168,168,1
"D18TE",263,341,"1200x900",800,1,600,400,"False",735,632,447,-185,185,1
"D18TE",264,231,"1200x900",800,0,600,400,"True",251,718,756,38,38,1
"D18TE",265,604,"1200x900",1000,2,600,400,"False",459,593,316,-277,277,0
"D18TE",266,625,"1200x900",1000,2,600,400,"True",279,228,257,29,29,0
"D18TE",267,352,"1200x900",800,1,600,400,"True",235,717,735,18,18,0
"D18TE",268,92,"1200x900",600,1,600,400,"False",624,605,663,58,58,0
"D18TE",269,509,"1200x900",1000,1,600,400,"True",509,434,489,55,55,0
"D18TE",270,16,"1200x900",600,0,600,400,"True",297,514,455,-59,59,1
"D18TE",271,563,"1200x900",1000,1,600,400,"False",201,696,565,-131,131,0
"D18TE",272,345,"1200x900",800,1,600,400,"False",841,566,631,65,65,1
"D18TE",273,561,"1200x900",1000,1,600,400,"False",231,406,485,79,79,0
"D18TE",274,583,"1200x900",1000,2,600,400,"True",949,284,321,37,37,1
"D18TE",275,31,"1200x900",600,0,600,400,"True",365,338,346,8,8,1
"D18TE",276,622,"1200x900",1000,2,600,400,"False",307,683,572,-111,111,0
"D18TE",277,121,"1200x900",600,1,600,400,"True",884,364,353,-11,11,0
"D18TE",278,388,"1200x900",800,2,600,400,"False",930,320,709,389,389,0
"D18TE",279,486,"1200x900",1000,0,600,400,"True",102,676,716,40,40,1
"D18TE",280,461,"1200x900",1000,0,600,400,"True",95,711,744,33,33,1
"D18TE",281,293,"1200x900",800,1,600,400,"True",561,396,344,-52,52,0
"D18TE",282,356,"1200x900",800,1,600,400,"True",123,484,495,11,11,0
"D18TE",283,132,"1200x900",600,1,600,400,"False",333,185,132,-53,53,0
"D18TE",284,250,"1200x900",800,0,600,400,"True",290,248,232,-16,16,1
"D18TE",285,350,"1200x900",800,1,600,400,"False",182,566,343,-223,223,0
"D18TE",286,516,"1200x900",1000,1,600,400,"True",440,559,598,39,39,0
"D18TE",287,576,"1200x900",1000,1,600,400,"False",376,713,474,-239,239,0
"D18TE",288,540,"1200x900",1000,1,600,400,"True",389,568,534,-34,34,1
"D18TE",289,40,"1200x900",600,0,600,400,"True",143,513,548,35,35,0
"D18TE",290,303,"1200x900",800,1,600,400,"False",241,431,310,-121,121,0
"D18TE",291,643,"1200x900",1000,2,600,400,"True",740,325,403,78,78,0
"D18TE",292,346,"1200x900",800,1,600,400,"True",269,635,592,-43,43,0
"D18TE",293,614,"1200x900",1000,2,600,400,"False",823,563,313,-250,250,0
"D18TE",294,110,"1200x900",600,1,600,400,"False",776,550,668,118,118,1
"D18TE",295,28,"1200x900",600,0,600,400,"False",336,410,550,140,140,1
"D18TE",296,419,"1200x900",800,2,600,400,"False",769,351,284,-67,67,0
"D18TE",297,237,"1200x900",800,0,600,400,"False",204,481,333,-148,148,1
"D18TE",298,223,"1200x900",800,0,600,400,"False",179,191,375,184,184,1
"D18TE",299,414,"1200x900",800,2,600,400,"True",831,592,591,-1,1,0
"D18TE",300,433,"1200x900",1000,0,600,400,"False",76,222,287,65,65,1
"D18TE",301,644,"1200x900",1000,2,600,400,"True",495,486,529,43,43,0
"D18TE",302,641,"1200x900",1000,2,600,400,"False",897,272,556,284,284,0
"D18TE",303,340,"1200x900",800,1,600,400,"False",226,240,516,276,276,0
"D18TE",304,141,"1200x900",600,1,600,400,"True",671,582,643,61,61,0
"D18TE",305,213,"1200x900",600,2,600,400,"True",822,275,302,27,27,0
"D18TE",306,236,"1200x900",800,0,600,400,"False",162,350,430,80,80,1
"D18TE",307,343,"1200x900",800,1,600,400,"False",407,557,334,-223,223,0
"D18TE",308,496,"1200x900",1000,0,600,400,"False",70,639,557,-82,82,1
"D18TE",309,464,"1200x900",1000,0,600,400,"False",82,222,101,-121,121,1
"D18TE",310,404,"1200x900",800,2,600,400,"True",842,396,382,-14,14,0
"D18TE",311,575,"1200x900",1000,1,600,400,"False",272,693,574,-119,119,0
"D18TE",312,301,"1200x900",800,1,600,400,"True",162,574,550,-24,24,0
"D18TE",313,170,"1200x900",600,2,600,400,"False",996,468,213,-255,255,0
"D18TE",314,13,"1200x900",600,0,600,400,"False",296,211,287,76,76,1
"D18TE",315,248,"1200x900",800,0,600,400,"True",94,240,238,-2,2,1
"D18TE",316,363,"1200x900",800,2,600,400,"True",800,218,219,1,1,0
"D18TE",317,314,"1200x900",800,1,600,400,"False",277,616,338,-278,278,1
"D18TE",318,470,"1200x900",1000,0,600,400,"True",91,666,679,13,13,1
"D18TE",319,93,"1200x900",600,1,600,400,"True",139,540,525,-15,15,0
"D18TE",320,387,"1200x900",800,2,600,400,"False",990,444,286,-158,158,0
"D18TE",321,195,"1200x900",600,2,600,400,"False",942,249,161,-88,88,0
"D18TE",322,238,"1200x900",800,0,600,400,"True",162,283,292,9,9,1
"D18TE",323,126,"1200x900",600,1,600,400,"True",849,354,391,37,37,0
"D18TE",324,183,"1200x900",600,2,600,400,"False",927,289,125,-164,164,0
"D18TE",325,613,"1200x900",1000,2,600,400,"True",690,374,393,19,19,0
"D18TE",326,418,"1200x900",800,2,600,400,"True",754,507,556,49,49,0
"D18TE",327,431,"1200x900",800,2,600,400,"True",694,382,386,4,4,0
"D18TE",328,201,"1200x900",600,2,600,400,"False",1005,462,290,-172,172,0
"D18TE",329,585,"1200x900",1000,2,600,400,"False",698,688,562,-126,126,1
"D18TE",330,253,"1200x900",800,0,600,400,"True",177,424,426,2,2,1
"D18TE",331,428,"1200x900",800,2,600,400,"True",732,665,621,-44,44,0
"D18TE",332,89,"1200x900",600,1,600,400,"True",917,366,430,64,64,1
"D18TE",333,589,"1200x900",1000,2,600,400,"False",856,418,606,188,188,0
"D18TE",334,81,"1200x900",600,1,600,400,"False",696,225,371,146,146,0
"D18TE",335,83,"1200x900",600,1,600,400,"False",763,568,409,-159,159,1
"D18TE",336,143,"1200x900",600,1,600,400,"False",479,284,373,89,89,1
"D18TE",337,90,"1200x900",600,1,600,400,"False",560,474,221,-253,253,0
"D18TE",338,275,"1200x900",800,0,600,400,"True",120,594,632,38,38,0
"D18TE",339,128,"1200x900",600,1,600,400,"True",661,258,317,59,59,1
"D18TE",340,180,"1200x900",600,2,600,400,"False",929,270,142,-128,128,0
"D18TE",341,536,"1200x900",1000,1,600,400,"False",580,213,328,115,115,0
"D18TE",342,508,"1200x900",1000,1,600,400,"False",596,485,392,-93,93,0
"D18TE",343,269,"1200x900",800,0,600,400,"True",160,295,358,63,63,1
"D18TE",344,208,"1200x900",600,2,600,400,"False",946,399,588,189,189,0
"D18TE",345,534,"1200x900",1000,1,600,400,"False",328,504,622,118,118,1
"D18TE",346,191,"1200x900",600,2,600,400,"True",962,396,346,-50,50,0
"D18TE",347,204,"1200x900",600,2,600,400,"False",1053,432,298,-134,134,0
"D18TE",348,458,"1200x900",1000,0,600,400,"True",78,624,685,61,61,1
"D18TE",349,284,"1200x900",800,0,600,400,"True",135,293,343,50,50,1
"D18TE",350,607,"1200x900",1000,2,600,400,"False",900,573,735,162,162,1
"D18TE",351,377,"1200x900",800,2,600,400,"False",683,388,228,-160,160,0
"D18TE",352,241,"1200x900",800,0,600,400,"True",129,227,237,10,10,1
"D18TE",353,640,"1200x900",1000,2,600,400,"False",361,334,413,79,79,0
"D18TE",354,495,"1200x900",1000,0,600,400,"True",93,692,656,-36,36,1
"D18TE",355,79,"1200x900",600,1,600,400,"True",731,289,337,48,48,0
"D18TE",356,307,"1200x900",800,1,600,400,"True",716,247,260,13,13,0
"D18TE",357,149,"1200x900",600,2,600,400,"True",890,289,355,66,66,0
"D18TE",358,400,"1200x900",800,2,600,400,"True",733,297,352,55,55,0
"D18TE",359,19,"1200x900",600,0,600,400,"True",286,686,624,-62,62,0
"D18TE",360,488,"1200x900",1000,0,600,400,"True",129,687,643,-44,44,1
"D18TE",361,565,"1200x900",1000,1,600,400,"True",451,562,612,50,50,0
"D18TE",362,405,"1200x900",800,2,600,400,"False",790,307,507,200,200,0
"D18TE",363,258,"1200x900",800,0,600,400,"False",126,664,485,-179,179,1
"D18TE",364,78,"1200x900",600,1,600,400,"False",885,684,472,-212,212,0
"D18TE",365,52,"1200x900",600,0,600,400,"True",171,188,178,-10,10,0
"D18TE",366,477,"1200x900",1000,0,600,400,"True",88,640,619,-21,21,1
"D18TE",367,5,"1200x900",600,0,600,400,"True",228,587,610,23,23,0
"D18TE",368,157,"1200x900",600,2,600,400,"False",1016,323,210,-113,113,0
"D18TE",369,10,"1200x900",600,0,600,400,"False",400,499,584,85,85,1
"D18TE",370,578,"1200x900",1000,2,600,400,"False",966,276,678,402,402,0
"D18TE",371,281,"1200x900",800,0,600,400,"True",112,611,607,-4,4,1
"D18TE",372,339,"1200x900",800,1,600,400,"True",273,545,604,59,59,1
"D18TE",373,445,"1200x900",1000,0,600,400,"True",78,302,346,44,44,1
"D18TE",374,368,"1200x900",800,2,600,400,"False",778,515,230,-285,285,0
"D18TE",375,462,"1200x900",1000,0,600,400,"True",102,672,673,1,1,1
"D18TE",376,294,"1200x900",800,1,600,400,"False",262,287,517,230,230,0
"D18TE",377,221,"1200x900",800,0,600,400,"False",132,520,599,79,79,1
"D18TE",378,268,"1200x900",800,0,600,400,"True",148,400,378,-22,22,1
"D18TE",379,152,"1200x900",600,2,600,400,"False",971,399,212,-187,187,0
"D18TE",380,597,"1200x900",1000,2,600,400,"True",352,239,214,-25,25,0
"D18TE",381,543,"1200x900",1000,1,600,400,"False",88,202,565,363,363,0
"D18TE",382,137,"1200x900",600,1,600,400,"True",789,577,553,-24,24,0
"D18TE",383,423,"1200x900",800,2,600,400,"True",1051,710,673,-37,37,1
"D18TE",384,279,"1200x900",800,0,600,400,"False",252,202,282,80,80,1
"D18TE",385,306,"1200x900",800,1,600,400,"False",164,524,633,109,109,0
"D18TE",386,559,"1200x900",1000,1,600,400,"False",641,244,416,172,172,0
"D18TE",387,233,"1200x900",800,0,600,400,"False",164,700,625,-75,75,1
"D18TE",388,558,"1200x900",1000,1,600,400,"True",72,464,437,-27,27,1
"D18TE",389,94,"1200x900",600,1,600,400,"False",729,482,399,-83,83,0
"D18TE",390,46,"1200x900",600,0,600,400,"True",193,355,362,7,7,1
"D18TE",391,525,"1200x900",1000,1,600,400,"False",123,690,484,-206,206,0
"D18TE",392,554,"1200x900",1000,1,600,400,"False",79,309,202,-107,107,1
"D18TE",393,131,"1200x900",600,1,600,400,"False",531,367,499,132,132,0
"D18TE",394,260,"1200x900",800,0,600,400,"False",103,525,389,-136,136,1
"D18TE",395,489,"1200x900",1000,0,600,400,"False",88,604,511,-93,93,1
"D18TE",396,579,"1200x900",1000,2,600,400,"False",803,394,639,245,245,0
"D18TE",397,64,"1200x900",600,0,600,400,"False",102,339,407,68,68,0
"D18TE",398,494,"1200x900",1000,0,600,400,"True",127,692,729,37,37,1
"D18TE",399,492,"1200x900",1000,0,600,400,"False",76,692,613,-79,79,1
"D18TE",400,247,"1200x900",800,0,600,400,"True",160,424,414,-10,10,1
"D18TE",401,526,"1200x900",1000,1,600,400,"False",497,710,590,-120,120,0
"D18TE",402,524,"1200x900",1000,1,600,400,"False",534,470,597,127,127,0
"D18TE",403,230,"1200x900",800,0,600,400,"True",99,678,689,11,11,1
"D18TE",404,436,"1200x900",1000,0,600,400,"True",82,617,664,47,47,1
"D18TE",405,550,"1200x900",1000,1,600,400,"True",301,459,444,-15,15,0
"D18TE",406,389,"1200x900",800,2,600,400,"False",843,530,223,-307,307,0
"D18TE",407,216,"1200x900",600,2,600,400,"True",1029,286,265,-21,21,0
"D18TE",408,440,"1200x900",1000,0,600,400,"True",71,237,177,-60,60,1
"D18TE",409,240,"1200x900",800,0,600,400,"True",330,656,704,48,48,1
"D18TE",410,173,"1200x900",600,2,600,400,"False",948,693,569,-124,124,0
"D18TE",411,139,"1200x900",600,1,600,400,"False",192,695,586,-109,109,0
"D18TE",412,155,"1200x900",600,2,600,400,"False",940,269,564,295,295,0
"D18TE",413,235,"1200x900",800,0,600,400,"False",146,646,769,123,123,1
"D18TE",414,171,"1200x900",600,2,600,400,"False",909,200,763,563,563,0
"D18TE",415,402,"1200x900",800,2,600,400,"True",878,234,268,34,34,0
"D18TE",416,145,"1200x900",600,2,600,400,"True",1004,630,633,3,3,0
"D18TE",417,312,"1200x900",800,1,600,400,"True",238,683,619,-64,64,0
"D18TE",418,412,"1200x900",800,2,600,400,"False",842,280,173,-107,107,0
"D18TE",419,147,"1200x900",600,2,600,400,"False",942,418,291,-127,127,0
"D18TE",420,2,"1200x900",600,0,600,400,"True",159,323,379,56,56,0
"D18TE",421,595,"1200x900",1000,2,600,400,"False",687,640,530,-110,110,0
"D18TE",422,434,"1200x900",1000,0,600,400,"True",89,657,625,-32,32,1
"D18TE",423,129,"1200x900",600,1,600,400,"False",859,482,337,-145,145,1
"D18TE",424,390,"1200x900",800,2,600,400,"False",982,674,484,-190,190,1
"D18TE",425,270,"1200x900",800,0,600,400,"True",192,418,386,-32,32,1
"D18TE",426,186,"1200x900",600,2,600,400,"True",997,197,222,25,25,0
"D18TE",427,590,"1200x900",1000,2,600,400,"False",636,278,146,-132,132,0
"D18TE",428,577,"1200x900",1000,2,600,400,"False",455,420,108,-312,312,0
"D18TE",429,226,"1200x900",800,0,600,400,"True",187,229,209,-20,20,1
"D18TE",430,331,"1200x900",800,1,600,400,"True",240,620,659,39,39,0
"D18TE",431,138,"1200x900",600,1,600,400,"True",844,580,617,37,37,1
"D18TE",432,315,"1200x900",800,1,600,400,"True",105,211,220,9,9,0
"D18TE",433,354,"1200x900",800,1,600,400,"False",118,236,155,-81,81,0
"D18TE",434,533,"1200x900",1000,1,600,400,"False",355,483,360,-123,123,0
"D18TE",435,424,"1200x900",800,2,600,400,"True",903,545,523,-22,22,0
"D18TE",436,178,"1200x900",600,2,600,400,"True",1041,510,544,34,34,0
"D18TE",437,4,"1200x900",600,0,600,400,"True",602,200,210,10,10,1
"D18TE",438,38,"1200x900",600,0,600,400,"True",120,628,679,51,51,1
"D18TE",439,263,"1200x900",800,0,600,400,"True",82,396,324,-72,72,1
"D18TE",440,471,"1200x900",1000,0,600,400,"True",122,200,240,40,40,1
"D18TE",441,102,"1200x900",600,1,600,400,"False",861,603,524,-79,79,0
"D18TE",442,349,"1200x900",800,1,600,400,"False",402,665,478,-187,187,0
"D18TE",443,566,"1200x900",1000,1,600,400,"False",378,472,306,-166,166,1
"D18TE",444,454,"1200x900",1000,0,600,400,"True",78,687,671,-16,16,1
"D18TE",445,225,"1200x900",800,0,600,400,"True",178,423,395,-28,28,1
"D18TE",446,75,"1200x900",600,1,600,400,"False",635,558,430,-128,128,0
"D18TE",447,615,"1200x900",1000,2,600,400,"False",736,634,734,100,100,0
"D18TE",448,12,"1200x900",600,0,600,400,"True",365,336,371,35,35,1
"D18TE",449,393,"1200x900",800,2,600,400,"False",657,620,496,-124,124,0
"D18TE",450,327,"1200x900",800,1,600,400,"False",152,339,262,-77,77,0
"D18TE",451,539,"1200x900",1000,1,600,400,"True",510,383,367,-16,16,0
"D18TE",452,551,"1200x900",1000,1,600,400,"True",146,445,387,-58,58,1
"D18TE",453,308,"1200x900",800,1,600,400,"False",437,425,532,107,107,0
"D18TE",454,635,"1200x900",1000,2,600,400,"False",833,402,299,-103,103,0
"D18TE",455,273,"1200x900",800,0,600,400,"True",180,309,353,44,44,1
"D18TE",456,150,"1200x900",600,2,600,400,"False",897,345,207,-138,138,0
"D18TE",457,252,"1200x900",800,0,600,400,"True",224,673,671,-2,2,1
"D18TE",458,372,"1200x900",800,2,600,400,"True",833,620,607,-13,13,0
"D18TE",459,493,"1200x900",1000,0,600,400,"True",80,582,629,47,47,1
"D18TE",460,20,"1200x900",600,0,600,400,"True",204,545,529,-16,16,1
"D18TE",461,111,"1200x900",600,1,600,400,"True",922,552,585,33,33,1
"D18TE",462,478,"1200x900",1000,0,600,400,"True",79,672,710,38,38,1
"D18TE",463,557,"1200x900",1000,1,600,400,"True",677,505,422,-83,83,1
"D18TE",464,384,"1200x900",800,2,600,400,"True",821,707,676,-31,31,0
"D18TE",465,50,"1200x900",600,0,600,400,"False",75,582,726,144,144,0
"D18TE",466,32,"1200x900",600,0,600,400,"True",152,563,606,43,43,1
"D18TE",467,172,"1200x900",600,2,600,400,"True",912,444,407,-37,37,0
"D18TE",468,296,"1200x900",800,1,600,400,"True",89,279,248,-31,31,0
"D18TE",469,326,"1200x900",800,1,600,400,"True",103,482,445,-37,37,0
"D18TE",470,626,"1200x900",1000,2,600,400,"False",329,449,633,184,184,0
"D18TE",471,369,"1200x900",800,2,600,400,"True",903,594,615,21,21,0
"D18TE",472,100,"1200x900",600,1,600,400,"False",453,511,375,-136,136,0
"D18TE",473,603,"1200x900",1000,2,600,400,"False",693,280,112,-168,168,0
"D18TE",474,637,"1200x900",1000,2,600,400,"False",750,460,590,130,130,0
"D18TE",475,411,"1200x900",800,2,600,400,"False",805,361,547,186,186,0
"D18TE",476,611,"1200x900",1000,2,600,400,"True",414,511,570,59,59,0
"D18TE",477,290,"1200x900",800,1,600,400,"True",789,603,669,66,66,0
"D18TE",478,234,"1200x900",800,0,600,400,"True",72,344,351,7,7,1
"D18TE",479,203,"1200x900",600,2,600,400,"False",938,603,751,148,148,0
"D18TE",480,538,"1200x900",1000,1,600,400,"False",308,457,350,-107,107,1
"D18TE",481,497,"1200x900",1000,0,600,400,"True",106,696,654,-42,42,1
"D18TE",482,257,"1200x900",800,0,600,400,"True",97,219,242,23,23,1
"D18TE",483,9,"1200x900",600,0,600,400,"True",509,654,622,-32,32,1
"D18TE",484,374,"1200x900",800,2,600,400,"True",755,450,479,29,29,0
"D18TE",485,552,"1200x900",1000,1,600,400,"False",255,412,592,180,180,0
"D18TE",486,437,"1200x900",1000,0,600,400,"True",74,667,681,14,14,1
"D18TE",487,217,"1200x900",800,0,600,400,"True",85,573,542,-31,31,1
"D18TE",488,594,"1200x900",1000,2,600,400,"True",537,637,648,11,11,0
"D18TE",489,328,"1200x900",800,1,600,400,"True",104,649,608,-41,41,0
"D18TE",490,602,"1200x900",1000,2,600,400,"False",865,452,342,-110,110,0
"D18TE",491,420,"1200x900",800,2,600,400,"True",519,223,248,25,25,0
"D18TE",492,475,"1200x900",1000,0,600,400,"False",101,715,599,-116,116,1
"D18TE",493,518,"1200x900",1000,1,600,400,"False",583,717,605,-112,112,0
"D18TE",494,332,"1200x900",800,1,600,400,"False",260,699,457,-242,242,0
"D18TE",495,310,"1200x900",800,1,600,400,"True",559,592,646,54,54,0
"D18TE",496,392,"1200x900",800,2,600,400,"False",1031,618,745,127,127,0
"D18TE",497,391,"1200x900",800,2,600,400,"False",895,521,213,-308,308,0
"D18TE",498,14,"1200x900",600,0,600,400,"True",399,224,255,31,31,1
"D18TE",499,517,"1200x900",1000,1,600,400,"True",548,182,201,19,19,0
"D18TE",500,453,"1200x900",1000,0,600,400,"False",71,393,248,-145,145,1
"D18TE",501,609,"1200x900",1000,2,600,400,"False",697,627,433,-194,194,0
"D18TE",502,344,"1200x900",800,1,600,400,"True",589,408,350,-58,58,0
"D18TE",503,545,"1200x900",1000,1,600,400,"False",358,562,466,-96,96,0
"D18TE",504,272,"1200x900",800,0,600,400,"True",200,181,225,44,44,1
"D18TE",505,646,"1200x900",1000,2,600,400,"True",829,227,195,-32,32,1
"D18TE",506,302,"1200x900",800,1,600,400,"True",479,467,509,42,42,1
"D18TE",507,164,"1200x900",600,2,600,400,"False",1051,268,159,-109,109,0
"D18TE",508,457,"1200x900",1000,0,600,400,"True",97,630,663,33,33,1
"D18TE",509,435,"1200x900",1000,0,600,400,"True",119,200,210,10,10,1
"D18TE",510,320,"1200x900",800,1,600,400,"False",644,376,204,-172,172,0
"D18TE",511,91,"1200x900",600,1,600,400,"False",417,630,448,-182,182,1
"D18TE",512,101,"1200x900",600,1,600,400,"True",541,656,596,-60,60,0
"D18TE",513,33,"1200x900",600,0,600,400,"True",198,533,579,46,46,1
"D18TE",514,220,"1200x900",800,0,600,400,"True",108,699,744,45,45,1
"D18TE",515,63,"1200x900",600,0,600,400,"True",311,188,167,-21,21,1
"D18TE",516,425,"1200x900",800,2,600,400,"True",621,438,412,-26,26,0
"D18TE",517,446,"1200x900",1000,0,600,400,"True",72,298,274,-24,24,1
"D18TE",518,645,"1200x900",1000,2,600,400,"False",619,396,319,-77,77,0
"D18TE",519,506,"1200x900",1000,1,600,400,"False",559,567,265,-302,302,1
"D18TE",520,546,"1200x900",1000,1,600,400,"False",305,374,507,133,133,0
"D18TE",521,364,"1200x900",800,2,600,400,"False",1018,204,587,383,383,0
"D18TE",522,444,"1200x900",1000,0,600,400,"False",101,714,579,-135,135,1
"D18TE",523,215,"1200x900",600,2,600,400,"True",939,596,580,-16,16,0
"D18TE",524,124,"1200x900",600,1,600,400,"False",345,467,359,-108,108,0
"D18TE",525,21,"1200x900",600,0,600,400,"True",314,383,381,-2,2,1
"D18TE",526,44,"1200x900",600,0,600,400,"True",305,554,545,-9,9,1
"D18TE",527,242,"1200x900",800,0,600,400,"False",117,448,539,91,91,1
"D18TE",528,537,"1200x900",1000,1,600,400,"False",621,412,619,207,207,1
"D18TE",529,481,"1200x900",1000,0,600,400,"True",80,185,220,35,35,1
"D18TE",530,194,"1200x900",600,2,600,400,"True",896,236,311,75,75,0
"D18TE",531,347,"1200x900",800,1,600,400,"False",757,295,411,116,116,1
"D18TE",532,317,"1200x900",800,1,600,400,"True",185,564,518,-46,46,0
"D18TE",533,73,"1200x900",600,1,600,400,"True",94,665,627,-38,38,0
"D18TE",534,584,"1200x900",1000,2,600,400,"True",731,413,386,-27,27,0
"D18TE",535,140,"1200x900",600,1,600,400,"True",700,523,548,25,25,0
"D18TE",536,254,"1200x900",800,0,600,400,"True",136,583,545,-38,38,1
"D18TE",537,218,"1200x900",800,0,600,400,"False",106,397,318,-79,79,1
"D18TE",538,45,"1200x900",600,0,600,400,"False",487,678,553,-125,125,1
"D18TE",539,360,"1200x900",800,1,600,400,"False",203,608,447,-161,161,0
"D18TE",540,211,"1200x900",600,2,600,400,"False",986,407,241,-166,166,0
"D18TE",541,87,"1200x900",600,1,600,400,"True",231,604,554,-50,50,0
"D18TE",542,367,"1200x900",800,2,600,400,"False",613,464,573,109,109,0
"D18TE",543,630,"1200x900",1000,2,600,400,"True",754,559,500,-59,59,0
"D18TE",544,351,"1200x900",800,1,600,400,"False",122,581,458,-123,123,0
"D18TE",545,511,"1200x900",1000,1,600,400,"False",408,390,507,117,117,1
"D18TE",546,161,"1200x900",600,2,600,400,"True",939,553,566,13,13,0
"D18TE",547,174,"1200x900",600,2,600,400,"False",998,457,231,-226,226,0
"D18TE",548,198,"1200x900",600,2,600,400,"True",976,500,447,-53,53,0
"D18TE",549,165,"1200x900",600,2,600,400,"True",912,554,545,-9,9,0
"D18TE",550,333,"1200x900",800,1,600,400,"False",521,548,732,184,184,0
"D18TE",551,61,"1200x900",600,0,600,400,"True",272,670,735,65,65,1
"D18TE",552,106,"1200x900",600,1,600,400,"False",803,659,389,-270,270,1
"D18TE",553,316,"1200x900",800,1,600,400,"False",362,319,554,235,235,0
"D18TE",554,278,"1200x900",800,0,600,400,"False",251,711,813,102,102,1
"D18TE",555,582,"1200x900",1000,2,600,400,"False",554,347,280,-67,67,0
"D18TE",556,598,"1200x900",1000,2,600,400,"False",706,559,438,-121,121,0
"D18TE",557,53,"1200x900",600,0,600,400,"False",177,189,267,78,78,0
"D18TE",558,207,"1200x900",600,2,600,400,"False",838,235,162,-73,73,0
"D18TE",559,408,"1200x900",800,2,600,400,"True",758,567,551,-16,16,0
"D18TE",560,610,"1200x900",1000,2,600,400,"True",702,293,321,28,28,0
"D18TE",561,277,"1200x900",800,0,600,400,"True",140,310,316,6,6,1
"D18TE",562,29,"1200x900",600,0,600,400,"True",385,533,511,-22,22,1
"D18TE",563,41,"1200x900",600,0,600,400,"True",370,452,477,25,25,1
"D18TE",564,450,"1200x900",1000,0,600,400,"False",130,204,308,104,104,1
"D18TE",565,255,"1200x900",800,0,600,400,"False",93,709,618,-91,91,1
"D18TE",566,476,"1200x900",1000,0,600,400,"True",76,359,361,2,2,1
"D18TE",567,409,"1200x900",800,2,600,400,"True",501,659,597,-62,62,0
"D18TE",568,199,"1200x900",600,2,600,400,"False",992,467,192,-275,275,0
"D18TE",569,261,"1200x900",800,0,600,400,"True",86,713,711,-2,2,1
"D18TE",570,122,"1200x900",600,1,600,400,"True",817,709,752,43,43,0
"D18TE",571,532,"1200x900",1000,1,600,400,"False",215,207,377,170,170,0
"D18TE",572,266,"1200x900",800,0,600,400,"True",126,303,282,-21,21,1
"D18TE",573,210,"1200x900",600,2,600,400,"True",835,506,542,36,36,0
"D18TE",574,382,"1200x900",800,2,600,400,"False",870,523,327,-196,196,0
"D18TE",575,416,"1200x900",800,2,600,400,"False",748,617,413,-204,204,0
"D18TE",576,163,"1200x900",600,2,600,400,"True",1046,665,691,26,26,0
"D18TE",577,484,"1200x900",1000,0,600,400,"True",100,223,222,-1,1,1
"D18TE",578,596,"1200x900",1000,2,600,400,"False",706,513,632,119,119,0
"D18TE",579,182,"1200x900",600,2,600,400,"False",933,389,238,-151,151,0
"D18TE",580,348,"1200x900",800,1,600,400,"False",764,294,363,69,69,0
"D18TE",581,86,"1200x900",600,1,600,400,"True",692,388,321,-67,67,1
"D18TE",582,321,"1200x900",800,1,600,400,"True",601,190,244,54,54,0
"D18TE",583,549,"1200x900",1000,1,600,400,"False",657,366,252,-114,114,0
"D18TE",584,27,"1200x900",600,0,600,400,"True",373,309,368,59,59,1
"D18TE",585,588,"1200x900",1000,2,600,400,"False",585,350,220,-130,130,0
"D18TE",586,56,"1200x900",600,0,600,400,"True",148,491,429,-62,62,0
"D18TE",587,103,"1200x900",600,1,600,400,"True",528,320,373,53,53,1
"D18TE",588,192,"1200x900",600,2,600,400,"False",1064,320,530,210,210,0
"D18TE",589,69,"1200x900",600,0,600,400,"True",322,268,280,12,12,0
"D18TE",590,480,"1200x900",1000,0,600,400,"True",100,231,289,58,58,1
"D18TE",591,447,"1200x900",1000,0,600,400,"True",71,339,358,19,19,1
"D18TE",592,187,"1200x900",600,2,600,400,"True",857,639,580,-59,59,0
"D18TE",593,125,"1200x900",600,1,600,400,"True",750,531,573,42,42,0
"D18TE",594,70,"1200x900",600,0,600,400,"True",309,703,703,0,0,1
"D18TE",595,286,"1200x900",800,0,600,400,"False",105,378,497,119,119,1
"D18TE",596,605,"1200x900",1000,2,600,400,"False",493,665,532,-133,133,0
"D18TE",597,417,"1200x900",800,2,600,400,"False",750,280,439,159,159,0
"D18TE",598,555,"1200x900",1000,1,600,400,"False",444,556,352,-204,204,0
"D18TE",599,541,"1200x900",1000,1,600,400,"True",339,478,452,-26,26,0
"D18TE",600,514,"1200x900",1000,1,600,400,"True",539,690,715,25,25,0
"D18TE",601,68,"1200x900",600,0,600,400,"False",165,367,487,120,120,0
"D18TE",602,57,"1200x900",600,0,600,400,"True",354,508,519,11,11,1
"D18TE",603,51,"1200x900",600,0,600,400,"False",272,181,252,71,71,1
"D18TE",604,329,"1200x900",800,1,600,400,"True",517,239,226,-13,13,0
"D18TE",605,342,"1200x900",800,1,600,400,"True",677,204,210,6,6,0
"D18TE",606,544,"1200x900",1000,1,600,400,"False",602,620,407,-213,213,0
"D18TE",607,483,"1200x900",1000,0,600,400,"True",93,191,195,4,4,1
"D18TE",608,499,"1200x900",1000,0,600,400,"True",93,271,229,-42,42,1
"D18TE",609,142,"1200x900",600,1,600,400,"False",286,474,608,134,134,0
"D18TE",610,510,"1200x900",1000,1,600,400,"True",486,338,290,-48,48,1
"D18TE",611,403,"1200x900",800,2,600,400,"False",625,704,553,-151,151,0
"D18TE",612,379,"1200x900",800,2,600,400,"False",994,325,596,271,271,0
"D18TE",613,601,"1200x900",1000,2,600,400,"False",735,697,375,-322,322,0
"D18TE",614,608,"1200x900",1000,2,600,400,"False",742,250,442,192,192,0
"D18TE",615,397,"1200x900",800,2,600,400,"True",817,692,709,17,17,0
"D18TE",616,205,"1200x900",600,2,600,400,"False",1021,504,634,130,130,0
"D18TE",617,623,"1200x900",1000,2,600,400,"False",636,527,322,-205,205,0
"D18TE",618,378,"1200x900",800,2,600,400,"False",1018,708,216,-492,492,0
"D18TE",619,119,"1200x900",600,1,600,400,"True",168,563,522,-41,41,0
"D18TE",620,17,"1200x900",600,0,600,400,"True",402,496,530,34,34,1
"D18TE",621,358,"1200x900",800,1,600,400,"False",263,635,162,-473,473,0
"D18TE",622,469,"1200x900",1000,0,600,400,"True",73,227,221,-6,6,1
"D18TE",623,586,"1200x900",1000,2,600,400,"False",802,262,480,218,218,0
"D18TE",624,375,"1200x900",800,2,600,400,"False",716,384,274,-110,110,0
"D18TE",625,209,"1200x900",600,2,600,400,"False",937,637,791,154,154,0
"D18TE",626,160,"1200x900",600,2,600,400,"True",863,606,586,-20,20,0
"D18TE",627,96,"1200x900",600,1,600,400,"False",433,458,526,68,68,0
"D18TE",628,410,"1200x900",800,2,600,400,"False",916,477,190,-287,287,0
"D18TE",629,25,"1200x900",600,0,600,400,"True",263,403,417,14,14,1
"D18TE",630,422,"1200x900",800,2,600,400,"False",712,558,343,-215,215,0
"D18TE",631,108,"1200x900",600,1,600,400,"True",830,239,267,28,28,0
"D18TE",632,632,"1200x900",1000,2,600,400,"False",984,227,634,407,407,0
"D18TE",633,35,"1200x900",600,0,600,400,"True",366,555,544,-11,11,1
"D18TE",634,154,"1200x900",600,2,600,400,"False",941,454,206,-248,248,0
"D18TE",635,156,"1200x900",600,2,600,400,"False",913,197,302,105,105,0
"D18TE",636,130,"1200x900",600,1,600,400,"True",741,428,364,-64,64,0
"D18TE",637,401,"1200x900",800,2,600,400,"False",821,260,121,-139,139,0
"D18TE",638,48,"1200x900",600,0,600,400,"False",323,645,568,-77,77,1
"D18TE",639,322,"1200x900",800,1,600,400,"False",703,206,333,127,127,1
"D18TE",640,118,"1200x900",600,1,600,400,"False",190,588,339,-249,249,0
"D18TE",641,214,"1200x900",600,2,600,400,"False",1046,305,189,-116,116,0
"D18TE",642,386,"1200x900",800,2,600,400,"False",774,301,426,125,125,0
"D18TE",643,98,"1200x900",600,1,600,400,"False",625,530,413,-117,117,0
"D18TE",644,168,"1200x900",600,2,600,400,"True",1001,439,404,-35,35,0
"D18TE",645,285,"1200x900",800,0,600,400,"True",237,396,347,-49,49,1
"D18TE",646,427,"1200x900",800,2,600,400,"False",812,380,294,-86,86,0
"D18TE",647,370,"1200x900",800,2,600,400,"False",874,336,158,-178,178,0
"D18TE",648,429,"1200x900",800,2,600,400,"True",682,692,687,-5,5,0
"E01CR",1,146,"1200x900",600,2,600,400,"False",989,492,334,-158,158,0
"E01CR",2,16,"1200x900",600,0,600,400,"True",297,514,499,-15,15,1
"E01CR",3,173,"1200x900",600,2,600,400,"False",948,693,819,126,126,0
"E01CR",4,167,"1200x900",600,2,600,400,"False",956,241,469,228,228,0
"E01CR",5,352,"1200x900",800,1,600,400,"True",235,717,713,-4,4,0
"E01CR",6,147,"1200x900",600,2,600,400,"False",942,418,320,-98,98,0
"E01CR",7,463,"1200x900",1000,0,600,400,"True",115,693,665,-28,28,1
"E01CR",8,482,"1200x900",1000,0,600,400,"True",79,686,686,0,0,1
"E01CR",9,188,"1200x900",600,2,600,400,"False",900,195,502,307,307,0
"E01CR",11,255,"1200x900",800,0,600,400,"True",93,709,688,-21,21,1
"E01CR",12,153,"1200x900",600,2,600,400,"True",1037,601,628,27,27,0
"E01CR",13,353,"1200x900",800,1,600,400,"False",90,476,575,99,99,0
"E01CR",14,252,"1200x900",800,0,600,400,"True",224,673,668,-5,5,1
"E01CR",15,308,"1200x900",800,1,600,400,"False",437,425,632,207,207,0
"E01CR",16,311,"1200x900",800,1,600,400,"False",710,261,481,220,220,0
"E01CR",17,122,"1200x900",600,1,600,400,"False",817,709,97,-612,612,0
"E01CR",18,630,"1200x900",1000,2,600,400,"False",754,559,747,188,188,0
"E01CR",19,464,"1200x900",1000,0,600,400,"False",82,222,338,116,116,1
"E01CR",20,340,"1200x900",800,1,600,400,"False",226,240,696,456,456,0
"E01CR",21,435,"1200x900",1000,0,600,400,"False",119,200,453,253,253,1
"E01CR",22,36,"1200x900",600,0,600,400,"True",128,346,387,41,41,1
"E01CR",23,640,"1200x900",1000,2,600,400,"False",361,334,522,188,188,0
"E01CR",24,59,"1200x900",600,0,600,400,"True",391,692,664,-28,28,1
"E01CR",25,140,"1200x900",600,1,600,400,"True",700,523,538,15,15,0
"E01CR",26,514,"1200x900",1000,1,600,400,"True",539,690,681,-9,9,0
"E01CR",27,157,"1200x900",600,2,600,400,"False",1016,323,163,-160,160,0
"E01CR",28,594,"1200x900",1000,2,600,400,"False",537,637,277,-360,360,0
"E01CR",29,67,"1200x900",600,0,600,400,"False",289,308,416,108,108,1
"E01CR",30,103,"1200x900",600,1,600,400,"False",528,320,402,82,82,1
"E01CR",31,613,"1200x900",1000,2,600,400,"False",690,374,641,267,267,0
"E01CR",32,460,"1200x900",1000,0,600,400,"False",155,189,393,204,204,1
"E01CR",33,645,"1200x900",1000,2,600,400,"True",619,396,383,-13,13,0
"E01CR",34,505,"1200x900",1000,1,600,400,"False",191,484,600,116,116,1
"E01CR",35,314,"1200x900",800,1,600,400,"True",277,616,557,-59,59,1
"E01CR",36,556,"1200x900",1000,1,600,400,"False",415,420,521,101,101,0
"E01CR",37,271,"1200x900",800,0,600,400,"True",74,360,382,22,22,1
"E01CR",38,136,"1200x900",600,1,600,400,"False",264,205,54,-151,151,0
"E01CR",39,467,"1200x900",1000,0,600,400,"True",74,712,659,-53,53,1
"E01CR",40,334,"1200x900",800,1,600,400,"True",481,665,673,8,8,0
"E01CR",41,548,"1200x900",1000,1,600,400,"False",103,278,376,98,98,0
"E01CR",42,116,"1200x900",600,1,600,400,"False",767,289,579,290,290,0
"E01CR",43,19,"1200x900",600,0,600,400,"False",286,686,621,-65,65,0
"E01CR",44,428,"1200x900",800,2,600,400,"True",732,665,687,22,22,0
"E01CR",45,307,"1200x900",800,1,600,400,"True",716,247,270,23,23,0
"E01CR",46,474,"1200x900",1000,0,600,400,"False",85,339,228,-111,111,1
"E01CR",47,48,"1200x900",600,0,600,400,"True",323,645,633,-12,12,1
"E01CR",48,52,"1200x900",600,0,600,400,"True",171,188,171,-17,17,0
"E01CR",49,453,"1200x900",1000,0,600,400,"True",71,393,388,-5,5,1
"E01CR",50,181,"1200x900",600,2,600,400,"True",1018,223,191,-32,32,0
"E01CR",51,592,"1200x900",1000,2,600,400,"False",492,392,532,140,140,0
"E01CR",52,28,"1200x900",600,0,600,400,"True",336,410,429,19,19,1
"E01CR",53,627,"1200x900",1000,2,600,400,"False",760,510,772,262,262,0
"E01CR",54,38,"1200x900",600,0,600,400,"True",120,628,677,49,49,1
"E01CR",55,148,"1200x900",600,2,600,400,"True",907,330,380,50,50,0
"E01CR",56,528,"1200x900",1000,1,600,400,"False",839,227,596,369,369,1
"E01CR",57,249,"1200x900",800,0,600,400,"True",126,306,316,10,10,1
"E01CR",58,124,"1200x900",600,1,600,400,"True",345,467,500,33,33,0
"E01CR",59,194,"1200x900",600,2,600,400,"False",896,236,85,-151,151,0
"E01CR",60,589,"1200x900",1000,2,600,400,"False",856,418,508,90,90,0
"E01CR",61,516,"1200x900",1000,1,600,400,"False",440,559,455,-104,104,0
"E01CR",62,235,"1200x900",800,0,600,400,"True",146,646,625,-21,21,1
"E01CR",63,72,"1200x900",600,0,600,400,"True",158,537,499,-38,38,0
"E01CR",64,408,"1200x900",800,2,600,400,"True",758,567,514,-53,53,0
"E01CR",65,156,"1200x900",600,2,600,400,"True",913,197,197,0,0,0
"E01CR",66,163,"1200x900",600,2,600,400,"True",1046,665,561,-104,104,0
"E01CR",67,205,"1200x900",600,2,600,400,"False",1021,504,728,224,224,0
"E01CR",68,478,"1200x900",1000,0,600,400,"True",79,672,645,-27,27,1
"E01CR",69,455,"1200x900",1000,0,600,400,"True",107,718,674,-44,44,1
"E01CR",70,106,"1200x900",600,1,600,400,"False",803,659,558,-101,101,1
"E01CR",71,360,"1200x900",800,1,600,400,"False",203,608,428,-180,180,0
"E01CR",72,174,"1200x900",600,2,600,400,"False",998,457,317,-140,140,0
"E01CR",73,224,"1200x900",800,0,600,400,"True",161,474,496,22,22,1
"E01CR",74,414,"1200x900",800,2,600,400,"False",831,592,420,-172,172,0
"E01CR",75,448,"1200x900",1000,0,600,400,"True",107,641,611,-30,30,1
"E01CR",76,108,"1200x900",600,1,600,400,"False",830,239,408,169,169,0
"E01CR",77,233,"1200x900",800,0,600,400,"True",164,700,705,5,5,1
"E01CR",78,483,"1200x900",1000,0,600,400,"True",93,191,187,-4,4,1
"E01CR",79,96,"1200x900",600,1,600,400,"True",433,458,444,-14,14,0
"E01CR",80,195,"1200x900",600,2,600,400,"False",942,249,407,158,158,0
"E01CR",81,494,"1200x900",1000,0,600,400,"False",127,692,584,-108,108,1
"E01CR",82,359,"1200x900",800,1,600,400,"False",653,241,340,99,99,0
"E01CR",83,434,"1200x900",1000,0,600,400,"False",89,657,495,-162,162,1
"E01CR",84,262,"1200x900",800,0,600,400,"True",196,481,512,31,31,1
"E01CR",85,614,"1200x900",1000,2,600,400,"False",823,563,216,-347,347,0
"E01CR",86,591,"1200x900",1000,2,600,400,"False",698,336,538,202,202,0
"E01CR",87,257,"1200x900",800,0,600,400,"True",97,219,219,0,0,1
"E01CR",88,426,"1200x900",800,2,600,400,"False",830,263,355,92,92,0
"E01CR",89,39,"1200x900",600,0,600,400,"False",210,609,458,-151,151,0
"E01CR",90,619,"1200x900",1000,2,600,400,"False",803,247,667,420,420,0
"E01CR",91,531,"1200x900",1000,1,600,400,"True",233,362,411,49,49,0
"E01CR",92,269,"1200x900",800,0,600,400,"True",160,295,339,44,44,1
"E01CR",93,458,"1200x900",1000,0,600,400,"False",78,624,520,-104,104,1
"E01CR",94,420,"1200x900",800,2,600,400,"False",519,223,544,321,321,0
"E01CR",95,541,"1200x900",1000,1,600,400,"True",339,478,440,-38,38,0
"E01CR",96,602,"1200x900",1000,2,600,400,"True",865,452,411,-41,41,0
"E01CR",97,459,"1200x900",1000,0,600,400,"False",70,645,553,-92,92,1
"E01CR",98,282,"1200x900",800,0,600,400,"True",109,246,247,1,1,1
"E01CR",99,241,"1200x900",800,0,600,400,"True",129,227,173,-54,54,1
"E01CR",100,166,"1200x900",600,2,600,400,"True",896,274,257,-17,17,0
"E01CR",101,346,"1200x900",800,1,600,400,"False",269,635,382,-253,253,0
"E01CR",102,639,"1200x900",1000,2,600,400,"False",504,456,525,69,69,0
"E01CR",103,30,"1200x900",600,0,600,400,"True",107,353,390,37,37,0
"E01CR",104,250,"1200x900",800,0,600,400,"False",290,248,337,89,89,1
"E01CR",105,561,"1200x900",1000,1,600,400,"False",231,406,673,267,267,0
"E01CR",106,64,"1200x900",600,0,600,400,"True",102,339,348,9,9,0
"E01CR",107,139,"1200x900",600,1,600,400,"True",192,695,638,-57,57,0
"E01CR",108,644,"1200x900",1000,2,600,400,"False",495,486,627,141,141,0
"E01CR",109,607,"1200x900",1000,2,600,400,"False",900,573,804,231,231,1
"E01CR",110,358,"1200x900",800,1,600,400,"False",263,635,226,-409,409,0
"E01CR",111,58,"1200x900",600,0,600,400,"False",353,655,581,-74,74,1
"E01CR",112,9,"1200x900",600,0,600,400,"False",509,654,528,-126,126,1
"E01CR",113,91,"1200x900",600,1,600,400,"True",417,630,605,-25,25,1
"E01CR",114,78,"1200x900",600,1,600,400,"True",885,684,685,1,1,0
"E01CR",115,472,"1200x900",1000,0,600,400,"True",77,685,756,71,71,1
"E01CR",116,508,"1200x900",1000,1,600,400,"True",596,485,549,64,64,0
"E01CR",117,273,"1200x900",800,0,600,400,"True",180,309,343,34,34,1
"E01CR",118,532,"1200x900",1000,1,600,400,"False",215,207,415,208,208,0
"E01CR",119,281,"1200x900",800,0,600,400,"True",112,611,557,-54,54,1
"E01CR",120,377,"1200x900",800,2,600,400,"True",683,388,400,12,12,0
"E01CR",121,486,"1200x900",1000,0,600,400,"False",102,676,525,-151,151,1
"E01CR",122,612,"1200x900",1000,2,600,400,"True",706,198,272,74,74,0
"E01CR",123,165,"1200x900",600,2,600,400,"True",912,554,563,9,9,0
"E01CR",124,375,"1200x900",800,2,600,400,"True",716,384,376,-8,8,0
"E01CR",125,303,"1200x900",800,1,600,400,"False",241,431,548,117,117,0
"E01CR",126,574,"1200x900",1000,1,600,400,"False",614,194,316,122,122,0
"E01CR",127,615,"1200x900",1000,2,600,400,"True",736,634,688,54,54,0
"E01CR",128,581,"1200x900",1000,2,600,400,"True",310,357,424,67,67,0
"E01CR",129,598,"1200x900",1000,2,600,400,"True",706,559,509,-50,50,0
"E01CR",130,479,"1200x900",1000,0,600,400,"False",74,705,566,-139,139,1
"E01CR",131,344,"1200x900",800,1,600,400,"False",589,408,489,81,81,0
"E01CR",132,423,"1200x900",800,2,600,400,"True",1051,710,716,6,6,1
"E01CR",133,616,"1200x900",1000,2,600,400,"False",854,357,244,-113,113,1
"E01CR",134,368,"1200x900",800,2,600,400,"False",778,515,358,-157,157,0
"E01CR",135,429,"1200x900",800,2,600,400,"True",682,692,653,-39,39,0
"E01CR",136,647,"1200x900",1000,2,600,400,"False",560,637,720,83,83,0
"E01CR",137,349,"1200x900",800,1,600,400,"False",402,665,736,71,71,0
"E01CR",138,128,"1200x900",600,1,600,400,"False",661,258,100,-158,158,1
"E01CR",139,416,"1200x900",800,2,600,400,"False",748,617,305,-312,312,0
"E01CR",140,642,"1200x900",1000,2,600,400,"False",776,316,644,328,328,0
"E01CR",141,134,"1200x900",600,1,600,400,"True",300,188,243,55,55,0
"E01CR",142,618,"1200x900",1000,2,600,400,"True",276,671,673,2,2,0
"E01CR",143,579,"1200x900",1000,2,600,400,"False",803,394,639,245,245,0
"E01CR",144,270,"1200x900",800,0,600,400,"True",192,418,433,15,15,1
"E01CR",145,43,"1200x900",600,0,600,400,"True",277,446,488,42,42,1
"E01CR",146,315,"1200x900",800,1,600,400,"True",105,211,254,43,43,0
"E01CR",147,7,"1200x900",600,0,600,400,"True",431,654,622,-32,32,1
"E01CR",148,553,"1200x900",1000,1,600,400,"False",116,712,183,-529,529,0
"E01CR",149,145,"1200x900",600,2,600,400,"False",1004,630,707,77,77,0
"E01CR",150,239,"1200x900",800,0,600,400,"False",114,231,340,109,109,1
"E01CR",151,395,"1200x900",800,2,600,400,"True",743,334,319,-15,15,0
"E01CR",152,216,"1200x900",600,2,600,400,"False",1029,286,141,-145,145,0
"E01CR",153,237,"1200x900",800,0,600,400,"True",204,481,496,15,15,1
"E01CR",154,394,"1200x900",800,2,600,400,"False",847,292,523,231,231,0
"E01CR",155,293,"1200x900",800,1,600,400,"True",561,396,387,-9,9,0
"E01CR",156,493,"1200x900",1000,0,600,400,"False",80,582,384,-198,198,1
"E01CR",157,402,"1200x900",800,2,600,400,"True",878,234,313,79,79,0
"E01CR",158,601,"1200x900",1000,2,600,400,"False",735,697,300,-397,397,0
"E01CR",159,512,"1200x900",1000,1,600,400,"False",139,261,529,268,268,0
"E01CR",160,23,"1200x900",600,0,600,400,"True",308,463,492,29,29,1
"E01CR",161,382,"1200x900",800,2,600,400,"False",870,523,334,-189,189,0
"E01CR",162,223,"1200x900",800,0,600,400,"True",179,191,230,39,39,1
"E01CR",163,111,"1200x900",600,1,600,400,"True",922,552,554,2,2,1
"E01CR",164,537,"1200x900",1000,1,600,400,"False",621,412,672,260,260,1
"E01CR",165,20,"1200x900",600,0,600,400,"True",204,545,523,-22,22,1
"E01CR",166,539,"1200x900",1000,1,600,400,"False",510,383,459,76,76,0
"E01CR",167,582,"1200x900",1000,2,600,400,"False",554,347,284,-63,63,0
"E01CR",168,312,"1200x900",800,1,600,400,"True",238,683,698,15,15,0
"E01CR",169,580,"1200x900",1000,2,600,400,"True",651,267,303,36,36,0
"E01CR",170,92,"1200x900",600,1,600,400,"False",624,605,723,118,118,0
"E01CR",171,372,"1200x900",800,2,600,400,"True",833,620,662,42,42,0
"E01CR",172,540,"1200x900",1000,1,600,400,"False",389,568,381,-187,187,1
"E01CR",173,384,"1200x900",800,2,600,400,"True",821,707,660,-47,47,0
"E01CR",174,617,"1200x900",1000,2,600,400,"False",294,180,519,339,339,0
"E01CR",175,198,"1200x900",600,2,600,400,"False",976,500,689,189,189,0
"E01CR",176,294,"1200x900",800,1,600,400,"False",262,287,494,207,207,0
"E01CR",177,480,"1200x900",1000,0,600,400,"False",100,231,296,65,65,1
"E01CR",178,446,"1200x900",1000,0,600,400,"True",72,298,305,7,7,1
"E01CR",179,75,"1200x900",600,1,600,400,"False",635,558,304,-254,254,0
"E01CR",180,221,"1200x900",800,0,600,400,"True",132,520,564,44,44,1
"E01CR",181,633,"1200x900",1000,2,600,400,"False",564,253,612,359,359,0
"E01CR",182,376,"1200x900",800,2,600,400,"True",788,275,260,-15,15,0
"E01CR",183,68,"1200x900",600,0,600,400,"True",165,367,405,38,38,0
"E01CR",184,60,"1200x900",600,0,600,400,"True",365,213,262,49,49,1
"E01CR",185,511,"1200x900",1000,1,600,400,"False",408,390,510,120,120,1
"E01CR",186,142,"1200x900",600,1,600,400,"True",286,474,495,21,21,0
"E01CR",187,196,"1200x900",600,2,600,400,"False",1030,397,219,-178,178,0
"E01CR",188,513,"1200x900",1000,1,600,400,"False",235,602,322,-280,280,0
"E01CR",189,21,"1200x900",600,0,600,400,"True",314,383,351,-32,32,1
"E01CR",190,123,"1200x900",600,1,600,400,"False",761,365,220,-145,145,1
"E01CR",191,253,"1200x900",800,0,600,400,"True",177,424,394,-30,30,1
"E01CR",192,298,"1200x900",800,1,600,400,"False",311,457,631,174,174,0
"E01CR",193,322,"1200x900",800,1,600,400,"True",703,206,262,56,56,1
"E01CR",194,272,"1200x900",800,0,600,400,"True",200,181,149,-32,32,1
"E01CR",195,410,"1200x900",800,2,600,400,"True",916,477,435,-42,42,0
"E01CR",196,604,"1200x900",1000,2,600,400,"True",459,593,608,15,15,0
"E01CR",197,389,"1200x900",800,2,600,400,"False",843,530,431,-99,99,0
"E01CR",198,54,"1200x900",600,0,600,400,"True",474,564,528,-36,36,1
"E01CR",199,70,"1200x900",600,0,600,400,"True",309,703,725,22,22,1
"E01CR",200,218,"1200x900",800,0,600,400,"False",106,397,472,75,75,1
"E01CR",201,259,"1200x900",800,0,600,400,"False",156,180,321,141,141,1
"E01CR",202,412,"1200x900",800,2,600,400,"True",842,280,358,78,78,0
"E01CR",203,66,"1200x900",600,0,600,400,"False",155,673,546,-127,127,0
"E01CR",204,525,"1200x900",1000,1,600,400,"False",123,690,603,-87,87,0
"E01CR",205,289,"1200x900",800,1,600,400,"False",421,703,771,68,68,1
"E01CR",206,212,"1200x900",600,2,600,400,"False",841,206,469,263,263,0
"E01CR",207,152,"1200x900",600,2,600,400,"False",971,399,291,-108,108,0
"E01CR",208,361,"1200x900",800,2,600,400,"False",931,328,509,181,181,0
"E01CR",209,436,"1200x900",1000,0,600,400,"True",82,617,604,-13,13,1
"E01CR",210,590,"1200x900",1000,2,600,400,"False",636,278,525,247,247,0
"E01CR",211,132,"1200x900",600,1,600,400,"True",333,185,273,88,88,0
"E01CR",212,89,"1200x900",600,1,600,400,"False",917,366,614,248,248,1
"E01CR",213,599,"1200x900",1000,2,600,400,"False",316,570,400,-170,170,0
"E01CR",214,184,"1200x900",600,2,600,400,"False",1067,441,508,67,67,0
"E01CR",215,403,"1200x900",800,2,600,400,"True",625,704,684,-20,20,0
"E01CR",216,386,"1200x900",800,2,600,400,"True",774,301,289,-12,12,0
"E01CR",217,227,"1200x900",800,0,600,400,"False",196,551,476,-75,75,1
"E01CR",218,144,"1200x900",600,1,600,400,"False",718,371,548,177,177,0
"E01CR",219,487,"1200x900",1000,0,600,400,"False",78,670,501,-169,169,1
"E01CR",220,575,"1200x900",1000,1,600,400,"False",272,693,589,-104,104,0
"E01CR",221,11,"1200x900",600,0,600,400,"True",372,670,632,-38,38,1
"E01CR",222,190,"1200x900",600,2,600,400,"True",977,238,334,96,96,0
"E01CR",223,176,"1200x900",600,2,600,400,"False",1033,281,408,127,127,0
"E01CR",224,476,"1200x900",1000,0,600,400,"False",76,359,264,-95,95,1
"E01CR",225,631,"1200x900",1000,2,600,400,"True",699,479,466,-13,13,0
"E01CR",226,397,"1200x900",800,2,600,400,"False",817,692,605,-87,87,0
"E01CR",227,335,"1200x900",800,1,600,400,"True",124,360,415,55,55,0
"E01CR",228,325,"1200x900",800,1,600,400,"False",105,394,301,-93,93,0
"E01CR",229,585,"1200x900",1000,2,600,400,"False",698,688,563,-125,125,1
"E01CR",230,466,"1200x900",1000,0,600,400,"False",82,205,300,95,95,1
"E01CR",231,29,"1200x900",600,0,600,400,"True",385,533,484,-49,49,1
"E01CR",232,391,"1200x900",800,2,600,400,"False",895,521,368,-153,153,0
"E01CR",233,468,"1200x900",1000,0,600,400,"False",121,219,384,165,165,1
"E01CR",234,477,"1200x900",1000,0,600,400,"False",88,640,531,-109,109,1
"E01CR",235,57,"1200x900",600,0,600,400,"True",354,508,482,-26,26,1
"E01CR",236,76,"1200x900",600,1,600,400,"True",647,614,668,54,54,0
"E01CR",237,444,"1200x900",1000,0,600,400,"True",101,714,680,-34,34,1
"E01CR",238,406,"1200x900",800,2,600,400,"False",971,233,583,350,350,0
"E01CR",239,27,"1200x900",600,0,600,400,"False",373,309,421,112,112,1
"E01CR",240,201,"1200x900",600,2,600,400,"False",1005,462,220,-242,242,0
"E01CR",241,445,"1200x900",1000,0,600,400,"True",78,302,307,5,5,1
"E01CR",242,354,"1200x900",800,1,600,400,"False",118,236,392,156,156,0
"E01CR",243,232,"1200x900",800,0,600,400,"True",84,511,518,7,7,1
"E01CR",244,563,"1200x900",1000,1,600,400,"True",201,696,672,-24,24,0
"E01CR",245,404,"1200x900",800,2,600,400,"False",842,396,551,155,155,0
"E01CR",246,85,"1200x900",600,1,600,400,"True",434,347,383,36,36,0
"E01CR",247,47,"1200x900",600,0,600,400,"True",303,499,531,32,32,1
"E01CR",248,437,"1200x900",1000,0,600,400,"True",74,667,628,-39,39,1
"E01CR",249,109,"1200x900",600,1,600,400,"True",691,589,602,13,13,0
"E01CR",250,443,"1200x900",1000,0,600,400,"True",99,651,613,-38,38,1
"E01CR",251,46,"1200x900",600,0,600,400,"True",193,355,407,52,52,1
"E01CR",252,131,"1200x900",600,1,600,400,"True",531,367,414,47,47,0
"E01CR",253,484,"1200x900",1000,0,600,400,"False",100,223,317,94,94,1
"E01CR",254,102,"1200x900",600,1,600,400,"True",861,603,646,43,43,0
"E01CR",255,94,"1200x900",600,1,600,400,"True",729,482,459,-23,23,0
"E01CR",256,127,"1200x900",600,1,600,400,"False",309,691,392,-299,299,0
"E01CR",257,320,"1200x900",800,1,600,400,"False",644,376,629,253,253,0
"E01CR",258,371,"1200x900",800,2,600,400,"False",730,560,641,81,81,0
"E01CR",259,208,"1200x900",600,2,600,400,"False",946,399,668,269,269,0
"E01CR",260,81,"1200x900",600,1,600,400,"False",696,225,493,268,268,0
"E01CR",261,287,"1200x900",800,0,600,400,"True",120,567,601,34,34,1
"E01CR",262,31,"1200x900",600,0,600,400,"True",365,338,361,23,23,1
"E01CR",263,251,"1200x900",800,0,600,400,"True",88,352,400,48,48,1
"E01CR",264,341,"1200x900",800,1,600,400,"False",735,632,720,88,88,1
"E01CR",265,316,"1200x900",800,1,600,400,"False",362,319,447,128,128,0
"E01CR",266,149,"1200x900",600,2,600,400,"False",890,289,201,-88,88,0
"E01CR",267,495,"1200x900",1000,0,600,400,"False",93,692,563,-129,129,1
"E01CR",268,496,"1200x900",1000,0,600,400,"True",70,639,624,-15,15,1
"E01CR",269,369,"1200x900",800,2,600,400,"False",903,594,702,108,108,0
"E01CR",270,605,"1200x900",1000,2,600,400,"False",493,665,531,-134,134,0
"E01CR",271,465,"1200x900",1000,0,600,400,"False",85,203,348,145,145,1
"E01CR",272,41,"1200x900",600,0,600,400,"True",370,452,445,-7,7,1
"E01CR",273,178,"1200x900",600,2,600,400,"False",1041,510,687,177,177,0
"E01CR",274,461,"1200x900",1000,0,600,400,"True",95,711,697,-14,14,1
"E01CR",275,500,"1200x900",1000,0,600,400,"True",105,700,696,-4,4,1
"E01CR",276,299,"1200x900",800,1,600,400,"False",779,274,506,232,232,0
"E01CR",277,610,"1200x900",1000,2,600,400,"True",702,293,368,75,75,0
"E01CR",278,240,"1200x900",800,0,600,400,"False",330,656,556,-100,100,1
"E01CR",279,515,"1200x900",1000,1,600,400,"False",307,217,407,190,190,0
"E01CR",280,215,"1200x900",600,2,600,400,"False",939,596,463,-133,133,0
"E01CR",281,159,"1200x900",600,2,600,400,"False",992,309,222,-87,87,0
"E01CR",282,309,"1200x900",800,1,600,400,"False",186,225,427,202,202,0
"E01CR",283,586,"1200x900",1000,2,600,400,"False",802,262,510,248,248,0
"E01CR",284,583,"1200x900",1000,2,600,400,"True",949,284,348,64,64,1
"E01CR",285,507,"1200x900",1000,1,600,400,"True",608,583,552,-31,31,1
"E01CR",286,620,"1200x900",1000,2,600,400,"False",832,649,258,-391,391,0
"E01CR",287,18,"1200x900",600,0,600,400,"True",400,318,306,-12,12,1
"E01CR",288,439,"1200x900",1000,0,600,400,"True",110,229,216,-13,13,1
"E01CR",289,355,"1200x900",800,1,600,400,"False",77,386,661,275,275,0
"E01CR",290,225,"1200x900",800,0,600,400,"True",178,423,456,33,33,1
"E01CR",291,399,"1200x900",800,2,600,400,"False",603,602,404,-198,198,0
"E01CR",292,302,"1200x900",800,1,600,400,"False",479,467,582,115,115,1
"E01CR",293,275,"1200x900",800,0,600,400,"True",120,594,550,-44,44,0
"E01CR",294,187,"1200x900",600,2,600,400,"False",857,639,535,-104,104,0
"E01CR",295,577,"1200x900",1000,2,600,400,"True",455,420,493,73,73,0
"E01CR",296,427,"1200x900",800,2,600,400,"True",812,380,439,59,59,0
"E01CR",297,170,"1200x900",600,2,600,400,"True",996,468,431,-37,37,0
"E01CR",298,243,"1200x900",800,0,600,400,"True",114,332,380,48,48,1
"E01CR",299,120,"1200x900",600,1,600,400,"False",690,655,393,-262,262,0
"E01CR",300,236,"1200x900",800,0,600,400,"True",162,350,399,49,49,1
"E01CR",301,22,"1200x900",600,0,600,400,"False",398,591,521,-70,70,1
"E01CR",302,125,"1200x900",600,1,600,400,"True",750,531,567,36,36,0
"E01CR",303,290,"1200x900",800,1,600,400,"True",789,603,566,-37,37,0
"E01CR",304,456,"1200x900",1000,0,600,400,"False",91,257,370,113,113,1
"E01CR",305,327,"1200x900",800,1,600,400,"False",152,339,202,-137,137,0
"E01CR",306,535,"1200x900",1000,1,600,400,"False",372,410,166,-244,244,0
"E01CR",307,87,"1200x900",600,1,600,400,"True",231,604,619,15,15,0
"E01CR",308,189,"1200x900",600,2,600,400,"True",881,397,393,-4,4,0
"E01CR",309,342,"1200x900",800,1,600,400,"False",677,204,288,84,84,0
"E01CR",310,268,"1200x900",800,0,600,400,"True",148,400,397,-3,3,1
"E01CR",311,571,"1200x900",1000,1,600,400,"False",239,522,660,138,138,1
"E01CR",312,228,"1200x900",800,0,600,400,"True",174,687,658,-29,29,1
"E01CR",313,73,"1200x900",600,1,600,400,"True",94,665,594,-71,71,0
"E01CR",314,210,"1200x900",600,2,600,400,"False",835,506,663,157,157,0
"E01CR",315,71,"1200x900",600,0,600,400,"False",219,248,365,117,117,0
"E01CR",316,536,"1200x900",1000,1,600,400,"False",580,213,311,98,98,0
"E01CR",317,457,"1200x900",1000,0,600,400,"False",97,630,481,-149,149,1
"E01CR",318,433,"1200x900",1000,0,600,400,"False",76,222,362,140,140,1
"E01CR",319,80,"1200x900",600,1,600,400,"False",616,423,630,207,207,1
"E01CR",320,3,"1200x900",600,0,600,400,"True",298,443,459,16,16,1
"E01CR",321,313,"1200x900",800,1,600,400,"True",588,421,435,14,14,0
"E01CR",322,2,"1200x900",600,0,600,400,"True",159,323,302,-21,21,0
"E01CR",323,504,"1200x900",1000,0,600,400,"True",107,699,639,-60,60,1
"E01CR",324,326,"1200x900",800,1,600,400,"False",103,482,634,152,152,0
"E01CR",325,499,"1200x900",1000,0,600,400,"True",93,271,280,9,9,1
"E01CR",326,584,"1200x900",1000,2,600,400,"True",731,413,369,-44,44,0
"E01CR",327,82,"1200x900",600,1,600,400,"True",108,213,282,69,69,0
"E01CR",328,566,"1200x900",1000,1,600,400,"True",378,472,427,-45,45,1
"E01CR",329,256,"1200x900",800,0,600,400,"True",192,656,641,-15,15,1
"E01CR",330,405,"1200x900",800,2,600,400,"False",790,307,478,171,171,0
"E01CR",331,202,"1200x900",600,2,600,400,"False",966,460,331,-129,129,0
"E01CR",332,17,"1200x900",600,0,600,400,"True",402,496,511,15,15,1
"E01CR",333,118,"1200x900",600,1,600,400,"False",190,588,432,-156,156,0
"E01CR",334,421,"1200x900",800,2,600,400,"False",898,394,544,150,150,0
"E01CR",335,230,"1200x900",800,0,600,400,"True",99,678,681,3,3,1
"E01CR",336,595,"1200x900",1000,2,600,400,"False",687,640,538,-102,102,0
"E01CR",337,611,"1200x900",1000,2,600,400,"True",414,511,516,5,5,0
"E01CR",338,113,"1200x900",600,1,600,400,"True",897,657,681,24,24,0
"E01CR",339,603,"1200x900",1000,2,600,400,"False",693,280,373,93,93,0
"E01CR",340,279,"1200x900",800,0,600,400,"False",252,202,295,93,93,1
"E01CR",341,546,"1200x900",1000,1,600,400,"True",305,374,333,-41,41,0
"E01CR",342,415,"1200x900",800,2,600,400,"True",823,684,632,-52,52,0
"E01CR",343,559,"1200x900",1000,1,600,400,"False",641,244,417,173,173,0
"E01CR",344,265,"1200x900",800,0,600,400,"True",229,353,280,-73,73,1
"E01CR",345,568,"1200x900",1000,1,600,400,"True",286,475,411,-64,64,1
"E01CR",346,510,"1200x900",1000,1,600,400,"False",486,338,211,-127,127,1
"E01CR",347,10,"1200x900",600,0,600,400,"True",400,499,486,-13,13,1
"E01CR",348,258,"1200x900",800,0,600,400,"False",126,664,789,125,125,1
"E01CR",349,379,"1200x900",800,2,600,400,"False",994,325,496,171,171,0
"E01CR",350,191,"1200x900",600,2,600,400,"True",962,396,459,63,63,0
"E01CR",351,545,"1200x900",1000,1,600,400,"False",358,562,469,-93,93,0
"E01CR",352,245,"1200x900",800,0,600,400,"False",296,235,308,73,73,1
"E01CR",353,366,"1200x900",800,2,600,400,"False",931,464,218,-246,246,0
"E01CR",354,560,"1200x900",1000,1,600,400,"False",516,693,436,-257,257,0
"E01CR",355,98,"1200x900",600,1,600,400,"False",625,530,420,-110,110,0
"E01CR",356,381,"1200x900",800,2,600,400,"True",705,408,419,11,11,0
"E01CR",357,306,"1200x900",800,1,600,400,"False",164,524,624,100,100,0
"E01CR",358,207,"1200x900",600,2,600,400,"False",838,235,399,164,164,0
"E01CR",359,247,"1200x900",800,0,600,400,"True",160,424,391,-33,33,1
"E01CR",360,179,"1200x900",600,2,600,400,"True",908,602,625,23,23,0
"E01CR",361,34,"1200x900",600,0,600,400,"True",361,242,289,47,47,1
"E01CR",362,244,"1200x900",800,0,600,400,"True",194,203,270,67,67,1
"E01CR",363,336,"1200x900",800,1,600,400,"False",251,587,478,-109,109,0
"E01CR",364,626,"1200x900",1000,2,600,400,"False",329,449,725,276,276,0
"E01CR",365,419,"1200x900",800,2,600,400,"False",769,351,649,298,298,0
"E01CR",366,193,"1200x900",600,2,600,400,"False",874,588,349,-239,239,0
"E01CR",367,168,"1200x900",600,2,600,400,"True",1001,439,396,-43,43,0
"E01CR",368,588,"1200x900",1000,2,600,400,"True",585,350,410,60,60,0
"E01CR",369,641,"1200x900",1000,2,600,400,"False",897,272,654,382,382,0
"E01CR",370,182,"1200x900",600,2,600,400,"False",933,389,533,144,144,0
"E01CR",371,14,"1200x900",600,0,600,400,"True",399,224,243,19,19,1
"E01CR",372,104,"1200x900",600,1,600,400,"True",448,584,622,38,38,0
"E01CR",373,110,"1200x900",600,1,600,400,"True",776,550,582,32,32,1
"E01CR",374,509,"1200x900",1000,1,600,400,"False",509,434,521,87,87,0
"E01CR",375,40,"1200x900",600,0,600,400,"True",143,513,512,-1,1,0
"E01CR",376,538,"1200x900",1000,1,600,400,"True",308,457,446,-11,11,1
"E01CR",377,648,"1200x900",1000,2,600,400,"True",557,394,413,19,19,0
"E01CR",378,65,"1200x900",600,0,600,400,"False",442,645,534,-111,111,1
"E01CR",379,417,"1200x900",800,2,600,400,"False",750,280,510,230,230,0
"E01CR",380,310,"1200x900",800,1,600,400,"True",559,592,544,-48,48,0
"E01CR",381,129,"1200x900",600,1,600,400,"False",859,482,385,-97,97,1
"E01CR",382,219,"1200x900",800,0,600,400,"False",202,502,427,-75,75,1
"E01CR",383,277,"1200x900",800,0,600,400,"True",140,310,317,7,7,1
"E01CR",384,155,"1200x900",600,2,600,400,"True",940,269,299,30,30,0
"E01CR",385,332,"1200x900",800,1,600,400,"False",260,699,467,-232,232,0
"E01CR",386,175,"1200x900",600,2,600,400,"False",1028,432,376,-56,56,0
"E01CR",387,276,"1200x900",800,0,600,400,"False",281,217,289,72,72,1
"E01CR",388,238,"1200x900",800,0,600,400,"True",162,283,290,7,7,1
"E01CR",389,242,"1200x900",800,0,600,400,"True",117,448,467,19,19,1
"E01CR",390,330,"1200x900",800,1,600,400,"True",759,301,379,78,78,1
"E01CR",391,442,"1200x900",1000,0,600,400,"True",87,183,235,52,52,1
"E01CR",392,572,"1200x900",1000,1,600,400,"False",302,260,520,260,260,0
"E01CR",393,6,"1200x900",600,0,600,400,"False",217,689,595,-94,94,1
"E01CR",394,413,"1200x900",800,2,600,400,"False",849,506,683,177,177,0
"E01CR",395,373,"1200x900",800,2,600,400,"False",694,326,516,190,190,0
"E01CR",396,624,"1200x900",1000,2,600,400,"True",693,501,469,-32,32,0
"E01CR",397,396,"1200x900",800,2,600,400,"False",678,663,356,-307,307,0
"E01CR",398,231,"1200x900",800,0,600,400,"True",251,718,667,-51,51,1
"E01CR",399,392,"1200x900",800,2,600,400,"True",1031,618,643,25,25,0
"E01CR",400,305,"1200x900",800,1,600,400,"False",471,716,449,-267,267,0
"E01CR",401,44,"1200x900",600,0,600,400,"True",305,554,599,45,45,1
"E01CR",402,160,"1200x900",600,2,600,400,"True",863,606,551,-55,55,0
"E01CR",403,524,"1200x900",1000,1,600,400,"True",534,470,517,47,47,0
"E01CR",404,356,"1200x900",800,1,600,400,"False",123,484,681,197,197,0
"E01CR",405,135,"1200x900",600,1,600,400,"True",759,569,544,-25,25,0
"E01CR",406,117,"1200x900",600,1,600,400,"True",711,456,459,3,3,0
"E01CR",407,544,"1200x900",1000,1,600,400,"True",602,620,590,-30,30,0
"E01CR",408,365,"1200x900",800,2,600,400,"False",1055,305,661,356,356,0
"E01CR",409,557,"1200x900",1000,1,600,400,"False",677,505,588,83,83,1
"E01CR",410,424,"1200x900",800,2,600,400,"False",903,545,460,-85,85,0
"E01CR",411,347,"1200x900",800,1,600,400,"False",757,295,584,289,289,1
"E01CR",412,430,"1200x900",800,2,600,400,"False",922,254,420,166,166,0
"E01CR",413,158,"1200x900",600,2,600,400,"True",939,300,303,3,3,0
"E01CR",414,126,"1200x900",600,1,600,400,"False",849,354,430,76,76,0
"E01CR",415,301,"1200x900",800,1,600,400,"True",162,574,517,-57,57,0
"E01CR",416,337,"1200x900",800,1,600,400,"True",299,622,550,-72,72,0
"E01CR",417,331,"1200x900",800,1,600,400,"True",240,620,579,-41,41,0
"E01CR",418,107,"1200x900",600,1,600,400,"True",878,678,654,-24,24,0
"E01CR",419,625,"1200x900",1000,2,600,400,"False",279,228,505,277,277,0
"E01CR",420,295,"1200x900",800,1,600,400,"True",471,334,340,6,6,0
"E01CR",421,554,"1200x900",1000,1,600,400,"False",79,309,236,-73,73,1
"E01CR",422,643,"1200x900",1000,2,600,400,"True",740,325,398,73,73,0
"E01CR",423,226,"1200x900",800,0,600,400,"True",187,229,258,29,29,1
"E01CR",424,501,"1200x900",1000,0,600,400,"True",96,323,339,16,16,1
"E01CR",425,621,"1200x900",1000,2,600,400,"True",540,478,439,-39,39,0
"E01CR",426,363,"1200x900",800,2,600,400,"False",800,218,360,142,142,0
"E01CR",427,388,"1200x900",800,2,600,400,"False",930,320,549,229,229,0
"E01CR",428,370,"1200x900",800,2,600,400,"True",874,336,401,65,65,0
"E01CR",429,264,"1200x900",800,0,600,400,"False",198,660,479,-181,181,1
"E01CR",430,562,"1200x900",1000,1,600,400,"True",347,540,532,-8,8,0
"E01CR",431,74,"1200x900",600,1,600,400,"True",115,358,462,104,104,0
"E01CR",432,84,"1200x900",600,1,600,400,"False",144,184,321,137,137,0
"E01CR",433,115,"1200x900",600,1,600,400,"True",545,307,382,75,75,0
"E01CR",434,329,"1200x900",800,1,600,400,"False",517,239,367,128,128,0
"E01CR",435,300,"1200x900",800,1,600,400,"False",620,693,610,-83,83,0
"E01CR",436,475,"1200x900",1000,0,600,400,"True",101,715,670,-45,45,1
"E01CR",437,213,"1200x900",600,2,600,400,"True",822,275,296,21,21,0
"E01CR",438,328,"1200x900",800,1,600,400,"False",104,649,473,-176,176,0
"E01CR",439,285,"1200x900",800,0,600,400,"True",237,396,426,30,30,1
"E01CR",440,283,"1200x900",800,0,600,400,"True",90,264,242,-22,22,1
"E01CR",441,164,"1200x900",600,2,600,400,"False",1051,268,141,-127,127,0
"E01CR",442,473,"1200x900",1000,0,600,400,"True",75,323,342,19,19,1
"E01CR",443,564,"1200x900",1000,1,600,400,"True",215,264,211,-53,53,0
"E01CR",444,387,"1200x900",800,2,600,400,"False",990,444,226,-218,218,0
"E01CR",445,199,"1200x900",600,2,600,400,"True",992,467,515,48,48,0
"E01CR",446,393,"1200x900",800,2,600,400,"False",657,620,367,-253,253,0
"E01CR",447,623,"1200x900",1000,2,600,400,"False",636,527,429,-98,98,0
"E01CR",448,485,"1200x900",1000,0,600,400,"False",121,694,611,-83,83,1
"E01CR",449,63,"1200x900",600,0,600,400,"True",311,188,203,15,15,1
"E01CR",450,49,"1200x900",600,0,600,400,"True",109,380,387,7,7,0
"E01CR",451,469,"1200x900",1000,0,600,400,"True",73,227,207,-20,20,1
"E01CR",452,292,"1200x900",800,1,600,400,"False",88,565,746,181,181,0
"E01CR",453,488,"1200x900",1000,0,600,400,"True",129,687,698,11,11,1
"E01CR",454,24,"1200x900",600,0,600,400,"True",430,538,572,34,34,1
"E01CR",455,222,"1200x900",800,0,600,400,"True",152,206,264,58,58,1
"E01CR",456,4,"1200x900",600,0,600,400,"True",602,200,231,31,31,1
"E01CR",457,297,"1200x900",800,1,600,400,"False",625,244,352,108,108,0
"E01CR",458,12,"1200x900",600,0,600,400,"True",365,336,275,-61,61,1
"E01CR",459,90,"1200x900",600,1,600,400,"False",560,474,195,-279,279,0
"E01CR",460,37,"1200x900",600,0,600,400,"True",258,403,451,48,48,1
"E01CR",461,533,"1200x900",1000,1,600,400,"True",355,483,458,-25,25,0
"E01CR",462,440,"1200x900",1000,0,600,400,"False",71,237,416,179,179,1
"E01CR",463,284,"1200x900",800,0,600,400,"False",135,293,387,94,94,1
"E01CR",464,449,"1200x900",1000,0,600,400,"True",105,683,695,12,12,1
"E01CR",465,324,"1200x900",800,1,600,400,"False",719,712,380,-332,332,1
"E01CR",466,527,"1200x900",1000,1,600,400,"True",565,601,567,-34,34,0
"E01CR",467,137,"1200x900",600,1,600,400,"False",789,577,692,115,115,0
"E01CR",468,267,"1200x900",800,0,600,400,"True",145,665,652,-13,13,1
"E01CR",469,51,"1200x900",600,0,600,400,"False",272,181,258,77,77,1
"E01CR",470,291,"1200x900",800,1,600,400,"False",522,694,630,-64,64,0
"E01CR",471,555,"1200x900",1000,1,600,400,"True",444,556,554,-2,2,0
"E01CR",472,169,"1200x900",600,2,600,400,"True",924,290,274,-16,16,0
"E01CR",473,88,"1200x900",600,1,600,400,"True",186,554,510,-44,44,0
"E01CR",474,364,"1200x900",800,2,600,400,"False",1018,204,690,486,486,0
"E01CR",475,304,"1200x900",800,1,600,400,"False",667,605,313,-292,292,0
"E01CR",476,296,"1200x900",800,1,600,400,"False",89,279,443,164,164,0
"E01CR",477,323,"1200x900",800,1,600,400,"False",388,348,522,174,174,0
"E01CR",478,593,"1200x900",1000,2,600,400,"False",246,719,255,-464,464,0
"E01CR",479,521,"1200x900",1000,1,600,400,"False",111,303,471,168,168,1
"E01CR",480,318,"1200x900",800,1,600,400,"True",788,534,430,-104,104,0
"E01CR",481,138,"1200x900",600,1,600,400,"False",844,580,766,186,186,1
"E01CR",482,343,"1200x900",800,1,600,400,"False",407,557,321,-236,236,0
"E01CR",483,77,"1200x900",600,1,600,400,"True",780,525,561,36,36,0
"E01CR",484,206,"1200x900",600,2,600,400,"True",975,223,300,77,77,0
"E01CR",485,101,"1200x900",600,1,600,400,"False",541,656,532,-124,124,0
"E01CR",486,471,"1200x900",1000,0,600,400,"False",122,200,364,164,164,1
"E01CR",487,260,"1200x900",800,0,600,400,"True",103,525,482,-43,43,1
"E01CR",488,498,"1200x900",1000,0,600,400,"False",100,260,342,82,82,1
"E01CR",489,171,"1200x900",600,2,600,400,"False",909,200,320,120,120,0
"E01CR",490,542,"1200x900",1000,1,600,400,"False",304,401,286,-115,115,0
"E01CR",491,551,"1200x900",1000,1,600,400,"False",146,445,610,165,165,1
"E01CR",492,317,"1200x900",800,1,600,400,"False",185,564,355,-209,209,0
"E01CR",493,462,"1200x900",1000,0,600,400,"False",102,672,593,-79,79,1
"E01CR",494,523,"1200x900",1000,1,600,400,"False",339,318,486,168,168,0
"E01CR",495,83,"1200x900",600,1,600,400,"True",763,568,557,-11,11,1
"E01CR",496,497,"1200x900",1000,0,600,400,"False",106,696,575,-121,121,1
"E01CR",497,50,"1200x900",600,0,600,400,"True",75,582,610,28,28,0
"E01CR",498,470,"1200x900",1000,0,600,400,"True",91,666,606,-60,60,1
"E01CR",499,378,"1200x900",800,2,600,400,"False",1018,708,607,-101,101,0
"E01CR",500,431,"1200x900",800,2,600,400,"False",694,382,523,141,141,0
"E01CR",501,274,"1200x900",800,0,600,400,"True",146,497,535,38,38,1
"E01CR",503,529,"1200x900",1000,1,600,400,"True",267,412,426,14,14,1
"E01CR",504,502,"1200x900",1000,0,600,400,"False",111,639,540,-99,99,1
"E01CR",505,338,"1200x900",800,1,600,400,"False",813,253,354,101,101,1
"E01CR",506,234,"1200x900",800,0,600,400,"True",72,344,355,11,11,1
"E01CR",507,254,"1200x900",800,0,600,400,"True",136,583,635,52,52,1
"E01CR",508,105,"1200x900",600,1,600,400,"True",527,440,434,-6,6,0
"E01CR",509,596,"1200x900",1000,2,600,400,"False",706,513,734,221,221,0
"E01CR",510,86,"1200x900",600,1,600,400,"True",692,388,382,-6,6,1
"E01CR",511,286,"1200x900",800,0,600,400,"True",105,378,378,0,0,1
"E01CR",512,522,"1200x900",1000,1,600,400,"False",223,379,561,182,182,0
"E01CR",513,622,"1200x900",1000,2,600,400,"True",307,683,732,49,49,0
"E01CR",514,543,"1200x900",1000,1,600,400,"False",88,202,642,440,440,0
"E01CR",515,362,"1200x900",800,2,600,400,"False",819,338,693,355,355,0
"E01CR",516,95,"1200x900",600,1,600,400,"True",749,425,466,41,41,1
"E01CR",517,288,"1200x900",800,0,600,400,"True",180,547,505,-42,42,1
"E01CR",519,25,"1200x900",600,0,600,400,"False",263,403,474,71,71,1
"E01CR",520,261,"1200x900",800,0,600,400,"True",86,713,644,-69,69,1
"E01CR",521,100,"1200x900",600,1,600,400,"True",453,511,557,46,46,0
"E01CR",522,119,"1200x900",600,1,600,400,"False",168,563,413,-150,150,0
"E01CR",523,112,"1200x900",600,1,600,400,"True",681,490,482,-8,8,0
"E01CR",525,374,"1200x900",800,2,600,400,"True",755,450,490,40,40,0
"E01CR",526,32,"1200x900",600,0,600,400,"True",152,563,555,-8,8,1
"E01CR",527,503,"1200x900",1000,0,600,400,"False",86,279,437,158,158,1
"E01CR",528,246,"1200x900",800,0,600,400,"False",196,418,499,81,81,1
"E01CR",529,203,"1200x900",600,2,600,400,"False",938,603,671,68,68,0
"E01CR",530,518,"1200x900",1000,1,600,400,"True",583,717,694,-23,23,0
"E01CR",531,8,"1200x900",600,0,600,400,"True",156,679,658,-21,21,0
"E01CR",532,390,"1200x900",800,2,600,400,"True",982,674,637,-37,37,1
"E01CR",533,79,"1200x900",600,1,600,400,"False",731,289,562,273,273,0
"E01CR",534,13,"1200x900",600,0,600,400,"True",296,211,256,45,45,1
"E01CR",535,550,"1200x900",1000,1,600,400,"False",301,459,312,-147,147,0
"E01CR",536,489,"1200x900",1000,0,600,400,"False",88,604,501,-103,103,1
"E01CR",537,635,"1200x900",1000,2,600,400,"True",833,402,472,70,70,0
"E01CR",538,99,"1200x900",600,1,600,400,"True",811,407,419,12,12,0
"E01CR",539,204,"1200x900",600,2,600,400,"True",1053,432,422,-10,10,0
"E01CR",540,200,"1200x900",600,2,600,400,"False",897,302,421,119,119,0
"E01CR",541,400,"1200x900",800,2,600,400,"True",733,297,320,23,23,0
"E01CR",542,608,"1200x900",1000,2,600,400,"False",742,250,548,298,298,0
"E01CR",543,183,"1200x900",600,2,600,400,"True",927,289,253,-36,36,0
"E01CR",544,162,"1200x900",600,2,600,400,"False",849,279,375,96,96,0
"E01CR",545,526,"1200x900",1000,1,600,400,"True",497,710,727,17,17,0
"E01CR",546,192,"1200x900",600,2,600,400,"False",1064,320,662,342,342,0
"E01CR",547,53,"1200x900",600,0,600,400,"False",177,189,277,88,88,0
"E01CR",548,481,"1200x900",1000,0,600,400,"True",80,185,213,28,28,1
"E01CR",549,530,"1200x900",1000,1,600,400,"False",584,405,91,-314,314,1
"E01CR",550,45,"1200x900",600,0,600,400,"True",487,678,695,17,17,1
"E01CR",551,441,"1200x900",1000,0,600,400,"True",85,684,734,50,50,1
"E01CR",552,409,"1200x900",800,2,600,400,"True",501,659,673,14,14,0
"E01CR",553,150,"1200x900",600,2,600,400,"False",897,345,164,-181,181,0
"E01CR",554,491,"1200x900",1000,0,600,400,"False",108,198,286,88,88,1
"E01CR",555,209,"1200x900",600,2,600,400,"True",937,637,597,-40,40,0
"E01CR",556,552,"1200x900",1000,1,600,400,"False",255,412,658,246,246,0
"E01CR",557,492,"1200x900",1000,0,600,400,"True",76,692,663,-29,29,1
"E01CR",558,380,"1200x900",800,2,600,400,"False",942,228,369,141,141,0
"E01CR",559,569,"1200x900",1000,1,600,400,"False",494,720,312,-408,408,0
"E01CR",560,185,"1200x900",600,2,600,400,"False",907,212,303,91,91,0
"E01CR",561,211,"1200x900",600,2,600,400,"False",986,407,300,-107,107,0
"E01CR",562,637,"1200x900",1000,2,600,400,"False",750,460,703,243,243,0
"E01CR",563,35,"1200x900",600,0,600,400,"True",366,555,568,13,13,1
"E01CR",564,570,"1200x900",1000,1,600,400,"False",315,352,654,302,302,0
"E01CR",565,266,"1200x900",800,0,600,400,"False",126,303,458,155,155,1
"E01CR",566,143,"1200x900",600,1,600,400,"True",479,284,316,32,32,1
"E01CR",567,646,"1200x900",1000,2,600,400,"True",829,227,260,33,33,1
"E01CR",568,280,"1200x900",800,0,600,400,"True",104,302,282,-20,20,1
"E01CR",569,418,"1200x900",800,2,600,400,"False",754,507,368,-139,139,0
"E01CR",570,61,"1200x900",600,0,600,400,"False",272,670,566,-104,104,1
"E01CR",571,114,"1200x900",600,1,600,400,"False",183,697,530,-167,167,0
"E01CR",572,578,"1200x900",1000,2,600,400,"False",966,276,741,465,465,0
"E01CR",573,634,"1200x900",1000,2,600,400,"False",735,313,662,349,349,0
"E01CR",574,401,"1200x900",800,2,600,400,"False",821,260,532,272,272,0
"E01CR",575,629,"1200x900",1000,2,600,400,"False",681,257,519,262,262,0
"E01CR",576,450,"1200x900",1000,0,600,400,"False",130,204,411,207,207,1
"E01CR",577,154,"1200x900",600,2,600,400,"False",941,454,250,-204,204,0
"E01CR",578,506,"1200x900",1000,1,600,400,"False",559,567,383,-184,184,1
"E01CR",579,248,"1200x900",800,0,600,400,"True",94,240,250,10,10,1
"E01CR",580,383,"1200x900",800,2,600,400,"False",855,407,490,83,83,0
"E01CR",581,229,"1200x900",800,0,600,400,"True",117,697,722,25,25,1
"E01CR",582,558,"1200x900",1000,1,600,400,"False",72,464,377,-87,87,1
"E01CR",583,62,"1200x900",600,0,600,400,"True",345,346,393,47,47,1
"E01CR",584,438,"1200x900",1000,0,600,400,"False",77,713,525,-188,188,1
"E01CR",585,56,"1200x900",600,0,600,400,"True",148,491,491,0,0,0
"E01CR",586,333,"1200x900",800,1,600,400,"True",521,548,498,-50,50,0
"E01CR",587,567,"1200x900",1000,1,600,400,"True",655,297,282,-15,15,1
"E01CR",588,197,"1200x900",600,2,600,400,"False",903,212,322,110,110,0
"E01CR",589,351,"1200x900",800,1,600,400,"False",122,581,679,98,98,0
"E01CR",590,186,"1200x900",600,2,600,400,"False",997,197,476,279,279,0
"E01CR",591,214,"1200x900",600,2,600,400,"True",1046,305,353,48,48,0
"E01CR",592,628,"1200x900",1000,2,600,400,"True",768,410,366,-44,44,0
"E01CR",593,422,"1200x900",800,2,600,400,"False",712,558,631,73,73,0
"E01CR",594,278,"1200x900",800,0,600,400,"False",251,711,616,-95,95,1
"E01CR",595,385,"1200x900",800,2,600,400,"False",740,456,604,148,148,0
"E01CR",596,447,"1200x900",1000,0,600,400,"False",71,339,600,261,261,1
"E01CR",597,565,"1200x900",1000,1,600,400,"True",451,562,593,31,31,0
"E01CR",598,161,"1200x900",600,2,600,400,"False",939,553,659,106,106,0
"E01CR",599,345,"1200x900",800,1,600,400,"True",841,566,571,5,5,1
"E01CR",600,632,"1200x900",1000,2,600,400,"False",984,227,633,406,406,0
"E01CR",601,638,"1200x900",1000,2,600,400,"False",385,198,495,297,297,0
"E01CR",602,425,"1200x900",800,2,600,400,"False",621,438,547,109,109,0
"E01CR",603,217,"1200x900",800,0,600,400,"True",85,573,614,41,41,1
"E01CR",604,33,"1200x900",600,0,600,400,"True",198,533,585,52,52,1
"E01CR",605,350,"1200x900",800,1,600,400,"False",182,566,433,-133,133,0
"E01CR",606,180,"1200x900",600,2,600,400,"True",929,270,286,16,16,0
"E01CR",607,97,"1200x900",600,1,600,400,"True",760,643,672,29,29,1
"E01CR",608,263,"1200x900",800,0,600,400,"True",82,396,445,49,49,1
"E01CR",609,141,"1200x900",600,1,600,400,"False",671,582,663,81,81,0
"E01CR",610,133,"1200x900",600,1,600,400,"False",345,551,609,58,58,0
"E01CR",611,130,"1200x900",600,1,600,400,"False",741,428,562,134,134,0
"E01CR",612,597,"1200x900",1000,2,600,400,"False",352,239,478,239,239,0
"E01CR",613,220,"1200x900",800,0,600,400,"True",108,699,679,-20,20,1
"E01CR",614,576,"1200x900",1000,1,600,400,"True",376,713,677,-36,36,0
"E01CR",615,454,"1200x900",1000,0,600,400,"True",78,687,708,21,21,1
"E01CR",616,398,"1200x900",800,2,600,400,"False",944,698,592,-106,106,0
"E01CR",617,534,"1200x900",1000,1,600,400,"False",328,504,633,129,129,1
"E01CR",618,121,"1200x900",600,1,600,400,"False",884,364,573,209,209,0
"E01CR",619,587,"1200x900",1000,2,600,400,"False",741,686,326,-360,360,0
"E01CR",620,42,"1200x900",600,0,600,400,"True",233,479,522,43,43,0
"E01CR",621,490,"1200x900",1000,0,600,400,"False",114,183,325,142,142,1
"E01CR",622,517,"1200x900",1000,1,600,400,"False",548,182,372,190,190,0
"E01CR",623,573,"1200x900",1000,1,600,400,"False",486,615,521,-94,94,0
"E01CR",624,93,"1200x900",600,1,600,400,"False",139,540,457,-83,83,0
"E01CR",625,547,"1200x900",1000,1,600,400,"False",369,384,627,243,243,1
"E01CR",626,600,"1200x900",1000,2,600,400,"False",765,207,550,343,343,0
"E01CR",627,519,"1200x900",1000,1,600,400,"False",319,565,477,-88,88,1
"E01CR",628,177,"1200x900",600,2,600,400,"False",912,236,408,172,172,0
"E01CR",629,151,"1200x900",600,2,600,400,"True",828,680,697,17,17,0
"E01CR",630,172,"1200x900",600,2,600,400,"False",912,444,562,118,118,0
"E01CR",631,636,"1200x900",1000,2,600,400,"False",575,583,427,-156,156,0
"E01CR",632,407,"1200x900",800,2,600,400,"False",989,340,520,180,180,0
"E01CR",633,321,"1200x900",800,1,600,400,"False",601,190,410,220,220,0
"E01CR",634,432,"1200x900",800,2,600,400,"False",792,380,224,-156,156,0
"E01CR",635,339,"1200x900",800,1,600,400,"True",273,545,478,-67,67,1
"E01CR",636,451,"1200x900",1000,0,600,400,"False",110,702,607,-95,95,1
"E01CR",637,452,"1200x900",1000,0,600,400,"False",97,273,382,109,109,1
"E01CR",638,69,"1200x900",600,0,600,400,"True",322,268,313,45,45,0
"E01CR",639,609,"1200x900",1000,2,600,400,"False",697,627,380,-247,247,0
"E01CR",640,348,"1200x900",800,1,600,400,"False",764,294,367,73,73,0
"E01CR",641,367,"1200x900",800,2,600,400,"False",613,464,369,-95,95,0
"E01CR",642,5,"1200x900",600,0,600,400,"True",228,587,545,-42,42,0
"E01CR",643,357,"1200x900",800,1,600,400,"False",109,594,481,-113,113,0
"E01CR",644,15,"1200x900",600,0,600,400,"False",473,352,429,77,77,1
"E01CR",645,55,"1200x900",600,0,600,400,"True",211,305,371,66,66,1
"E01CR",646,411,"1200x900",800,2,600,400,"True",805,361,418,57,57,0
"E01CR",647,549,"1200x900",1000,1,600,400,"True",657,366,426,60,60,0
"E01CR",648,26,"1200x900",600,0,600,400,"False",70,712,583,-129,129,0
"E02SC",1,8,"1200x900",600,0,600,400,"False",156,679,364,-315,315,0
"E02SC",2,325,"1200x900",800,1,600,400,"False",105,394,567,173,173,0
"E02SC",3,451,"1200x900",1000,0,600,400,"False",110,702,400,-302,302,1
"E02SC",4,47,"1200x900",600,0,600,400,"True",303,499,437,-62,62,1
"E02SC",5,113,"1200x900",600,1,600,400,"False",897,657,536,-121,121,0
"E02SC",6,474,"1200x900",1000,0,600,400,"False",85,339,442,103,103,1
"E02SC",7,350,"1200x900",800,1,600,400,"True",182,566,524,-42,42,0
"E02SC",8,119,"1200x900",600,1,600,400,"True",168,563,494,-69,69,0
"E02SC",9,142,"1200x900",600,1,600,400,"True",286,474,440,-34,34,0
"E02SC",10,63,"1200x900",600,0,600,400,"True",311,188,243,55,55,1
"E02SC",11,620,"1200x900",1000,2,600,400,"False",832,649,375,-274,274,0
"E02SC",12,5,"1200x900",600,0,600,400,"False",228,587,483,-104,104,0
"E02SC",13,417,"1200x900",800,2,600,400,"False",750,280,203,-77,77,0
"E02SC",14,523,"1200x900",1000,1,600,400,"True",339,318,386,68,68,0
"E02SC",15,578,"1200x900",1000,2,600,400,"False",966,276,698,422,422,0
"E02SC",16,23,"1200x900",600,0,600,400,"False",308,463,309,-154,154,1
"E02SC",17,606,"1200x900",1000,2,600,400,"True",653,627,642,15,15,0
"E02SC",18,193,"1200x900",600,2,600,400,"False",874,588,673,85,85,0
"E02SC",19,156,"1200x900",600,2,600,400,"False",913,197,679,482,482,0
"E02SC",20,207,"1200x900",600,2,600,400,"False",838,235,630,395,395,0
"E02SC",21,365,"1200x900",800,2,600,400,"False",1055,305,482,177,177,0
"E02SC",22,628,"1200x900",1000,2,600,400,"False",768,410,706,296,296,0
"E02SC",23,58,"1200x900",600,0,600,400,"False",353,655,773,118,118,1
"E02SC",24,264,"1200x900",800,0,600,400,"True",198,660,628,-32,32,1
"E02SC",25,38,"1200x900",600,0,600,400,"True",120,628,619,-9,9,1
"E02SC",26,129,"1200x900",600,1,600,400,"False",859,482,589,107,107,1
"E02SC",27,360,"1200x900",800,1,600,400,"False",203,608,744,136,136,0
"E02SC",28,494,"1200x900",1000,0,600,400,"True",127,692,647,-45,45,1
"E02SC",29,287,"1200x900",800,0,600,400,"True",120,567,635,68,68,1
"E02SC",30,580,"1200x900",1000,2,600,400,"False",651,267,438,171,171,0
"E02SC",31,433,"1200x900",1000,0,600,400,"False",76,222,505,283,283,1
"E02SC",32,86,"1200x900",600,1,600,400,"False",692,388,294,-94,94,1
"E02SC",33,646,"1200x900",1000,2,600,400,"True",829,227,283,56,56,1
"E02SC",34,11,"1200x900",600,0,600,400,"False",372,670,525,-145,145,1
"E02SC",35,329,"1200x900",800,1,600,400,"False",517,239,462,223,223,0
"E02SC",36,236,"1200x900",800,0,600,400,"True",162,350,362,12,12,1
"E02SC",37,215,"1200x900",600,2,600,400,"False",939,596,443,-153,153,0
"E02SC",38,149,"1200x900",600,2,600,400,"False",890,289,650,361,361,0
"E02SC",39,124,"1200x900",600,1,600,400,"True",345,467,487,20,20,0
"E02SC",40,516,"1200x900",1000,1,600,400,"False",440,559,368,-191,191,0
"E02SC",41,56,"1200x900",600,0,600,400,"True",148,491,430,-61,61,0
"E02SC",42,472,"1200x900",1000,0,600,400,"False",77,685,474,-211,211,1
"E02SC",43,581,"1200x900",1000,2,600,400,"False",310,357,515,158,158,0
"E02SC",44,396,"1200x900",800,2,600,400,"False",678,663,332,-331,331,0
"E02SC",45,425,"1200x900",800,2,600,400,"False",621,438,628,190,190,0
"E02SC",46,202,"1200x900",600,2,600,400,"True",966,460,460,0,0,0
"E02SC",47,57,"1200x900",600,0,600,400,"True",354,508,455,-53,53,1
"E02SC",48,624,"1200x900",1000,2,600,400,"False",693,501,408,-93,93,0
"E02SC",49,189,"1200x900",600,2,600,400,"True",881,397,429,32,32,0
"E02SC",50,203,"1200x900",600,2,600,400,"False",938,603,420,-183,183,0
"E02SC",51,138,"1200x900",600,1,600,400,"True",844,580,505,-75,75,1
"E02SC",52,495,"1200x900",1000,0,600,400,"False",93,692,389,-303,303,1
"E02SC",53,226,"1200x900",800,0,600,400,"True",187,229,295,66,66,1
"E02SC",54,497,"1200x900",1000,0,600,400,"True",106,696,693,-3,3,1
"E02SC",55,543,"1200x900",1000,1,600,400,"True",88,202,240,38,38,0
"E02SC",56,15,"1200x900",600,0,600,400,"False",473,352,270,-82,82,1
"E02SC",57,456,"1200x900",1000,0,600,400,"False",91,257,363,106,106,1
"E02SC",58,339,"1200x900",800,1,600,400,"False",273,545,168,-377,377,1
"E02SC",59,321,"1200x900",800,1,600,400,"False",601,190,334,144,144,0
"E02SC",60,180,"1200x900",600,2,600,400,"False",929,270,452,182,182,0
"E02SC",61,49,"1200x900",600,0,600,400,"True",109,380,360,-20,20,0
"E02SC",62,114,"1200x900",600,1,600,400,"False",183,697,353,-344,344,0
"E02SC",63,599,"1200x900",1000,2,600,400,"False",316,570,677,107,107,0
"E02SC",64,107,"1200x900",600,1,600,400,"False",878,678,350,-328,328,0
"E02SC",65,208,"1200x900",600,2,600,400,"False",946,399,613,214,214,0
"E02SC",66,488,"1200x900",1000,0,600,400,"False",129,687,533,-154,154,1
"E02SC",67,232,"1200x900",800,0,600,400,"False",84,511,658,147,147,1
"E02SC",68,431,"1200x900",800,2,600,400,"False",694,382,456,74,74,0
"E02SC",69,19,"1200x900",600,0,600,400,"False",286,686,600,-86,86,0
"E02SC",70,72,"1200x900",600,0,600,400,"True",158,537,583,46,46,0
"E02SC",71,398,"1200x900",800,2,600,400,"False",944,698,597,-101,101,0
"E02SC",72,439,"1200x900",1000,0,600,400,"False",110,229,485,256,256,1
"E02SC",73,18,"1200x900",600,0,600,400,"True",400,318,314,-4,4,1
"E02SC",74,553,"1200x900",1000,1,600,400,"False",116,712,513,-199,199,0
"E02SC",75,263,"1200x900",800,0,600,400,"True",82,396,376,-20,20,1
"E02SC",76,427,"1200x900",800,2,600,400,"False",812,380,558,178,178,0
"E02SC",77,629,"1200x900",1000,2,600,400,"False",681,257,394,137,137,0
"E02SC",78,399,"1200x900",800,2,600,400,"False",603,602,341,-261,261,0
"E02SC",79,338,"1200x900",800,1,600,400,"False",813,253,487,234,234,1
"E02SC",80,320,"1200x900",800,1,600,400,"True",644,376,442,66,66,0
"E02SC",81,97,"1200x900",600,1,600,400,"False",760,643,394,-249,249,1
"E02SC",82,413,"1200x900",800,2,600,400,"False",849,506,376,-130,130,0
"E02SC",83,354,"1200x900",800,1,600,400,"False",118,236,509,273,273,0
"E02SC",84,172,"1200x900",600,2,600,400,"True",912,444,490,46,46,0
"E02SC",85,441,"1200x900",1000,0,600,400,"False",85,684,566,-118,118,1
"E02SC",86,342,"1200x900",800,1,600,400,"False",677,204,470,266,266,0
"E02SC",87,223,"1200x900",800,0,600,400,"True",179,191,128,-63,63,1
"E02SC",88,230,"1200x900",800,0,600,400,"False",99,678,548,-130,130,1
"E02SC",89,75,"1200x900",600,1,600,400,"True",635,558,556,-2,2,0
"E02SC",90,327,"1200x900",800,1,600,400,"False",152,339,643,304,304,0
"E02SC",91,486,"1200x900",1000,0,600,400,"False",102,676,399,-277,277,1
"E02SC",92,630,"1200x900",1000,2,600,400,"False",754,559,442,-117,117,0
"E02SC",93,167,"1200x900",600,2,600,400,"False",956,241,456,215,215,0
"E02SC",94,144,"1200x900",600,1,600,400,"True",718,371,316,-55,55,0
"E02SC",95,589,"1200x900",1000,2,600,400,"False",856,418,325,-93,93,0
"E02SC",96,410,"1200x900",800,2,600,400,"False",916,477,386,-91,91,0
"E02SC",97,454,"1200x900",1000,0,600,400,"False",78,687,477,-210,210,1
"E02SC",98,160,"1200x900",600,2,600,400,"False",863,606,509,-97,97,0
"E02SC",99,480,"1200x900",1000,0,600,400,"False",100,231,298,67,67,1
"E02SC",100,88,"1200x900",600,1,600,400,"False",186,554,271,-283,283,0
"E02SC",101,45,"1200x900",600,0,600,400,"False",487,678,422,-256,256,1
"E02SC",102,195,"1200x900",600,2,600,400,"False",942,249,420,171,171,0
"E02SC",103,526,"1200x900",1000,1,600,400,"False",497,710,522,-188,188,0
"E02SC",104,17,"1200x900",600,0,600,400,"True",402,496,441,-55,55,1
"E02SC",105,400,"1200x900",800,2,600,400,"False",733,297,474,177,177,0
"E02SC",106,597,"1200x900",1000,2,600,400,"False",352,239,372,133,133,0
"E02SC",107,622,"1200x900",1000,2,600,400,"True",307,683,637,-46,46,0
"E02SC",108,397,"1200x900",800,2,600,400,"False",817,692,542,-150,150,0
"E02SC",109,625,"1200x900",1000,2,600,400,"False",279,228,437,209,209,0
"E02SC",110,506,"1200x900",1000,1,600,400,"False",559,567,423,-144,144,1
"E02SC",111,502,"1200x900",1000,0,600,400,"False",111,639,514,-125,125,1
"E02SC",112,591,"1200x900",1000,2,600,400,"False",698,336,516,180,180,0
"E02SC",113,405,"1200x900",800,2,600,400,"False",790,307,391,84,84,0
"E02SC",114,415,"1200x900",800,2,600,400,"False",823,684,365,-319,319,0
"E02SC",115,518,"1200x900",1000,1,600,400,"False",583,717,412,-305,305,0
"E02SC",116,585,"1200x900",1000,2,600,400,"False",698,688,504,-184,184,1
"E02SC",117,184,"1200x900",600,2,600,400,"False",1067,441,368,-73,73,0
"E02SC",118,525,"1200x900",1000,1,600,400,"True",123,690,674,-16,16,0
"E02SC",119,522,"1200x900",1000,1,600,400,"False",223,379,677,298,298,0
"E02SC",120,552,"1200x900",1000,1,600,400,"True",255,412,370,-42,42,0
"E02SC",121,254,"1200x900",800,0,600,400,"True",136,583,549,-34,34,1
"E02SC",122,64,"1200x900",600,0,600,400,"False",102,339,432,93,93,0
"E02SC",123,220,"1200x900",800,0,600,400,"True",108,699,667,-32,32,1
"E02SC",124,146,"1200x900",600,2,600,400,"True",989,492,519,27,27,0
"E02SC",125,462,"1200x900",1000,0,600,400,"True",102,672,639,-33,33,1
"E02SC",126,53,"1200x900",600,0,600,400,"False",177,189,440,251,251,0
"E02SC",127,71,"1200x900",600,0,600,400,"False",219,248,156,-92,92,0
"E02SC",128,283,"1200x900",800,0,600,400,"True",90,264,223,-41,41,1
"E02SC",129,434,"1200x900",1000,0,600,400,"False",89,657,551,-106,106,1
"E02SC",130,394,"1200x900",800,2,600,400,"False",847,292,421,129,129,0
"E02SC",131,217,"1200x900",800,0,600,400,"False",85,573,670,97,97,1
"E02SC",132,116,"1200x900",600,1,600,400,"False",767,289,665,376,376,0
"E02SC",133,261,"1200x900",800,0,600,400,"True",86,713,684,-29,29,1
"E02SC",134,311,"1200x900",800,1,600,400,"False",710,261,523,262,262,0
"E02SC",135,508,"1200x900",1000,1,600,400,"True",596,485,436,-49,49,0
"E02SC",136,183,"1200x900",600,2,600,400,"False",927,289,498,209,209,0
"E02SC",137,438,"1200x900",1000,0,600,400,"False",77,713,633,-80,80,1
"E02SC",138,322,"1200x900",800,1,600,400,"False",703,206,456,250,250,1
"E02SC",139,141,"1200x900",600,1,600,400,"False",671,582,433,-149,149,0
"E02SC",140,374,"1200x900",800,2,600,400,"False",755,450,508,58,58,0
"E02SC",141,241,"1200x900",800,0,600,400,"False",129,227,395,168,168,1
"E02SC",142,192,"1200x900",600,2,600,400,"False",1064,320,650,330,330,0
"E02SC",143,481,"1200x900",1000,0,600,400,"False",80,185,648,463,463,1
"E02SC",144,121,"1200x900",600,1,600,400,"True",884,364,354,-10,10,0
"E02SC",145,616,"1200x900",1000,2,600,400,"False",854,357,508,151,151,1
"E02SC",146,555,"1200x900",1000,1,600,400,"True",444,556,551,-5,5,0
"E02SC",147,68,"1200x900",600,0,600,400,"False",165,367,599,232,232,0
"E02SC",148,595,"1200x900",1000,2,600,400,"False",687,640,461,-179,179,0
"E02SC",149,1,"1200x900",600,0,600,400,"True",136,502,480,-22,22,0
"E02SC",150,111,"1200x900",600,1,600,400,"True",922,552,527,-25,25,1
"E02SC",151,46,"1200x900",600,0,600,400,"True",193,355,393,38,38,1
"E02SC",152,377,"1200x900",800,2,600,400,"False",683,388,543,155,155,0
"E02SC",153,227,"1200x900",800,0,600,400,"False",196,551,413,-138,138,1
"E02SC",154,259,"1200x900",800,0,600,400,"False",156,180,462,282,282,1
"E02SC",155,378,"1200x900",800,2,600,400,"False",1018,708,429,-279,279,0
"E02SC",156,640,"1200x900",1000,2,600,400,"False",361,334,531,197,197,0
"E02SC",157,300,"1200x900",800,1,600,400,"False",620,693,597,-96,96,0
"E02SC",158,577,"1200x900",1000,2,600,400,"False",455,420,566,146,146,0
"E02SC",159,288,"1200x900",800,0,600,400,"True",180,547,500,-47,47,1
"E02SC",160,573,"1200x900",1000,1,600,400,"False",486,615,494,-121,121,0
"E02SC",161,461,"1200x900",1000,0,600,400,"False",95,711,578,-133,133,1
"E02SC",162,598,"1200x900",1000,2,600,400,"True",706,559,622,63,63,0
"E02SC",163,150,"1200x900",600,2,600,400,"False",897,345,489,144,144,0
"E02SC",164,517,"1200x900",1000,1,600,400,"False",548,182,308,126,126,0
"E02SC",165,80,"1200x900",600,1,600,400,"False",616,423,296,-127,127,1
"E02SC",166,25,"1200x900",600,0,600,400,"True",263,403,412,9,9,1
"E02SC",167,221,"1200x900",800,0,600,400,"False",132,520,337,-183,183,1
"E02SC",168,32,"1200x900",600,0,600,400,"True",152,563,535,-28,28,1
"E02SC",169,282,"1200x900",800,0,600,400,"False",109,246,345,99,99,1
"E02SC",170,295,"1200x900",800,1,600,400,"False",471,334,552,218,218,0
"E02SC",171,347,"1200x900",800,1,600,400,"False",757,295,578,283,283,1
"E02SC",172,533,"1200x900",1000,1,600,400,"True",355,483,499,16,16,0
"E02SC",173,117,"1200x900",600,1,600,400,"False",711,456,633,177,177,0
"E02SC",174,601,"1200x900",1000,2,600,400,"False",735,697,482,-215,215,0
"E02SC",175,228,"1200x900",800,0,600,400,"True",174,687,634,-53,53,1
"E02SC",176,213,"1200x900",600,2,600,400,"False",822,275,535,260,260,0
"E02SC",177,13,"1200x900",600,0,600,400,"False",296,211,479,268,268,1
"E02SC",178,66,"1200x900",600,0,600,400,"True",155,673,674,1,1,0
"E02SC",179,99,"1200x900",600,1,600,400,"True",811,407,431,24,24,0
"E02SC",180,418,"1200x900",800,2,600,400,"True",754,507,569,62,62,0
"E02SC",181,609,"1200x900",1000,2,600,400,"True",697,627,551,-76,76,0
"E02SC",182,310,"1200x900",800,1,600,400,"False",559,592,488,-104,104,0
"E02SC",183,299,"1200x900",800,1,600,400,"False",779,274,444,170,170,0
"E02SC",184,370,"1200x900",800,2,600,400,"False",874,336,151,-185,185,0
"E02SC",185,485,"1200x900",1000,0,600,400,"False",121,694,602,-92,92,1
"E02SC",186,372,"1200x900",800,2,600,400,"False",833,620,366,-254,254,0
"E02SC",187,541,"1200x900",1000,1,600,400,"True",339,478,452,-26,26,0
"E02SC",188,181,"1200x900",600,2,600,400,"False",1018,223,455,232,232,0
"E02SC",189,503,"1200x900",1000,0,600,400,"False",86,279,435,156,156,1
"E02SC",190,464,"1200x900",1000,0,600,400,"False",82,222,307,85,85,1
"E02SC",191,65,"1200x900",600,0,600,400,"True",442,645,625,-20,20,1
"E02SC",192,324,"1200x900",800,1,600,400,"False",719,712,621,-91,91,1
"E02SC",193,206,"1200x900",600,2,600,400,"False",975,223,716,493,493,0
"E02SC",194,521,"1200x900",1000,1,600,400,"False",111,303,138,-165,165,1
"E02SC",195,24,"1200x900",600,0,600,400,"False",430,538,432,-106,106,1
"E02SC",196,604,"1200x900",1000,2,600,400,"False",459,593,480,-113,113,0
"E02SC",197,366,"1200x900",800,2,600,400,"False",931,464,283,-181,181,0
"E02SC",198,465,"1200x900",1000,0,600,400,"True",85,203,246,43,43,1
"E02SC",199,332,"1200x900",800,1,600,400,"False",260,699,338,-361,361,0
"E02SC",200,381,"1200x900",800,2,600,400,"True",705,408,449,41,41,0
"E02SC",201,590,"1200x900",1000,2,600,400,"True",636,278,245,-33,33,0
"E02SC",202,356,"1200x900",800,1,600,400,"False",123,484,149,-335,335,0
"E02SC",203,359,"1200x900",800,1,600,400,"True",653,241,208,-33,33,0
"E02SC",204,612,"1200x900",1000,2,600,400,"True",706,198,210,12,12,0
"E02SC",205,314,"1200x900",800,1,600,400,"False",277,616,219,-397,397,1
"E02SC",206,574,"1200x900",1000,1,600,400,"False",614,194,427,233,233,0
"E02SC",207,187,"1200x900",600,2,600,400,"False",857,639,318,-321,321,0
"E02SC",208,105,"1200x900",600,1,600,400,"False",527,440,239,-201,201,0
"E02SC",210,562,"1200x900",1000,1,600,400,"False",347,540,453,-87,87,0
"E02SC",211,491,"1200x900",1000,0,600,400,"True",108,198,179,-19,19,1
"E02SC",212,341,"1200x900",800,1,600,400,"False",735,632,422,-210,210,1
"E02SC",213,73,"1200x900",600,1,600,400,"False",94,665,166,-499,499,0
"E02SC",214,165,"1200x900",600,2,600,400,"False",912,554,390,-164,164,0
"E02SC",215,101,"1200x900",600,1,600,400,"False",541,656,445,-211,211,0
"E02SC",216,197,"1200x900",600,2,600,400,"False",903,212,427,215,215,0
"E02SC",217,83,"1200x900",600,1,600,400,"False",763,568,428,-140,140,1
"E02SC",218,534,"1200x900",1000,1,600,400,"False",328,504,600,96,96,1
"E02SC",219,74,"1200x900",600,1,600,400,"False",115,358,501,143,143,0
"E02SC",220,554,"1200x900",1000,1,600,400,"True",79,309,376,67,67,1
"E02SC",221,587,"1200x900",1000,2,600,400,"False",741,686,189,-497,497,0
"E02SC",222,470,"1200x900",1000,0,600,400,"False",91,666,466,-200,200,1
"E02SC",223,483,"1200x900",1000,0,600,400,"True",93,191,196,5,5,1
"E02SC",224,643,"1200x900",1000,2,600,400,"False",740,325,208,-117,117,0
"E02SC",225,611,"1200x900",1000,2,600,400,"False",414,511,423,-88,88,0
"E02SC",226,276,"1200x900",800,0,600,400,"True",281,217,263,46,46,1
"E02SC",227,92,"1200x900",600,1,600,400,"False",624,605,278,-327,327,0
"E02SC",228,275,"1200x900",800,0,600,400,"True",120,594,554,-40,40,0
"E02SC",229,51,"1200x900",600,0,600,400,"True",272,181,142,-39,39,1
"E02SC",230,626,"1200x900",1000,2,600,400,"False",329,449,260,-189,189,0
"E02SC",231,54,"1200x900",600,0,600,400,"True",474,564,534,-30,30,1
"E02SC",232,645,"1200x900",1000,2,600,400,"False",619,396,520,124,124,0
"E02SC",233,524,"1200x900",1000,1,600,400,"False",534,470,243,-227,227,0
"E02SC",234,385,"1200x900",800,2,600,400,"True",740,456,407,-49,49,0
"E02SC",235,357,"1200x900",800,1,600,400,"False",109,594,256,-338,338,0
"E02SC",236,479,"1200x900",1000,0,600,400,"True",74,705,694,-11,11,1
"E02SC",237,492,"1200x900",1000,0,600,400,"False",76,692,624,-68,68,1
"E02SC",238,30,"1200x900",600,0,600,400,"True",107,353,407,54,54,0
"E02SC",239,265,"1200x900",800,0,600,400,"True",229,353,299,-54,54,1
"E02SC",240,136,"1200x900",600,1,600,400,"False",264,205,463,258,258,0
"E02SC",241,239,"1200x900",800,0,600,400,"True",114,231,249,18,18,1
"E02SC",242,545,"1200x900",1000,1,600,400,"False",358,562,472,-90,90,0
"E02SC",243,222,"1200x900",800,0,600,400,"True",152,206,190,-16,16,1
"E02SC",244,528,"1200x900",1000,1,600,400,"False",839,227,532,305,305,1
"E02SC",245,382,"1200x900",800,2,600,400,"True",870,523,606,83,83,0
"E02SC",246,31,"1200x900",600,0,600,400,"True",365,338,351,13,13,1
"E02SC",247,353,"1200x900",800,1,600,400,"False",90,476,261,-215,215,0
"E02SC",248,437,"1200x900",1000,0,600,400,"True",74,667,659,-8,8,1
"E02SC",249,484,"1200x900",1000,0,600,400,"True",100,223,237,14,14,1
"E02SC",250,253,"1200x900",800,0,600,400,"True",177,424,455,31,31,1
"E02SC",251,290,"1200x900",800,1,600,400,"False",789,603,441,-162,162,0
"E02SC",252,209,"1200x900",600,2,600,400,"False",937,637,488,-149,149,0
"E02SC",253,307,"1200x900",800,1,600,400,"False",716,247,383,136,136,0
"E02SC",254,225,"1200x900",800,0,600,400,"True",178,423,491,68,68,1
"E02SC",255,302,"1200x900",800,1,600,400,"False",479,467,529,62,62,1
"E02SC",256,375,"1200x900",800,2,600,400,"False",716,384,540,156,156,0
"E02SC",257,292,"1200x900",800,1,600,400,"False",88,565,327,-238,238,0
"E02SC",258,16,"1200x900",600,0,600,400,"True",297,514,473,-41,41,1
"E02SC",259,344,"1200x900",800,1,600,400,"False",589,408,532,124,124,0
"E02SC",260,409,"1200x900",800,2,600,400,"False",501,659,562,-97,97,0
"E02SC",261,583,"1200x900",1000,2,600,400,"False",949,284,429,145,145,1
"E02SC",262,395,"1200x900",800,2,600,400,"True",743,334,326,-8,8,0
"E02SC",263,76,"1200x900",600,1,600,400,"False",647,614,284,-330,330,0
"E02SC",264,448,"1200x900",1000,0,600,400,"True",107,641,602,-39,39,1
"E02SC",265,171,"1200x900",600,2,600,400,"False",909,200,381,181,181,0
"E02SC",266,26,"1200x900",600,0,600,400,"True",70,712,710,-2,2,0
"E02SC",267,318,"1200x900",800,1,600,400,"False",788,534,652,118,118,0
"E02SC",268,200,"1200x900",600,2,600,400,"False",897,302,568,266,266,0
"E02SC",269,588,"1200x900",1000,2,600,400,"True",585,350,379,29,29,0
"E02SC",270,231,"1200x900",800,0,600,400,"True",251,718,674,-44,44,1
"E02SC",271,512,"1200x900",1000,1,600,400,"True",139,261,255,-6,6,0
"E02SC",272,475,"1200x900",1000,0,600,400,"False",101,715,539,-176,176,1
"E02SC",273,268,"1200x900",800,0,600,400,"True",148,400,391,-9,9,1
"E02SC",274,216,"1200x900",600,2,600,400,"True",1029,286,343,57,57,0
"E02SC",275,568,"1200x900",1000,1,600,400,"False",286,475,259,-216,216,1
"E02SC",276,303,"1200x900",800,1,600,400,"True",241,431,427,-4,4,0
"E02SC",277,186,"1200x900",600,2,600,400,"False",997,197,446,249,249,0
"E02SC",278,582,"1200x900",1000,2,600,400,"True",554,347,423,76,76,0
"E02SC",279,246,"1200x900",800,0,600,400,"True",196,418,435,17,17,1
"E02SC",280,440,"1200x900",1000,0,600,400,"True",71,237,215,-22,22,1
"E02SC",281,306,"1200x900",800,1,600,400,"False",164,524,209,-315,315,0
"E02SC",282,446,"1200x900",1000,0,600,400,"True",72,298,269,-29,29,1
"E02SC",283,245,"1200x900",800,0,600,400,"True",296,235,279,44,44,1
"E02SC",284,162,"1200x900",600,2,600,400,"False",849,279,420,141,141,0
"E02SC",285,155,"1200x900",600,2,600,400,"True",940,269,333,64,64,0
"E02SC",286,147,"1200x900",600,2,600,400,"True",942,418,377,-41,41,0
"E02SC",287,550,"1200x900",1000,1,600,400,"False",301,459,352,-107,107,0
"E02SC",288,196,"1200x900",600,2,600,400,"False",1030,397,318,-79,79,0
"E02SC",289,501,"1200x900",1000,0,600,400,"True",96,323,329,6,6,1
"E02SC",290,404,"1200x900",800,2,600,400,"True",842,396,410,14,14,0
"E02SC",291,234,"1200x900",800,0,600,400,"True",72,344,363,19,19,1
"E02SC",292,3,"1200x900",600,0,600,400,"True",298,443,455,12,12,1
"E02SC",293,558,"1200x900",1000,1,600,400,"False",72,464,576,112,112,1
"E02SC",294,416,"1200x900",800,2,600,400,"False",748,617,473,-144,144,0
"E02SC",295,459,"1200x900",1000,0,600,400,"False",70,645,540,-105,105,1
"E02SC",296,84,"1200x900",600,1,600,400,"False",144,184,420,236,236,0
"E02SC",297,284,"1200x900",800,0,600,400,"True",135,293,316,23,23,1
"E02SC",298,278,"1200x900",800,0,600,400,"False",251,711,607,-104,104,1
"E02SC",299,500,"1200x900",1000,0,600,400,"False",105,700,601,-99,99,1
"E02SC",300,256,"1200x900",800,0,600,400,"True",192,656,667,11,11,1
"E02SC",301,368,"1200x900",800,2,600,400,"False",778,515,610,95,95,0
"E02SC",302,401,"1200x900",800,2,600,400,"False",821,260,387,127,127,0
"E02SC",303,260,"1200x900",800,0,600,400,"True",103,525,558,33,33,1
"E02SC",304,154,"1200x900",600,2,600,400,"True",941,454,416,-38,38,0
"E02SC",305,94,"1200x900",600,1,600,400,"True",729,482,509,27,27,0
"E02SC",306,345,"1200x900",800,1,600,400,"True",841,566,612,46,46,1
"E02SC",307,297,"1200x900",800,1,600,400,"True",625,244,303,59,59,0
"E02SC",308,422,"1200x900",800,2,600,400,"False",712,558,341,-217,217,0
"E02SC",309,148,"1200x900",600,2,600,400,"True",907,330,302,-28,28,0
"E02SC",310,12,"1200x900",600,0,600,400,"True",365,336,295,-41,41,1
"E02SC",311,605,"1200x900",1000,2,600,400,"False",493,665,459,-206,206,0
"E02SC",312,298,"1200x900",800,1,600,400,"False",311,457,561,104,104,0
"E02SC",313,249,"1200x900",800,0,600,400,"True",126,306,307,1,1,1
"E02SC",314,313,"1200x900",800,1,600,400,"True",588,421,441,20,20,0
"E02SC",315,458,"1200x900",1000,0,600,400,"True",78,624,627,3,3,1
"E02SC",316,100,"1200x900",600,1,600,400,"False",453,511,639,128,128,0
"E02SC",317,455,"1200x900",1000,0,600,400,"False",107,718,633,-85,85,1
"E02SC",318,564,"1200x900",1000,1,600,400,"False",215,264,387,123,123,0
"E02SC",319,33,"1200x900",600,0,600,400,"True",198,533,521,-12,12,1
"E02SC",320,566,"1200x900",1000,1,600,400,"False",378,472,567,95,95,1
"E02SC",321,594,"1200x900",1000,2,600,400,"False",537,637,440,-197,197,0
"E02SC",322,402,"1200x900",800,2,600,400,"False",878,234,501,267,267,0
"E02SC",323,267,"1200x900",800,0,600,400,"True",145,665,632,-33,33,1
"E02SC",324,78,"1200x900",600,1,600,400,"True",885,684,691,7,7,0
"E02SC",325,22,"1200x900",600,0,600,400,"True",398,591,574,-17,17,1
"E02SC",326,198,"1200x900",600,2,600,400,"True",976,500,554,54,54,0
"E02SC",327,270,"1200x900",800,0,600,400,"False",192,418,493,75,75,1
"E02SC",328,436,"1200x900",1000,0,600,400,"True",82,617,636,19,19,1
"E02SC",329,535,"1200x900",1000,1,600,400,"True",372,410,450,40,40,0
"E02SC",330,379,"1200x900",800,2,600,400,"False",994,325,513,188,188,0
"E02SC",331,2,"1200x900",600,0,600,400,"False",159,323,220,-103,103,0
"E02SC",332,531,"1200x900",1000,1,600,400,"True",233,362,318,-44,44,0
"E02SC",333,547,"1200x900",1000,1,600,400,"True",369,384,447,63,63,1
"E02SC",334,426,"1200x900",800,2,600,400,"True",830,263,319,56,56,0
"E02SC",335,235,"1200x900",800,0,600,400,"True",146,646,667,21,21,1
"E02SC",336,623,"1200x900",1000,2,600,400,"True",636,527,522,-5,5,0
"E02SC",337,131,"1200x900",600,1,600,400,"False",531,367,595,228,228,0
"E02SC",338,179,"1200x900",600,2,600,400,"True",908,602,542,-60,60,0
"E02SC",339,161,"1200x900",600,2,600,400,"True",939,553,496,-57,57,0
"E02SC",340,387,"1200x900",800,2,600,400,"True",990,444,447,3,3,0
"E02SC",341,496,"1200x900",1000,0,600,400,"True",70,639,639,0,0,1
"E02SC",342,476,"1200x900",1000,0,600,400,"False",76,359,439,80,80,1
"E02SC",343,43,"1200x900",600,0,600,400,"False",277,446,640,194,194,1
"E02SC",344,7,"1200x900",600,0,600,400,"False",431,654,553,-101,101,1
"E02SC",345,509,"1200x900",1000,1,600,400,"False",509,434,585,151,151,0
"E02SC",346,175,"1200x900",600,2,600,400,"False",1028,432,558,126,126,0
"E02SC",347,423,"1200x900",800,2,600,400,"False",1051,710,497,-213,213,1
"E02SC",348,460,"1200x900",1000,0,600,400,"False",155,189,323,134,134,1
"E02SC",349,140,"1200x900",600,1,600,400,"True",700,523,505,-18,18,0
"E02SC",350,586,"1200x900",1000,2,600,400,"False",802,262,483,221,221,0
"E02SC",351,467,"1200x900",1000,0,600,400,"False",74,712,559,-153,153,1
"E02SC",352,191,"1200x900",600,2,600,400,"True",962,396,391,-5,5,0
"E02SC",353,127,"1200x900",600,1,600,400,"False",309,691,344,-347,347,0
"E02SC",354,563,"1200x900",1000,1,600,400,"True",201,696,688,-8,8,0
"E02SC",355,331,"1200x900",800,1,600,400,"True",240,620,601,-19,19,0
"E02SC",356,243,"1200x900",800,0,600,400,"True",114,332,338,6,6,1
"E02SC",357,247,"1200x900",800,0,600,400,"False",160,424,271,-153,153,1
"E02SC",358,251,"1200x900",800,0,600,400,"True",88,352,326,-26,26,1
"E02SC",359,28,"1200x900",600,0,600,400,"True",336,410,404,-6,6,1
"E02SC",360,323,"1200x900",800,1,600,400,"True",388,348,337,-11,11,0
"E02SC",361,631,"1200x900",1000,2,600,400,"True",699,479,526,47,47,0
"E02SC",362,250,"1200x900",800,0,600,400,"False",290,248,393,145,145,1
"E02SC",363,349,"1200x900",800,1,600,400,"False",402,665,271,-394,394,0
"E02SC",364,291,"1200x900",800,1,600,400,"False",522,694,518,-176,176,0
"E02SC",365,648,"1200x900",1000,2,600,400,"False",557,394,586,192,192,0
"E02SC",366,537,"1200x900",1000,1,600,400,"False",621,412,546,134,134,1
"E02SC",367,176,"1200x900",600,2,600,400,"False",1033,281,418,137,137,0
"E02SC",368,450,"1200x900",1000,0,600,400,"True",130,204,199,-5,5,1
"E02SC",369,279,"1200x900",800,0,600,400,"True",252,202,241,39,39,1
"E02SC",370,85,"1200x900",600,1,600,400,"False",434,347,191,-156,156,0
"E02SC",371,596,"1200x900",1000,2,600,400,"False",706,513,391,-122,122,0
"E02SC",372,511,"1200x900",1000,1,600,400,"True",408,390,379,-11,11,1
"E02SC",373,285,"1200x900",800,0,600,400,"False",237,396,296,-100,100,1
"E02SC",374,380,"1200x900",800,2,600,400,"True",942,228,315,87,87,0
"E02SC",375,93,"1200x900",600,1,600,400,"False",139,540,378,-162,162,0
"E02SC",376,544,"1200x900",1000,1,600,400,"False",602,620,396,-224,224,0
"E02SC",377,244,"1200x900",800,0,600,400,"True",194,203,186,-17,17,1
"E02SC",378,77,"1200x900",600,1,600,400,"True",780,525,542,17,17,0
"E02SC",379,608,"1200x900",1000,2,600,400,"False",742,250,576,326,326,0
"E02SC",380,190,"1200x900",600,2,600,400,"False",977,238,427,189,189,0
"E02SC",381,367,"1200x900",800,2,600,400,"True",613,464,436,-28,28,0
"E02SC",382,48,"1200x900",600,0,600,400,"True",323,645,667,22,22,1
"E02SC",383,432,"1200x900",800,2,600,400,"True",792,380,376,-4,4,0
"E02SC",384,293,"1200x900",800,1,600,400,"True",561,396,462,66,66,0
"E02SC",385,542,"1200x900",1000,1,600,400,"True",304,401,481,80,80,0
"E02SC",386,151,"1200x900",600,2,600,400,"True",828,680,664,-16,16,0
"E02SC",387,530,"1200x900",1000,1,600,400,"True",584,405,424,19,19,1
"E02SC",388,551,"1200x900",1000,1,600,400,"False",146,445,595,150,150,1
"E02SC",389,152,"1200x900",600,2,600,400,"False",971,399,518,119,119,0
"E02SC",390,575,"1200x900",1000,1,600,400,"False",272,693,540,-153,153,0
"E02SC",391,569,"1200x900",1000,1,600,400,"False",494,720,632,-88,88,0
"E02SC",392,177,"1200x900",600,2,600,400,"False",912,236,594,358,358,0
"E02SC",393,91,"1200x900",600,1,600,400,"False",417,630,512,-118,118,1
"E02SC",394,570,"1200x900",1000,1,600,400,"True",315,352,368,16,16,0
"E02SC",395,199,"1200x900",600,2,600,400,"True",992,467,440,-27,27,0
"E02SC",396,340,"1200x900",800,1,600,400,"False",226,240,315,75,75,0
"E02SC",397,158,"1200x900",600,2,600,400,"False",939,300,439,139,139,0
"E02SC",398,4,"1200x900",600,0,600,400,"False",602,200,314,114,114,1
"E02SC",399,102,"1200x900",600,1,600,400,"False",861,603,494,-109,109,0
"E02SC",400,95,"1200x900",600,1,600,400,"False",749,425,320,-105,105,1
"E02SC",401,42,"1200x900",600,0,600,400,"False",233,479,603,124,124,0
"E02SC",402,262,"1200x900",800,0,600,400,"True",196,481,431,-50,50,1
"E02SC",403,238,"1200x900",800,0,600,400,"False",162,283,379,96,96,1
"E02SC",405,79,"1200x900",600,1,600,400,"True",731,289,309,20,20,0
"E02SC",406,619,"1200x900",1000,2,600,400,"False",803,247,352,105,105,0
"E02SC",407,164,"1200x900",600,2,600,400,"True",1051,268,300,32,32,0
"E02SC",408,435,"1200x900",1000,0,600,400,"True",119,200,199,-1,1,1
"E02SC",409,44,"1200x900",600,0,600,400,"False",305,554,422,-132,132,1
"E02SC",410,81,"1200x900",600,1,600,400,"False",696,225,298,73,73,0
"E02SC",411,40,"1200x900",600,0,600,400,"True",143,513,525,12,12,0
"E02SC",412,233,"1200x900",800,0,600,400,"True",164,700,692,-8,8,1
"E02SC",413,637,"1200x900",1000,2,600,400,"False",750,460,587,127,127,0
"E02SC",414,308,"1200x900",800,1,600,400,"True",437,425,406,-19,19,0
"E02SC",415,572,"1200x900",1000,1,600,400,"False",302,260,441,181,181,0
"E02SC",416,468,"1200x900",1000,0,600,400,"True",121,219,257,38,38,1
"E02SC",417,539,"1200x900",1000,1,600,400,"True",510,383,345,-38,38,0
"E02SC",418,635,"1200x900",1000,2,600,400,"True",833,402,422,20,20,0
"E02SC",419,67,"1200x900",600,0,600,400,"True",289,308,272,-36,36,1
"E02SC",420,39,"1200x900",600,0,600,400,"False",210,609,448,-161,161,0
"E02SC",421,546,"1200x900",1000,1,600,400,"True",305,374,393,19,19,0
"E02SC",422,274,"1200x900",800,0,600,400,"True",146,497,568,71,71,1
"E02SC",423,411,"1200x900",800,2,600,400,"True",805,361,427,66,66,0
"E02SC",424,593,"1200x900",1000,2,600,400,"False",246,719,611,-108,108,0
"E02SC",425,510,"1200x900",1000,1,600,400,"False",486,338,532,194,194,1
"E02SC",426,499,"1200x900",1000,0,600,400,"True",93,271,311,40,40,1
"E02SC",427,463,"1200x900",1000,0,600,400,"True",115,693,662,-31,31,1
"E02SC",428,14,"1200x900",600,0,600,400,"False",399,224,342,118,118,1
"E02SC",429,392,"1200x900",800,2,600,400,"True",1031,618,554,-64,64,0
"E02SC",430,229,"1200x900",800,0,600,400,"False",117,697,615,-82,82,1
"E02SC",431,157,"1200x900",600,2,600,400,"True",1016,323,407,84,84,0
"E02SC",432,449,"1200x900",1000,0,600,400,"False",105,683,610,-73,73,1
"E02SC",433,602,"1200x900",1000,2,600,400,"False",865,452,598,146,146,0
"E02SC",434,505,"1200x900",1000,1,600,400,"False",191,484,597,113,113,1
"E02SC",435,364,"1200x900",800,2,600,400,"False",1018,204,532,328,328,0
"E02SC",436,281,"1200x900",800,0,600,400,"True",112,611,548,-63,63,1
"E02SC",437,346,"1200x900",800,1,600,400,"False",269,635,385,-250,250,0
"E02SC",438,271,"1200x900",800,0,600,400,"True",74,360,388,28,28,1
"E02SC",439,316,"1200x900",800,1,600,400,"True",362,319,284,-35,35,0
"E02SC",440,430,"1200x900",800,2,600,400,"True",922,254,290,36,36,0
"E02SC",441,607,"1200x900",1000,2,600,400,"False",900,573,244,-329,329,1
"E02SC",442,182,"1200x900",600,2,600,400,"True",933,389,356,-33,33,0
"E02SC",443,627,"1200x900",1000,2,600,400,"False",760,510,302,-208,208,0
"E02SC",444,134,"1200x900",600,1,600,400,"True",300,188,261,73,73,0
"E02SC",445,50,"1200x900",600,0,600,400,"False",75,582,515,-67,67,0
"E02SC",446,219,"1200x900",800,0,600,400,"True",202,502,519,17,17,1
"E02SC",447,6,"1200x900",600,0,600,400,"True",217,689,632,-57,57,1
"E02SC",448,644,"1200x900",1000,2,600,400,"False",495,486,718,232,232,0
"E02SC",449,613,"1200x900",1000,2,600,400,"True",690,374,407,33,33,0
"E02SC",450,389,"1200x900",800,2,600,400,"False",843,530,352,-178,178,0
"E02SC",451,493,"1200x900",1000,0,600,400,"True",80,582,628,46,46,1
"E02SC",452,369,"1200x900",800,2,600,400,"False",903,594,410,-184,184,0
"E02SC",453,473,"1200x900",1000,0,600,400,"True",75,323,332,9,9,1
"E02SC",454,560,"1200x900",1000,1,600,400,"False",516,693,480,-213,213,0
"E02SC",455,504,"1200x900",1000,0,600,400,"True",107,699,722,23,23,1
"E02SC",456,309,"1200x900",800,1,600,400,"True",186,225,246,21,21,0
"E02SC",457,614,"1200x900",1000,2,600,400,"False",823,563,321,-242,242,0
"E02SC",458,334,"1200x900",800,1,600,400,"True",481,665,682,17,17,0
"E02SC",459,600,"1200x900",1000,2,600,400,"False",765,207,426,219,219,0
"E02SC",460,118,"1200x900",600,1,600,400,"False",190,588,267,-321,321,0
"E02SC",461,130,"1200x900",600,1,600,400,"False",741,428,343,-85,85,0
"E02SC",462,137,"1200x900",600,1,600,400,"True",789,577,518,-59,59,0
"E02SC",463,96,"1200x900",600,1,600,400,"False",433,458,340,-118,118,0
"E02SC",464,412,"1200x900",800,2,600,400,"False",842,280,379,99,99,0
"E02SC",465,615,"1200x900",1000,2,600,400,"False",736,634,475,-159,159,0
"E02SC",466,106,"1200x900",600,1,600,400,"False",803,659,504,-155,155,1
"E02SC",467,337,"1200x900",800,1,600,400,"False",299,622,233,-389,389,0
"E02SC",468,355,"1200x900",800,1,600,400,"False",77,386,246,-140,140,0
"E02SC",469,420,"1200x900",800,2,600,400,"False",519,223,380,157,157,0
"E02SC",470,273,"1200x900",800,0,600,400,"False",180,309,379,70,70,1
"E02SC",471,319,"1200x900",800,1,600,400,"False",494,587,279,-308,308,1
"E02SC",472,419,"1200x900",800,2,600,400,"False",769,351,507,156,156,0
"E02SC",473,487,"1200x900",1000,0,600,400,"False",78,670,557,-113,113,1
"E02SC",474,266,"1200x900",800,0,600,400,"False",126,303,175,-128,128,1
"E02SC",475,452,"1200x900",1000,0,600,400,"False",97,273,433,160,160,1
"E02SC",476,60,"1200x900",600,0,600,400,"False",365,213,288,75,75,1
"E02SC",477,218,"1200x900",800,0,600,400,"True",106,397,401,4,4,1
"E02SC",478,237,"1200x900",800,0,600,400,"True",204,481,486,5,5,1
"E02SC",479,326,"1200x900",800,1,600,400,"False",103,482,304,-178,178,0
"E02SC",480,41,"1200x900",600,0,600,400,"True",370,452,388,-64,64,1
"E02SC",481,352,"1200x900",800,1,600,400,"False",235,717,209,-508,508,0
"E02SC",482,166,"1200x900",600,2,600,400,"False",896,274,424,150,150,0
"E02SC",483,317,"1200x900",800,1,600,400,"True",185,564,500,-64,64,0
"E02SC",484,286,"1200x900",800,0,600,400,"True",105,378,345,-33,33,1
"E02SC",485,328,"1200x900",800,1,600,400,"False",104,649,360,-289,289,0
"E02SC",486,515,"1200x900",1000,1,600,400,"False",307,217,372,155,155,0
"E02SC",487,304,"1200x900",800,1,600,400,"False",667,605,435,-170,170,0
"E02SC",488,621,"1200x900",1000,2,600,400,"True",540,478,457,-21,21,0
"E02SC",489,527,"1200x900",1000,1,600,400,"True",565,601,652,51,51,0
"E02SC",490,383,"1200x900",800,2,600,400,"False",855,407,666,259,259,0
"E02SC",491,173,"1200x900",600,2,600,400,"True",948,693,658,-35,35,0
"E02SC",492,312,"1200x900",800,1,600,400,"False",238,683,580,-103,103,0
"E02SC",493,211,"1200x900",600,2,600,400,"True",986,407,447,40,40,0
"E02SC",494,153,"1200x900",600,2,600,400,"True",1037,601,607,6,6,0
"E02SC",495,443,"1200x900",1000,0,600,400,"True",99,651,645,-6,6,1
"E02SC",496,143,"1200x900",600,1,600,400,"False",479,284,640,356,356,1
"E02SC",497,482,"1200x900",1000,0,600,400,"False",79,686,614,-72,72,1
"E02SC",498,201,"1200x900",600,2,600,400,"True",1005,462,489,27,27,0
"E02SC",499,289,"1200x900",800,1,600,400,"False",421,703,202,-501,501,1
"E02SC",500,559,"1200x900",1000,1,600,400,"True",641,244,296,52,52,0
"E02SC",501,29,"1200x900",600,0,600,400,"True",385,533,590,57,57,1
"E02SC",502,123,"1200x900",600,1,600,400,"False",761,365,304,-61,61,1
"E02SC",503,194,"1200x900",600,2,600,400,"False",896,236,325,89,89,0
"E02SC",504,414,"1200x900",800,2,600,400,"False",831,592,482,-110,110,0
"E02SC",505,557,"1200x900",1000,1,600,400,"False",677,505,580,75,75,1
"E02SC",506,168,"1200x900",600,2,600,400,"True",1001,439,411,-28,28,0
"E02SC",507,21,"1200x900",600,0,600,400,"True",314,383,326,-57,57,1
"E02SC",508,490,"1200x900",1000,0,600,400,"True",114,183,194,11,11,1
"E02SC",509,55,"1200x900",600,0,600,400,"True",211,305,252,-53,53,1
"E02SC",510,567,"1200x900",1000,1,600,400,"True",655,297,312,15,15,1
"E02SC",511,163,"1200x900",600,2,600,400,"False",1046,665,322,-343,343,0
"E02SC",512,384,"1200x900",800,2,600,400,"True",821,707,643,-64,64,0
"E02SC",513,335,"1200x900",800,1,600,400,"False",124,360,160,-200,200,0
"E02SC",514,333,"1200x900",800,1,600,400,"False",521,548,371,-177,177,0
"E02SC",515,529,"1200x900",1000,1,600,400,"True",267,412,445,33,33,1
"E02SC",516,428,"1200x900",800,2,600,400,"False",732,665,395,-270,270,0
"E02SC",517,549,"1200x900",1000,1,600,400,"False",657,366,444,78,78,0
"E02SC",518,556,"1200x900",1000,1,600,400,"False",415,420,314,-106,106,0
"E02SC",519,390,"1200x900",800,2,600,400,"True",982,674,622,-52,52,1
"E02SC",520,403,"1200x900",800,2,600,400,"False",625,704,543,-161,161,0
"E02SC",521,391,"1200x900",800,2,600,400,"False",895,521,282,-239,239,0
"E02SC",522,294,"1200x900",800,1,600,400,"True",262,287,301,14,14,0
"E02SC",523,336,"1200x900",800,1,600,400,"False",251,587,300,-287,287,0
"E02SC",524,561,"1200x900",1000,1,600,400,"False",231,406,240,-166,166,0
"E02SC",525,109,"1200x900",600,1,600,400,"True",691,589,626,37,37,0
"E02SC",526,69,"1200x900",600,0,600,400,"True",322,268,265,-3,3,0
"E02SC",527,178,"1200x900",600,2,600,400,"False",1041,510,638,128,128,0
"E02SC",528,371,"1200x900",800,2,600,400,"False",730,560,471,-89,89,0
"E02SC",529,406,"1200x900",800,2,600,400,"False",971,233,556,323,323,0
"E02SC",530,301,"1200x900",800,1,600,400,"False",162,574,369,-205,205,0
"E02SC",531,489,"1200x900",1000,0,600,400,"False",88,604,505,-99,99,1
"E02SC",532,125,"1200x900",600,1,600,400,"True",750,531,526,-5,5,0
"E02SC",533,240,"1200x900",800,0,600,400,"True",330,656,656,0,0,1
"E02SC",534,618,"1200x900",1000,2,600,400,"False",276,671,778,107,107,0
"E02SC",535,204,"1200x900",600,2,600,400,"False",1053,432,296,-136,136,0
"E02SC",536,343,"1200x900",800,1,600,400,"True",407,557,581,24,24,0
"E02SC",537,388,"1200x900",800,2,600,400,"True",930,320,366,46,46,0
"E02SC",538,408,"1200x900",800,2,600,400,"False",758,567,450,-117,117,0
"E02SC",539,466,"1200x900",1000,0,600,400,"False",82,205,284,79,79,1
"E02SC",540,469,"1200x900",1000,0,600,400,"True",73,227,202,-25,25,1
"E02SC",541,36,"1200x900",600,0,600,400,"False",128,346,275,-71,71,1
"E02SC",542,407,"1200x900",800,2,600,400,"True",989,340,345,5,5,0
"E02SC",543,126,"1200x900",600,1,600,400,"True",849,354,344,-10,10,0
"E02SC",544,305,"1200x900",800,1,600,400,"False",471,716,410,-306,306,0
"E02SC",545,139,"1200x900",600,1,600,400,"False",192,695,271,-424,424,0
"E02SC",546,89,"1200x900",600,1,600,400,"True",917,366,349,-17,17,1
"E02SC",547,205,"1200x900",600,2,600,400,"False",1021,504,612,108,108,0
"E02SC",548,445,"1200x900",1000,0,600,400,"False",78,302,181,-121,121,1
"E02SC",549,540,"1200x900",1000,1,600,400,"False",389,568,312,-256,256,1
"E02SC",550,536,"1200x900",1000,1,600,400,"False",580,213,339,126,126,0
"E02SC",551,110,"1200x900",600,1,600,400,"True",776,550,479,-71,71,1
"E02SC",552,120,"1200x900",600,1,600,400,"True",690,655,616,-39,39,0
"E02SC",553,10,"1200x900",600,0,600,400,"True",400,499,532,33,33,1
"E02SC",554,447,"1200x900",1000,0,600,400,"True",71,339,279,-60,60,1
"E02SC",555,90,"1200x900",600,1,600,400,"False",560,474,332,-142,142,0
"E02SC",556,592,"1200x900",1000,2,600,400,"True",492,392,406,14,14,0
"E02SC",557,647,"1200x900",1000,2,600,400,"False",560,637,349,-288,288,0
"E02SC",558,133,"1200x900",600,1,600,400,"False",345,551,322,-229,229,0
"E02SC",559,248,"1200x900",800,0,600,400,"True",94,240,170,-70,70,1
"E02SC",560,584,"1200x900",1000,2,600,400,"True",731,413,364,-49,49,0
"E02SC",561,280,"1200x900",800,0,600,400,"False",104,302,171,-131,131,1
"E02SC",562,603,"1200x900",1000,2,600,400,"True",693,280,327,47,47,0
"E02SC",563,87,"1200x900",600,1,600,400,"False",231,604,276,-328,328,0
"E02SC",564,513,"1200x900",1000,1,600,400,"False",235,602,399,-203,203,0
"E02SC",565,252,"1200x900",800,0,600,400,"True",224,673,620,-53,53,1
"E02SC",566,112,"1200x900",600,1,600,400,"False",681,490,602,112,112,0
"E02SC",567,159,"1200x900",600,2,600,400,"True",992,309,388,79,79,0
"E02SC",568,52,"1200x900",600,0,600,400,"False",171,188,260,72,72,0
"E02SC",569,638,"1200x900",1000,2,600,400,"False",385,198,305,107,107,0
"E02SC",570,421,"1200x900",800,2,600,400,"False",898,394,188,-206,206,0
"E02SC",571,453,"1200x900",1000,0,600,400,"False",71,393,492,99,99,1
"E02SC",572,633,"1200x900",1000,2,600,400,"False",564,253,607,354,354,0
"E02SC",573,214,"1200x900",600,2,600,400,"False",1046,305,474,169,169,0
"E02SC",574,62,"1200x900",600,0,600,400,"True",345,346,386,40,40,1
"E02SC",575,210,"1200x900",600,2,600,400,"True",835,506,469,-37,37,0
"E02SC",576,255,"1200x900",800,0,600,400,"True",93,709,666,-43,43,1
"E02SC",577,610,"1200x900",1000,2,600,400,"False",702,293,461,168,168,0
"E02SC",578,37,"1200x900",600,0,600,400,"True",258,403,421,18,18,1
"E02SC",579,457,"1200x900",1000,0,600,400,"False",97,630,485,-145,145,1
"E02SC",580,358,"1200x900",800,1,600,400,"False",263,635,372,-263,263,0
"E02SC",581,507,"1200x900",1000,1,600,400,"False",608,583,344,-239,239,1
"E02SC",582,59,"1200x900",600,0,600,400,"True",391,692,698,6,6,1
"E02SC",583,224,"1200x900",800,0,600,400,"True",161,474,487,13,13,1
"E02SC",584,642,"1200x900",1000,2,600,400,"False",776,316,403,87,87,0
"E02SC",585,20,"1200x900",600,0,600,400,"True",204,545,573,28,28,1
"E02SC",586,576,"1200x900",1000,1,600,400,"True",376,713,671,-42,42,0
"E02SC",587,514,"1200x900",1000,1,600,400,"False",539,690,567,-123,123,0
"E02SC",588,361,"1200x900",800,2,600,400,"False",931,328,517,189,189,0
"E02SC",589,639,"1200x900",1000,2,600,400,"False",504,456,313,-143,143,0
"E02SC",590,444,"1200x900",1000,0,600,400,"True",101,714,655,-59,59,1
"E02SC",591,82,"1200x900",600,1,600,400,"False",108,213,484,271,271,0
"E02SC",592,27,"1200x900",600,0,600,400,"False",373,309,183,-126,126,1
"E02SC",593,9,"1200x900",600,0,600,400,"True",509,654,610,-44,44,1
"E02SC",594,471,"1200x900",1000,0,600,400,"True",122,200,123,-77,77,1
"E02SC",595,242,"1200x900",800,0,600,400,"False",117,448,296,-152,152,1
"E02SC",596,296,"1200x900",800,1,600,400,"False",89,279,545,266,266,0
"E02SC",597,538,"1200x900",1000,1,600,400,"False",308,457,210,-247,247,1
"E02SC",598,548,"1200x900",1000,1,600,400,"False",103,278,195,-83,83,0
"E02SC",599,519,"1200x900",1000,1,600,400,"False",319,565,325,-240,240,1
"E02SC",600,498,"1200x900",1000,0,600,400,"True",100,260,239,-21,21,1
"E02SC",601,315,"1200x900",800,1,600,400,"False",105,211,360,149,149,0
"E02SC",602,636,"1200x900",1000,2,600,400,"False",575,583,428,-155,155,0
"E02SC",603,477,"1200x900",1000,0,600,400,"True",88,640,657,17,17,1
"E02SC",604,393,"1200x900",800,2,600,400,"False",657,620,449,-171,171,0
"E02SC",605,424,"1200x900",800,2,600,400,"False",903,545,358,-187,187,0
"E02SC",606,258,"1200x900",800,0,600,400,"True",126,664,684,20,20,1
"E02SC",607,363,"1200x900",800,2,600,400,"False",800,218,360,142,142,0
"E02SC",608,376,"1200x900",800,2,600,400,"True",788,275,245,-30,30,0
"E02SC",609,632,"1200x900",1000,2,600,400,"False",984,227,625,398,398,0
"E02SC",610,520,"1200x900",1000,1,600,400,"False",564,260,490,230,230,0
"E02SC",611,170,"1200x900",600,2,600,400,"False",996,468,272,-196,196,0
"E02SC",612,61,"1200x900",600,0,600,400,"True",272,670,688,18,18,1
"E02SC",613,34,"1200x900",600,0,600,400,"True",361,242,221,-21,21,1
"E02SC",614,565,"1200x900",1000,1,600,400,"False",451,562,644,82,82,0
"E02SC",615,98,"1200x900",600,1,600,400,"True",625,530,550,20,20,0
"E02SC",616,122,"1200x900",600,1,600,400,"False",817,709,619,-90,90,0
"E02SC",617,373,"1200x900",800,2,600,400,"False",694,326,488,162,162,0
"E02SC",618,132,"1200x900",600,1,600,400,"True",333,185,230,45,45,0
"E02SC",619,145,"1200x900",600,2,600,400,"True",1004,630,592,-38,38,0
"E02SC",620,169,"1200x900",600,2,600,400,"False",924,290,402,112,112,0
"E02SC",621,579,"1200x900",1000,2,600,400,"False",803,394,542,148,148,0
"E02SC",622,362,"1200x900",800,2,600,400,"False",819,338,412,74,74,0
"E02SC",623,571,"1200x900",1000,1,600,400,"True",239,522,551,29,29,1
"E02SC",624,429,"1200x900",800,2,600,400,"True",682,692,627,-65,65,0
"E02SC",625,185,"1200x900",600,2,600,400,"False",907,212,425,213,213,0
"E02SC",626,272,"1200x900",800,0,600,400,"False",200,181,388,207,207,1
"E02SC",627,128,"1200x900",600,1,600,400,"True",661,258,253,-5,5,1
"E02SC",628,104,"1200x900",600,1,600,400,"False",448,584,330,-254,254,0
"E02SC",629,257,"1200x900",800,0,600,400,"True",97,219,193,-26,26,1
"E02SC",630,386,"1200x900",800,2,600,400,"False",774,301,233,-68,68,0
"E02SC",631,330,"1200x900",800,1,600,400,"True",759,301,273,-28,28,1
"E02SC",632,212,"1200x900",600,2,600,400,"False",841,206,303,97,97,0
"E02SC",633,115,"1200x900",600,1,600,400,"False",545,307,215,-92,92,0
"E02SC",634,135,"1200x900",600,1,600,400,"True",759,569,630,61,61,0
"E02SC",635,70,"1200x900",600,0,600,400,"True",309,703,728,25,25,1
"E02SC",636,103,"1200x900",600,1,600,400,"False",528,320,534,214,214,1
"E02SC",637,532,"1200x900",1000,1,600,400,"False",215,207,306,99,99,0
"E02SC",638,351,"1200x900",800,1,600,400,"False",122,581,303,-278,278,0
"E02SC",639,617,"1200x900",1000,2,600,400,"False",294,180,311,131,131,0
"E02SC",640,442,"1200x900",1000,0,600,400,"False",87,183,256,73,73,1
"E02SC",641,634,"1200x900",1000,2,600,400,"True",735,313,343,30,30,0
"E02SC",642,269,"1200x900",800,0,600,400,"True",160,295,335,40,40,1
"E02SC",643,478,"1200x900",1000,0,600,400,"False",79,672,294,-378,378,1
"E02SC",644,641,"1200x900",1000,2,600,400,"False",897,272,544,272,272,0
"E02SC",645,277,"1200x900",800,0,600,400,"False",140,310,207,-103,103,1
"E02SC",646,348,"1200x900",800,1,600,400,"True",764,294,356,62,62,0
"E02SC",647,35,"1200x900",600,0,600,400,"True",366,555,533,-22,22,1
"E02SC",648,188,"1200x900",600,2,600,400,"False",900,195,347,152,152,0
"E03DB",1,260,"1200x900",800,0,600,400,"False",103,525,460,-65,65,1
"E03DB",2,249,"1200x900",800,0,600,400,"False",126,306,374,68,68,1
"E03DB",3,262,"1200x900",800,0,600,400,"False",196,481,385,-96,96,1
"E03DB",4,89,"1200x900",600,1,600,400,"False",917,366,484,118,118,1
"E03DB",5,376,"1200x900",800,2,600,400,"False",788,275,458,183,183,0
"E03DB",6,107,"1200x900",600,1,600,400,"True",878,678,711,33,33,0
"E03DB",7,450,"1200x900",1000,0,600,400,"False",130,204,338,134,134,1
"E03DB",8,171,"1200x900",600,2,600,400,"False",909,200,528,328,328,0
"E03DB",9,523,"1200x900",1000,1,600,400,"False",339,318,219,-99,99,0
"E03DB",10,564,"1200x900",1000,1,600,400,"False",215,264,391,127,127,0
"E03DB",11,484,"1200x900",1000,0,600,400,"False",100,223,339,116,116,1
"E03DB",12,517,"1200x900",1000,1,600,400,"True",548,182,227,45,45,0
"E03DB",13,440,"1200x900",1000,0,600,400,"True",71,237,242,5,5,1
"E03DB",14,190,"1200x900",600,2,600,400,"False",977,238,443,205,205,0
"E03DB",15,426,"1200x900",800,2,600,400,"True",830,263,253,-10,10,0
"E03DB",16,570,"1200x900",1000,1,600,400,"True",315,352,423,71,71,0
"E03DB",17,133,"1200x900",600,1,600,400,"False",345,551,354,-197,197,0
"E03DB",18,121,"1200x900",600,1,600,400,"True",884,364,417,53,53,0
"E03DB",19,182,"1200x900",600,2,600,400,"True",933,389,373,-16,16,0
"E03DB",20,549,"1200x900",1000,1,600,400,"True",657,366,366,0,0,0
"E03DB",21,345,"1200x900",800,1,600,400,"True",841,566,619,53,53,1
"E03DB",22,270,"1200x900",800,0,600,400,"True",192,418,460,42,42,1
"E03DB",23,420,"1200x900",800,2,600,400,"False",519,223,417,194,194,0
"E03DB",24,299,"1200x900",800,1,600,400,"False",779,274,692,418,418,0
"E03DB",25,492,"1200x900",1000,0,600,400,"False",76,692,514,-178,178,1
"E03DB",26,18,"1200x900",600,0,600,400,"False",400,318,412,94,94,1
"E03DB",27,507,"1200x900",1000,1,600,400,"True",608,583,646,63,63,1
"E03DB",28,425,"1200x900",800,2,600,400,"False",621,438,369,-69,69,0
"E03DB",29,466,"1200x900",1000,0,600,400,"False",82,205,356,151,151,1
"E03DB",30,49,"1200x900",600,0,600,400,"True",109,380,373,-7,7,0
"E03DB",31,594,"1200x900",1000,2,600,400,"False",537,637,380,-257,257,0
"E03DB",32,2,"1200x900",600,0,600,400,"True",159,323,374,51,51,0
"E03DB",33,175,"1200x900",600,2,600,400,"False",1028,432,360,-72,72,0
"E03DB",34,329,"1200x900",800,1,600,400,"False",517,239,320,81,81,0
"E03DB",35,619,"1200x900",1000,2,600,400,"False",803,247,332,85,85,0
"E03DB",36,436,"1200x900",1000,0,600,400,"False",82,617,399,-218,218,1
"E03DB",37,146,"1200x900",600,2,600,400,"True",989,492,465,-27,27,0
"E03DB",38,245,"1200x900",800,0,600,400,"True",296,235,288,53,53,1
"E03DB",39,346,"1200x900",800,1,600,400,"False",269,635,749,114,114,0
"E03DB",40,410,"1200x900",800,2,600,400,"True",916,477,427,-50,50,0
"E03DB",41,622,"1200x900",1000,2,600,400,"False",307,683,557,-126,126,0
"E03DB",42,112,"1200x900",600,1,600,400,"False",681,490,302,-188,188,0
"E03DB",43,314,"1200x900",800,1,600,400,"False",277,616,464,-152,152,1
"E03DB",44,500,"1200x900",1000,0,600,400,"False",105,700,537,-163,163,1
"E03DB",45,634,"1200x900",1000,2,600,400,"False",735,313,420,107,107,0
"E03DB",46,141,"1200x900",600,1,600,400,"True",671,582,641,59,59,0
"E03DB",47,67,"1200x900",600,0,600,400,"False",289,308,375,67,67,1
"E03DB",48,117,"1200x900",600,1,600,400,"False",711,456,249,-207,207,0
"E03DB",49,322,"1200x900",800,1,600,400,"False",703,206,280,74,74,1
"E03DB",50,22,"1200x900",600,0,600,400,"True",398,591,590,-1,1,1
"E03DB",51,442,"1200x900",1000,0,600,400,"False",87,183,388,205,205,1
"E03DB",52,275,"1200x900",800,0,600,400,"False",120,594,481,-113,113,0
"E03DB",53,647,"1200x900",1000,2,600,400,"True",560,637,574,-63,63,0
"E03DB",54,77,"1200x900",600,1,600,400,"False",780,525,392,-133,133,0
"E03DB",55,238,"1200x900",800,0,600,400,"True",162,283,312,29,29,1
"E03DB",56,493,"1200x900",1000,0,600,400,"False",80,582,432,-150,150,1
"E03DB",57,177,"1200x900",600,2,600,400,"True",912,236,278,42,42,0
"E03DB",58,149,"1200x900",600,2,600,400,"True",890,289,373,84,84,0
"E03DB",59,166,"1200x900",600,2,600,400,"False",896,274,362,88,88,0
"E03DB",60,544,"1200x900",1000,1,600,400,"True",602,620,675,55,55,0
"E03DB",61,475,"1200x900",1000,0,600,400,"False",101,715,645,-70,70,1
"E03DB",62,278,"1200x900",800,0,600,400,"True",251,711,664,-47,47,1
"E03DB",63,66,"1200x900",600,0,600,400,"True",155,673,640,-33,33,0
"E03DB",64,636,"1200x900",1000,2,600,400,"False",575,583,768,185,185,0
"E03DB",65,602,"1200x900",1000,2,600,400,"False",865,452,285,-167,167,0
"E03DB",66,264,"1200x900",800,0,600,400,"True",198,660,611,-49,49,1
"E03DB",67,34,"1200x900",600,0,600,400,"True",361,242,249,7,7,1
"E03DB",68,85,"1200x900",600,1,600,400,"False",434,347,580,233,233,0
"E03DB",69,4,"1200x900",600,0,600,400,"False",602,200,368,168,168,1
"E03DB",70,28,"1200x900",600,0,600,400,"True",336,410,404,-6,6,1
"E03DB",71,355,"1200x900",800,1,600,400,"False",77,386,508,122,122,0
"E03DB",72,344,"1200x900",800,1,600,400,"True",589,408,442,34,34,0
"E03DB",73,132,"1200x900",600,1,600,400,"False",333,185,366,181,181,0
"E03DB",74,411,"1200x900",800,2,600,400,"True",805,361,329,-32,32,0
"E03DB",75,210,"1200x900",600,2,600,400,"False",835,506,564,58,58,0
"E03DB",76,461,"1200x900",1000,0,600,400,"False",95,711,644,-67,67,1
"E03DB",77,296,"1200x900",800,1,600,400,"True",89,279,241,-38,38,0
"E03DB",78,637,"1200x900",1000,2,600,400,"True",750,460,470,10,10,0
"E03DB",79,199,"1200x900",600,2,600,400,"True",992,467,419,-48,48,0
"E03DB",80,137,"1200x900",600,1,600,400,"True",789,577,578,1,1,0
"E03DB",81,432,"1200x900",800,2,600,400,"True",792,380,408,28,28,0
"E03DB",82,358,"1200x900",800,1,600,400,"False",263,635,350,-285,285,0
"E03DB",83,573,"1200x900",1000,1,600,400,"True",486,615,663,48,48,0
"E03DB",84,487,"1200x900",1000,0,600,400,"True",78,670,635,-35,35,1
"E03DB",85,612,"1200x900",1000,2,600,400,"False",706,198,606,408,408,0
"E03DB",86,455,"1200x900",1000,0,600,400,"False",107,718,642,-76,76,1
"E03DB",87,610,"1200x900",1000,2,600,400,"False",702,293,468,175,175,0
"E03DB",88,640,"1200x900",1000,2,600,400,"False",361,334,432,98,98,0
"E03DB",89,191,"1200x900",600,2,600,400,"False",962,396,507,111,111,0
"E03DB",90,1,"1200x900",600,0,600,400,"True",136,502,506,4,4,0
"E03DB",91,430,"1200x900",800,2,600,400,"False",922,254,427,173,173,0
"E03DB",92,604,"1200x900",1000,2,600,400,"False",459,593,501,-92,92,0
"E03DB",93,131,"1200x900",600,1,600,400,"False",531,367,433,66,66,0
"E03DB",95,298,"1200x900",800,1,600,400,"False",311,457,368,-89,89,0
"E03DB",96,308,"1200x900",800,1,600,400,"False",437,425,572,147,147,0
"E03DB",97,522,"1200x900",1000,1,600,400,"False",223,379,479,100,100,0
"E03DB",98,579,"1200x900",1000,2,600,400,"True",803,394,446,52,52,0
"E03DB",99,116,"1200x900",600,1,600,400,"False",767,289,515,226,226,0
"E03DB",100,585,"1200x900",1000,2,600,400,"False",698,688,427,-261,261,1
"E03DB",101,144,"1200x900",600,1,600,400,"False",718,371,533,162,162,0
"E03DB",102,71,"1200x900",600,0,600,400,"True",219,248,183,-65,65,0
"E03DB",103,407,"1200x900",800,2,600,400,"True",989,340,398,58,58,0
"E03DB",104,575,"1200x900",1000,1,600,400,"False",272,693,598,-95,95,0
"E03DB",105,135,"1200x900",600,1,600,400,"True",759,569,554,-15,15,0
"E03DB",106,428,"1200x900",800,2,600,400,"False",732,665,553,-112,112,0
"E03DB",107,629,"1200x900",1000,2,600,400,"False",681,257,653,396,396,0
"E03DB",108,555,"1200x900",1000,1,600,400,"True",444,556,561,5,5,0
"E03DB",109,167,"1200x900",600,2,600,400,"False",956,241,482,241,241,0
"E03DB",110,15,"1200x900",600,0,600,400,"False",473,352,429,77,77,1
"E03DB",111,364,"1200x900",800,2,600,400,"False",1018,204,661,457,457,0
"E03DB",112,310,"1200x900",800,1,600,400,"True",559,592,656,64,64,0
"E03DB",113,123,"1200x900",600,1,600,400,"False",761,365,538,173,173,1
"E03DB",114,103,"1200x900",600,1,600,400,"False",528,320,455,135,135,1
"E03DB",115,452,"1200x900",1000,0,600,400,"False",97,273,354,81,81,1
"E03DB",116,115,"1200x900",600,1,600,400,"False",545,307,199,-108,108,0
"E03DB",117,480,"1200x900",1000,0,600,400,"True",100,231,254,23,23,1
"E03DB",118,60,"1200x900",600,0,600,400,"True",365,213,255,42,42,1
"E03DB",119,200,"1200x900",600,2,600,400,"False",897,302,202,-100,100,0
"E03DB",120,174,"1200x900",600,2,600,400,"False",998,457,340,-117,117,0
"E03DB",121,241,"1200x900",800,0,600,400,"False",129,227,310,83,83,1
"E03DB",122,592,"1200x900",1000,2,600,400,"True",492,392,397,5,5,0
"E03DB",123,431,"1200x900",800,2,600,400,"True",694,382,383,1,1,0
"E03DB",124,400,"1200x900",800,2,600,400,"True",733,297,342,45,45,0
"E03DB",125,173,"1200x900",600,2,600,400,"True",948,693,735,42,42,0
"E03DB",126,307,"1200x900",800,1,600,400,"False",716,247,376,129,129,0
"E03DB",127,98,"1200x900",600,1,600,400,"False",625,530,456,-74,74,0
"E03DB",128,485,"1200x900",1000,0,600,400,"False",121,694,623,-71,71,1
"E03DB",129,148,"1200x900",600,2,600,400,"False",907,330,448,118,118,0
"E03DB",130,109,"1200x900",600,1,600,400,"False",691,589,671,82,82,0
"E03DB",131,336,"1200x900",800,1,600,400,"False",251,587,680,93,93,0
"E03DB",132,620,"1200x900",1000,2,600,400,"False",832,649,548,-101,101,0
"E03DB",133,187,"1200x900",600,2,600,400,"True",857,639,571,-68,68,0
"E03DB",134,477,"1200x900",1000,0,600,400,"True",88,640,601,-39,39,1
"E03DB",135,250,"1200x900",800,0,600,400,"False",290,248,498,250,250,1
"E03DB",136,459,"1200x900",1000,0,600,400,"False",70,645,555,-90,90,1
"E03DB",137,36,"1200x900",600,0,600,400,"False",128,346,424,78,78,1
"E03DB",138,118,"1200x900",600,1,600,400,"False",190,588,676,88,88,0
"E03DB",139,641,"1200x900",1000,2,600,400,"False",897,272,677,405,405,0
"E03DB",140,255,"1200x900",800,0,600,400,"False",93,709,563,-146,146,1
"E03DB",141,363,"1200x900",800,2,600,400,"False",800,218,424,206,206,0
"E03DB",142,389,"1200x900",800,2,600,400,"False",843,530,358,-172,172,0
"E03DB",143,473,"1200x900",1000,0,600,400,"False",75,323,400,77,77,1
"E03DB",144,393,"1200x900",800,2,600,400,"False",657,620,408,-212,212,0
"E03DB",145,45,"1200x900",600,0,600,400,"False",487,678,561,-117,117,1
"E03DB",146,216,"1200x900",600,2,600,400,"True",1029,286,369,83,83,0
"E03DB",147,247,"1200x900",800,0,600,400,"False",160,424,496,72,72,1
"E03DB",148,482,"1200x900",1000,0,600,400,"False",79,686,564,-122,122,1
"E03DB",149,143,"1200x900",600,1,600,400,"False",479,284,418,134,134,1
"E03DB",150,17,"1200x900",600,0,600,400,"True",402,496,442,-54,54,1
"E03DB",151,556,"1200x900",1000,1,600,400,"True",415,420,456,36,36,0
"E03DB",152,288,"1200x900",800,0,600,400,"True",180,547,526,-21,21,1
"E03DB",153,499,"1200x900",1000,0,600,400,"False",93,271,460,189,189,1
"E03DB",154,79,"1200x900",600,1,600,400,"True",731,289,313,24,24,0
"E03DB",155,412,"1200x900",800,2,600,400,"False",842,280,372,92,92,0
"E03DB",156,606,"1200x900",1000,2,600,400,"True",653,627,591,-36,36,0
"E03DB",157,38,"1200x900",600,0,600,400,"False",120,628,523,-105,105,1
"E03DB",158,160,"1200x900",600,2,600,400,"True",863,606,659,53,53,0
"E03DB",159,423,"1200x900",800,2,600,400,"False",1051,710,598,-112,112,1
"E03DB",160,265,"1200x900",800,0,600,400,"False",229,353,421,68,68,1
"E03DB",162,532,"1200x900",1000,1,600,400,"False",215,207,365,158,158,0
"E03DB",163,224,"1200x900",800,0,600,400,"True",161,474,434,-40,40,1
"E03DB",164,391,"1200x900",800,2,600,400,"True",895,521,514,-7,7,0
"E03DB",165,152,"1200x900",600,2,600,400,"False",971,399,516,117,117,0
"E03DB",166,464,"1200x900",1000,0,600,400,"False",82,222,426,204,204,1
"E03DB",167,526,"1200x900",1000,1,600,400,"False",497,710,629,-81,81,0
"E03DB",168,562,"1200x900",1000,1,600,400,"False",347,540,632,92,92,0
"E03DB",169,353,"1200x900",800,1,600,400,"False",90,476,588,112,112,0
"E03DB",170,456,"1200x900",1000,0,600,400,"False",91,257,369,112,112,1
"E03DB",171,392,"1200x900",800,2,600,400,"True",1031,618,602,-16,16,0
"E03DB",172,285,"1200x900",800,0,600,400,"False",237,396,487,91,91,1
"E03DB",173,61,"1200x900",600,0,600,400,"True",272,670,704,34,34,1
"E03DB",174,457,"1200x900",1000,0,600,400,"True",97,630,640,10,10,1
"E03DB",175,446,"1200x900",1000,0,600,400,"False",72,298,444,146,146,1
"E03DB",176,317,"1200x900",800,1,600,400,"False",185,564,779,215,215,0
"E03DB",177,502,"1200x900",1000,0,600,400,"True",111,639,584,-55,55,1
"E03DB",178,545,"1200x900",1000,1,600,400,"True",358,562,583,21,21,0
"E03DB",180,96,"1200x900",600,1,600,400,"False",433,458,539,81,81,0
"E03DB",181,577,"1200x900",1000,2,600,400,"False",455,420,525,105,105,0
"E03DB",182,186,"1200x900",600,2,600,400,"False",997,197,432,235,235,0
"E03DB",183,168,"1200x900",600,2,600,400,"True",1001,439,471,32,32,0
"E03DB",184,126,"1200x900",600,1,600,400,"False",849,354,489,135,135,0
"E03DB",185,323,"1200x900",800,1,600,400,"False",388,348,497,149,149,0
"E03DB",186,618,"1200x900",1000,2,600,400,"False",276,671,779,108,108,0
"E03DB",187,159,"1200x900",600,2,600,400,"False",992,309,550,241,241,0
"E03DB",188,435,"1200x900",1000,0,600,400,"False",119,200,335,135,135,1
"E03DB",189,5,"1200x900",600,0,600,400,"True",228,587,529,-58,58,0
"E03DB",190,433,"1200x900",1000,0,600,400,"True",76,222,282,60,60,1
"E03DB",191,86,"1200x900",600,1,600,400,"False",692,388,267,-121,121,1
"E03DB",192,514,"1200x900",1000,1,600,400,"True",539,690,654,-36,36,0
"E03DB",193,58,"1200x900",600,0,600,400,"True",353,655,672,17,17,1
"E03DB",194,235,"1200x900",800,0,600,400,"True",146,646,673,27,27,1
"E03DB",195,617,"1200x900",1000,2,600,400,"False",294,180,563,383,383,0
"E03DB",196,259,"1200x900",800,0,600,400,"False",156,180,306,126,126,1
"E03DB",197,565,"1200x900",1000,1,600,400,"False",451,562,481,-81,81,0
"E03DB",198,145,"1200x900",600,2,600,400,"False",1004,630,691,61,61,0
"E03DB",199,530,"1200x900",1000,1,600,400,"True",584,405,401,-4,4,1
"E03DB",200,536,"1200x900",1000,1,600,400,"True",580,213,242,29,29,0
"E03DB",201,331,"1200x900",800,1,600,400,"True",240,620,557,-63,63,0
"E03DB",202,593,"1200x900",1000,2,600,400,"True",246,719,712,-7,7,0
"E03DB",203,557,"1200x900",1000,1,600,400,"True",677,505,511,6,6,1
"E03DB",204,365,"1200x900",800,2,600,400,"False",1055,305,606,301,301,0
"E03DB",205,330,"1200x900",800,1,600,400,"False",759,301,226,-75,75,1
"E03DB",206,220,"1200x900",800,0,600,400,"True",108,699,688,-11,11,1
"E03DB",207,7,"1200x900",600,0,600,400,"False",431,654,575,-79,79,1
"E03DB",208,486,"1200x900",1000,0,600,400,"False",102,676,581,-95,95,1
"E03DB",209,229,"1200x900",800,0,600,400,"True",117,697,694,-3,3,1
"E03DB",210,29,"1200x900",600,0,600,400,"True",385,533,583,50,50,1
"E03DB",211,81,"1200x900",600,1,600,400,"True",696,225,287,62,62,0
"E03DB",213,102,"1200x900",600,1,600,400,"False",861,603,499,-104,104,0
"E03DB",214,414,"1200x900",800,2,600,400,"True",831,592,587,-5,5,0
"E03DB",215,488,"1200x900",1000,0,600,400,"False",129,687,605,-82,82,1
"E03DB",216,32,"1200x900",600,0,600,400,"True",152,563,568,5,5,1
"E03DB",217,157,"1200x900",600,2,600,400,"True",1016,323,347,24,24,0
"E03DB",218,333,"1200x900",800,1,600,400,"True",521,548,530,-18,18,0
"E03DB",219,127,"1200x900",600,1,600,400,"True",309,691,636,-55,55,0
"E03DB",220,289,"1200x900",800,1,600,400,"True",421,703,754,51,51,1
"E03DB",221,8,"1200x900",600,0,600,400,"True",156,679,679,0,0,0
"E03DB",222,633,"1200x900",1000,2,600,400,"False",564,253,650,397,397,0
"E03DB",223,449,"1200x900",1000,0,600,400,"True",105,683,651,-32,32,1
"E03DB",224,447,"1200x900",1000,0,600,400,"False",71,339,488,149,149,1
"E03DB",225,281,"1200x900",800,0,600,400,"True",112,611,547,-64,64,1
"E03DB",226,178,"1200x900",600,2,600,400,"True",1041,510,532,22,22,0
"E03DB",227,444,"1200x900",1000,0,600,400,"False",101,714,549,-165,165,1
"E03DB",228,33,"1200x900",600,0,600,400,"True",198,533,552,19,19,1
"E03DB",229,379,"1200x900",800,2,600,400,"False",994,325,514,189,189,0
"E03DB",230,164,"1200x900",600,2,600,400,"True",1051,268,362,94,94,0
"E03DB",231,185,"1200x900",600,2,600,400,"False",907,212,361,149,149,0
"E03DB",232,150,"1200x900",600,2,600,400,"True",897,345,320,-25,25,0
"E03DB",233,496,"1200x900",1000,0,600,400,"False",70,639,473,-166,166,1
"E03DB",234,625,"1200x900",1000,2,600,400,"False",279,228,441,213,213,0
"E03DB",235,529,"1200x900",1000,1,600,400,"False",267,412,348,-64,64,1
"E03DB",236,73,"1200x900",600,1,600,400,"False",94,665,481,-184,184,0
"E03DB",237,54,"1200x900",600,0,600,400,"False",474,564,485,-79,79,1
"E03DB",238,206,"1200x900",600,2,600,400,"False",975,223,357,134,134,0
"E03DB",239,599,"1200x900",1000,2,600,400,"True",316,570,523,-47,47,0
"E03DB",240,236,"1200x900",800,0,600,400,"True",162,350,381,31,31,1
"E03DB",241,293,"1200x900",800,1,600,400,"True",561,396,380,-16,16,0
"E03DB",242,341,"1200x900",800,1,600,400,"False",735,632,493,-139,139,1
"E03DB",243,223,"1200x900",800,0,600,400,"True",179,191,181,-10,10,1
"E03DB",244,439,"1200x900",1000,0,600,400,"True",110,229,209,-20,20,1
"E03DB",245,335,"1200x900",800,1,600,400,"True",124,360,344,-16,16,0
"E03DB",246,55,"1200x900",600,0,600,400,"True",211,305,322,17,17,1
"E03DB",247,546,"1200x900",1000,1,600,400,"True",305,374,385,11,11,0
"E03DB",248,359,"1200x900",800,1,600,400,"False",653,241,323,82,82,0
"E03DB",249,82,"1200x900",600,1,600,400,"True",108,213,249,36,36,0
"E03DB",250,596,"1200x900",1000,2,600,400,"True",706,513,553,40,40,0
"E03DB",251,95,"1200x900",600,1,600,400,"True",749,425,443,18,18,1
"E03DB",252,422,"1200x900",800,2,600,400,"False",712,558,395,-163,163,0
"E03DB",253,340,"1200x900",800,1,600,400,"False",226,240,589,349,349,0
"E03DB",254,460,"1200x900",1000,0,600,400,"False",155,189,285,96,96,1
"E03DB",255,418,"1200x900",800,2,600,400,"False",754,507,381,-126,126,0
"E03DB",256,50,"1200x900",600,0,600,400,"True",75,582,545,-37,37,0
"E03DB",259,218,"1200x900",800,0,600,400,"True",106,397,440,43,43,1
"E03DB",260,234,"1200x900",800,0,600,400,"True",72,344,378,34,34,1
"E03DB",261,25,"1200x900",600,0,600,400,"True",263,403,358,-45,45,1
"E03DB",262,539,"1200x900",1000,1,600,400,"True",510,383,441,58,58,0
"E03DB",263,252,"1200x900",800,0,600,400,"False",224,673,554,-119,119,1
"E03DB",264,41,"1200x900",600,0,600,400,"True",370,452,481,29,29,1
"E03DB",265,489,"1200x900",1000,0,600,400,"True",88,604,556,-48,48,1
"E03DB",266,405,"1200x900",800,2,600,400,"False",790,307,415,108,108,0
"E03DB",267,30,"1200x900",600,0,600,400,"True",107,353,347,-6,6,0
"E03DB",268,424,"1200x900",800,2,600,400,"True",903,545,514,-31,31,0
"E03DB",269,282,"1200x900",800,0,600,400,"False",109,246,324,78,78,1
"E03DB",270,416,"1200x900",800,2,600,400,"False",748,617,460,-157,157,0
"E03DB",271,648,"1200x900",1000,2,600,400,"False",557,394,502,108,108,0
"E03DB",272,231,"1200x900",800,0,600,400,"False",251,718,586,-132,132,1
"E03DB",273,470,"1200x900",1000,0,600,400,"True",91,666,653,-13,13,1
"E03DB",274,554,"1200x900",1000,1,600,400,"True",79,309,270,-39,39,1
"E03DB",275,628,"1200x900",1000,2,600,400,"True",768,410,373,-37,37,0
"E03DB",276,14,"1200x900",600,0,600,400,"True",399,224,247,23,23,1
"E03DB",277,122,"1200x900",600,1,600,400,"False",817,709,615,-94,94,0
"E03DB",278,56,"1200x900",600,0,600,400,"True",148,491,534,43,43,0
"E03DB",279,188,"1200x900",600,2,600,400,"False",900,195,396,201,201,0
"E03DB",280,201,"1200x900",600,2,600,400,"False",1005,462,395,-67,67,0
"E03DB",281,134,"1200x900",600,1,600,400,"False",300,188,392,204,204,0
"E03DB",282,292,"1200x900",800,1,600,400,"False",88,565,327,-238,238,0
"E03DB",283,528,"1200x900",1000,1,600,400,"False",839,227,570,343,343,1
"E03DB",284,204,"1200x900",600,2,600,400,"True",1053,432,472,40,40,0
"E03DB",285,588,"1200x900",1000,2,600,400,"True",585,350,357,7,7,0
"E03DB",286,93,"1200x900",600,1,600,400,"False",139,540,278,-262,262,0
"E03DB",287,609,"1200x900",1000,2,600,400,"False",697,627,385,-242,242,0
"E03DB",288,360,"1200x900",800,1,600,400,"True",203,608,520,-88,88,0
"E03DB",289,70,"1200x900",600,0,600,400,"True",309,703,717,14,14,1
"E03DB",290,533,"1200x900",1000,1,600,400,"True",355,483,506,23,23,0
"E03DB",291,181,"1200x900",600,2,600,400,"False",1018,223,410,187,187,0
"E03DB",292,642,"1200x900",1000,2,600,400,"True",776,316,347,31,31,0
"E03DB",293,438,"1200x900",1000,0,600,400,"False",77,713,562,-151,151,1
"E03DB",294,91,"1200x900",600,1,600,400,"True",417,630,554,-76,76,1
"E03DB",295,589,"1200x900",1000,2,600,400,"False",856,418,629,211,211,0
"E03DB",296,378,"1200x900",800,2,600,400,"False",1018,708,483,-225,225,0
"E03DB",297,111,"1200x900",600,1,600,400,"True",922,552,579,27,27,1
"E03DB",298,645,"1200x900",1000,2,600,400,"False",619,396,510,114,114,0
"E03DB",300,638,"1200x900",1000,2,600,400,"False",385,198,358,160,160,0
"E03DB",301,304,"1200x900",800,1,600,400,"False",667,605,216,-389,389,0
"E03DB",302,315,"1200x900",800,1,600,400,"True",105,211,215,4,4,0
"E03DB",304,24,"1200x900",600,0,600,400,"False",430,538,462,-76,76,1
"E03DB",306,268,"1200x900",800,0,600,400,"True",148,400,445,45,45,1
"E03DB",307,547,"1200x900",1000,1,600,400,"True",369,384,439,55,55,1
"E03DB",308,535,"1200x900",1000,1,600,400,"True",372,410,378,-32,32,0
"E03DB",309,587,"1200x900",1000,2,600,400,"False",741,686,358,-328,328,0
"E03DB",310,291,"1200x900",800,1,600,400,"False",522,694,615,-79,79,0
"E03DB",311,318,"1200x900",800,1,600,400,"False",788,534,609,75,75,0
"E03DB",312,108,"1200x900",600,1,600,400,"False",830,239,340,101,101,0
"E03DB",313,215,"1200x900",600,2,600,400,"True",939,596,589,-7,7,0
"E03DB",314,490,"1200x900",1000,0,600,400,"False",114,183,384,201,201,1
"E03DB",315,553,"1200x900",1000,1,600,400,"False",116,712,563,-149,149,0
"E03DB",316,476,"1200x900",1000,0,600,400,"True",76,359,341,-18,18,1
"E03DB",317,409,"1200x900",800,2,600,400,"True",501,659,617,-42,42,0
"E03DB",318,387,"1200x900",800,2,600,400,"True",990,444,420,-24,24,0
"E03DB",319,280,"1200x900",800,0,600,400,"False",104,302,390,88,88,1
"E03DB",321,561,"1200x900",1000,1,600,400,"False",231,406,565,159,159,0
"E03DB",322,582,"1200x900",1000,2,600,400,"False",554,347,544,197,197,0
"E03DB",323,352,"1200x900",800,1,600,400,"True",235,717,652,-65,65,0
"E03DB",324,406,"1200x900",800,2,600,400,"False",971,233,495,262,262,0
"E03DB",325,194,"1200x900",600,2,600,400,"False",896,236,421,185,185,0
"E03DB",326,114,"1200x900",600,1,600,400,"False",183,697,538,-159,159,0
"E03DB",327,566,"1200x900",1000,1,600,400,"False",378,472,387,-85,85,1
"E03DB",328,513,"1200x900",1000,1,600,400,"False",235,602,499,-103,103,0
"E03DB",329,614,"1200x900",1000,2,600,400,"False",823,563,461,-102,102,0
"E03DB",330,453,"1200x900",1000,0,600,400,"False",71,393,459,66,66,1
"E03DB",331,35,"1200x900",600,0,600,400,"True",366,555,529,-26,26,1
"E03DB",332,193,"1200x900",600,2,600,400,"True",874,588,579,-9,9,0
"E03DB",333,506,"1200x900",1000,1,600,400,"False",559,567,459,-108,108,1
"E03DB",334,443,"1200x900",1000,0,600,400,"False",99,651,577,-74,74,1
"E03DB",335,337,"1200x900",800,1,600,400,"False",299,622,715,93,93,0
"E03DB",336,227,"1200x900",800,0,600,400,"True",196,551,565,14,14,1
"E03DB",337,463,"1200x900",1000,0,600,400,"True",115,693,635,-58,58,1
"E03DB",338,46,"1200x900",600,0,600,400,"True",193,355,354,-1,1,1
"E03DB",339,342,"1200x900",800,1,600,400,"True",677,204,215,11,11,0
"E03DB",340,295,"1200x900",800,1,600,400,"False",471,334,455,121,121,0
"E03DB",341,474,"1200x900",1000,0,600,400,"True",85,339,279,-60,60,1
"E03DB",342,483,"1200x900",1000,0,600,400,"False",93,191,291,100,100,1
"E03DB",343,74,"1200x900",600,1,600,400,"True",115,358,394,36,36,0
"E03DB",344,196,"1200x900",600,2,600,400,"True",1030,397,395,-2,2,0
"E03DB",345,519,"1200x900",1000,1,600,400,"False",319,565,667,102,102,1
"E03DB",346,3,"1200x900",600,0,600,400,"False",298,443,342,-101,101,1
"E03DB",347,542,"1200x900",1000,1,600,400,"False",304,401,246,-155,155,0
"E03DB",348,372,"1200x900",800,2,600,400,"False",833,620,404,-216,216,0
"E03DB",349,237,"1200x900",800,0,600,400,"True",204,481,485,4,4,1
"E03DB",350,382,"1200x900",800,2,600,400,"False",870,523,661,138,138,0
"E03DB",351,233,"1200x900",800,0,600,400,"True",164,700,650,-50,50,1
"E03DB",352,156,"1200x900",600,2,600,400,"False",913,197,470,273,273,0
"E03DB",353,198,"1200x900",600,2,600,400,"True",976,500,461,-39,39,0
"E03DB",354,512,"1200x900",1000,1,600,400,"False",139,261,374,113,113,0
"E03DB",355,184,"1200x900",600,2,600,400,"True",1067,441,383,-58,58,0
"E03DB",356,232,"1200x900",800,0,600,400,"True",84,511,477,-34,34,1
"E03DB",357,136,"1200x900",600,1,600,400,"False",264,205,324,119,119,0
"E03DB",358,170,"1200x900",600,2,600,400,"False",996,468,276,-192,192,0
"E03DB",359,350,"1200x900",800,1,600,400,"True",182,566,529,-37,37,0
"E03DB",360,369,"1200x900",800,2,600,400,"False",903,594,367,-227,227,0
"E03DB",361,324,"1200x900",800,1,600,400,"False",719,712,543,-169,169,1
"E03DB",362,10,"1200x900",600,0,600,400,"True",400,499,518,19,19,1
"E03DB",363,75,"1200x900",600,1,600,400,"True",635,558,542,-16,16,0
"E03DB",364,454,"1200x900",1000,0,600,400,"False",78,687,604,-83,83,1
"E03DB",365,630,"1200x900",1000,2,600,400,"False",754,559,433,-126,126,0
"E03DB",366,385,"1200x900",800,2,600,400,"False",740,456,603,147,147,0
"E03DB",367,48,"1200x900",600,0,600,400,"True",323,645,653,8,8,1
"E03DB",368,100,"1200x900",600,1,600,400,"False",453,511,704,193,193,0
"E03DB",369,312,"1200x900",800,1,600,400,"True",238,683,629,-54,54,0
"E03DB",371,384,"1200x900",800,2,600,400,"False",821,707,578,-129,129,0
"E03DB",372,211,"1200x900",600,2,600,400,"False",986,407,513,106,106,0
"E03DB",373,320,"1200x900",800,1,600,400,"True",644,376,421,45,45,0
"E03DB",374,155,"1200x900",600,2,600,400,"False",940,269,378,109,109,0
"E03DB",375,626,"1200x900",1000,2,600,400,"True",329,449,506,57,57,0
"E03DB",376,516,"1200x900",1000,1,600,400,"True",440,559,568,9,9,0
"E03DB",377,57,"1200x900",600,0,600,400,"True",354,508,500,-8,8,1
"E03DB",378,370,"1200x900",800,2,600,400,"True",874,336,339,3,3,0
"E03DB",379,31,"1200x900",600,0,600,400,"True",365,338,346,8,8,1
"E03DB",380,303,"1200x900",800,1,600,400,"False",241,431,535,104,104,0
"E03DB",381,381,"1200x900",800,2,600,400,"False",705,408,536,128,128,0
"E03DB",382,415,"1200x900",800,2,600,400,"False",823,684,439,-245,245,0
"E03DB",383,214,"1200x900",600,2,600,400,"True",1046,305,326,21,21,0
"E03DB",384,605,"1200x900",1000,2,600,400,"True",493,665,591,-74,74,0
"E03DB",385,51,"1200x900",600,0,600,400,"True",272,181,131,-50,50,1
"E03DB",386,509,"1200x900",1000,1,600,400,"True",509,434,455,21,21,0
"E03DB",387,217,"1200x900",800,0,600,400,"True",85,573,540,-33,33,1
"E03DB",388,192,"1200x900",600,2,600,400,"False",1064,320,539,219,219,0
"E03DB",389,169,"1200x900",600,2,600,400,"True",924,290,273,-17,17,0
"E03DB",390,212,"1200x900",600,2,600,400,"False",841,206,317,111,111,0
"E03DB",391,635,"1200x900",1000,2,600,400,"False",833,402,210,-192,192,0
"E03DB",392,12,"1200x900",600,0,600,400,"False",365,336,255,-81,81,1
"E03DB",393,639,"1200x900",1000,2,600,400,"False",504,456,343,-113,113,0
"E03DB",394,301,"1200x900",800,1,600,400,"False",162,574,710,136,136,0
"E03DB",395,351,"1200x900",800,1,600,400,"True",122,581,604,23,23,0
"E03DB",396,328,"1200x900",800,1,600,400,"True",104,649,616,-33,33,0
"E03DB",397,87,"1200x900",600,1,600,400,"True",231,604,617,13,13,0
"E03DB",398,19,"1200x900",600,0,600,400,"True",286,686,650,-36,36,0
"E03DB",400,603,"1200x900",1000,2,600,400,"False",693,280,490,210,210,0
"E03DB",401,300,"1200x900",800,1,600,400,"True",620,693,688,-5,5,0
"E03DB",402,343,"1200x900",800,1,600,400,"False",407,557,419,-138,138,0
"E03DB",403,375,"1200x900",800,2,600,400,"True",716,384,372,-12,12,0
"E03DB",404,471,"1200x900",1000,0,600,400,"False",122,200,312,112,112,1
"E03DB",405,615,"1200x900",1000,2,600,400,"True",736,634,570,-64,64,0
"E03DB",406,643,"1200x900",1000,2,600,400,"True",740,325,362,37,37,0
"E03DB",407,226,"1200x900",800,0,600,400,"True",187,229,229,0,0,1
"E03DB",408,251,"1200x900",800,0,600,400,"False",88,352,231,-121,121,1
"E03DB",409,180,"1200x900",600,2,600,400,"True",929,270,236,-34,34,0
"E03DB",410,611,"1200x900",1000,2,600,400,"True",414,511,518,7,7,0
"E03DB",411,246,"1200x900",800,0,600,400,"True",196,418,401,-17,17,1
"E03DB",412,26,"1200x900",600,0,600,400,"True",70,712,652,-60,60,0
"E03DB",413,441,"1200x900",1000,0,600,400,"True",85,684,653,-31,31,1
"E03DB",415,481,"1200x900",1000,0,600,400,"False",80,185,315,130,130,1
"E03DB",416,23,"1200x900",600,0,600,400,"True",308,463,455,-8,8,1
"E03DB",417,371,"1200x900",800,2,600,400,"True",730,560,492,-68,68,0
"E03DB",418,394,"1200x900",800,2,600,400,"False",847,292,554,262,262,0
"E03DB",419,13,"1200x900",600,0,600,400,"True",296,211,245,34,34,1
"E03DB",420,368,"1200x900",800,2,600,400,"False",778,515,413,-102,102,0
"E03DB",421,162,"1200x900",600,2,600,400,"False",849,279,473,194,194,0
"E03DB",422,276,"1200x900",800,0,600,400,"True",281,217,244,27,27,1
"E03DB",423,16,"1200x900",600,0,600,400,"False",297,514,243,-271,271,1
"E03DB",424,325,"1200x900",800,1,600,400,"True",105,394,418,24,24,0
"E03DB",425,396,"1200x900",800,2,600,400,"False",678,663,421,-242,242,0
"E03DB",426,76,"1200x900",600,1,600,400,"False",647,614,677,63,63,0
"E03DB",427,334,"1200x900",800,1,600,400,"True",481,665,627,-38,38,0
"E03DB",428,158,"1200x900",600,2,600,400,"False",939,300,539,239,239,0
"E03DB",429,569,"1200x900",1000,1,600,400,"False",494,720,648,-72,72,0
"E03DB",430,311,"1200x900",800,1,600,400,"False",710,261,586,325,325,0
"E03DB",431,62,"1200x900",600,0,600,400,"True",345,346,350,4,4,1
"E03DB",432,40,"1200x900",600,0,600,400,"True",143,513,515,2,2,0
"E03DB",433,147,"1200x900",600,2,600,400,"True",942,418,443,25,25,0
"E03DB",434,125,"1200x900",600,1,600,400,"True",750,531,563,32,32,0
"E03DB",435,560,"1200x900",1000,1,600,400,"True",516,693,696,3,3,0
"E03DB",436,140,"1200x900",600,1,600,400,"True",700,523,587,64,64,0
"E03DB",437,11,"1200x900",600,0,600,400,"True",372,670,667,-3,3,1
"E03DB",438,402,"1200x900",800,2,600,400,"True",878,234,280,46,46,0
"E03DB",439,367,"1200x900",800,2,600,400,"False",613,464,532,68,68,0
"E03DB",440,395,"1200x900",800,2,600,400,"True",743,334,372,38,38,0
"E03DB",441,525,"1200x900",1000,1,600,400,"False",123,690,546,-144,144,0
"E03DB",442,302,"1200x900",800,1,600,400,"False",479,467,630,163,163,1
"E03DB",443,84,"1200x900",600,1,600,400,"False",144,184,310,126,126,0
"E03DB",444,63,"1200x900",600,0,600,400,"True",311,188,194,6,6,1
"E03DB",445,203,"1200x900",600,2,600,400,"False",938,603,509,-94,94,0
"E03DB",446,550,"1200x900",1000,1,600,400,"False",301,459,640,181,181,0
"E03DB",447,277,"1200x900",800,0,600,400,"True",140,310,342,32,32,1
"E03DB",448,21,"1200x900",600,0,600,400,"True",314,383,402,19,19,1
"E03DB",449,195,"1200x900",600,2,600,400,"True",942,249,314,65,65,0
"E03DB",450,332,"1200x900",800,1,600,400,"False",260,699,589,-110,110,0
"E03DB",451,401,"1200x900",800,2,600,400,"True",821,260,348,88,88,0
"E03DB",453,219,"1200x900",800,0,600,400,"True",202,502,550,48,48,1
"E03DB",454,243,"1200x900",800,0,600,400,"True",114,332,386,54,54,1
"E03DB",455,64,"1200x900",600,0,600,400,"True",102,339,321,-18,18,0
"E03DB",456,9,"1200x900",600,0,600,400,"False",509,654,551,-103,103,1
"E03DB",457,290,"1200x900",800,1,600,400,"False",789,603,711,108,108,0
"E03DB",458,279,"1200x900",800,0,600,400,"False",252,202,332,130,130,1
"E03DB",459,497,"1200x900",1000,0,600,400,"False",106,696,547,-149,149,1
"E03DB",460,624,"1200x900",1000,2,600,400,"True",693,501,540,39,39,0
"E03DB",461,501,"1200x900",1000,0,600,400,"True",96,323,364,41,41,1
"E03DB",462,548,"1200x900",1000,1,600,400,"True",103,278,275,-3,3,0
"E03DB",463,225,"1200x900",800,0,600,400,"True",178,423,375,-48,48,1
"E03DB",464,563,"1200x900",1000,1,600,400,"True",201,696,714,18,18,0
"E03DB",465,515,"1200x900",1000,1,600,400,"False",307,217,345,128,128,0
"E03DB",466,101,"1200x900",600,1,600,400,"True",541,656,676,20,20,0
"E03DB",467,271,"1200x900",800,0,600,400,"True",74,360,405,45,45,1
"E03DB",468,583,"1200x900",1000,2,600,400,"False",949,284,464,180,180,1
"E03DB",469,165,"1200x900",600,2,600,400,"False",912,554,393,-161,161,0
"E03DB",470,469,"1200x900",1000,0,600,400,"False",73,227,338,111,111,1
"E03DB",471,631,"1200x900",1000,2,600,400,"False",699,479,682,203,203,0
"E03DB",472,558,"1200x900",1000,1,600,400,"False",72,464,567,103,103,1
"E03DB",473,338,"1200x900",800,1,600,400,"False",813,253,397,144,144,1
"E03DB",474,319,"1200x900",800,1,600,400,"True",494,587,616,29,29,1
"E03DB",475,349,"1200x900",800,1,600,400,"True",402,665,685,20,20,0
"E03DB",476,305,"1200x900",800,1,600,400,"True",471,716,723,7,7,0
"E03DB",477,383,"1200x900",800,2,600,400,"False",855,407,507,100,100,0
"E03DB",478,534,"1200x900",1000,1,600,400,"False",328,504,684,180,180,1
"E03DB",479,105,"1200x900",600,1,600,400,"False",527,440,683,243,243,0
"E03DB",480,273,"1200x900",800,0,600,400,"False",180,309,408,99,99,1
"E03DB",481,321,"1200x900",800,1,600,400,"False",601,190,346,156,156,0
"E03DB",482,537,"1200x900",1000,1,600,400,"False",621,412,670,258,258,1
"E03DB",483,326,"1200x900",800,1,600,400,"False",103,482,692,210,210,0
"E03DB",484,505,"1200x900",1000,1,600,400,"True",191,484,473,-11,11,1
"E03DB",485,397,"1200x900",800,2,600,400,"False",817,692,607,-85,85,0
"E03DB",486,437,"1200x900",1000,0,600,400,"True",74,667,656,-11,11,1
"E03DB",487,119,"1200x900",600,1,600,400,"True",168,563,502,-61,61,0
"E03DB",488,129,"1200x900",600,1,600,400,"True",859,482,430,-52,52,1
"E03DB",490,59,"1200x900",600,0,600,400,"True",391,692,660,-32,32,1
"E03DB",491,202,"1200x900",600,2,600,400,"True",966,460,516,56,56,0
"E03DB",492,272,"1200x900",800,0,600,400,"True",200,181,202,21,21,1
"E03DB",493,179,"1200x900",600,2,600,400,"False",908,602,423,-179,179,0
"E03DB",494,508,"1200x900",1000,1,600,400,"True",596,485,489,4,4,0
"E03DB",497,491,"1200x900",1000,0,600,400,"False",108,198,364,166,166,1
"E03DB",498,242,"1200x900",800,0,600,400,"True",117,448,488,40,40,1
"E03DB",499,104,"1200x900",600,1,600,400,"True",448,584,587,3,3,0
"E03DB",500,591,"1200x900",1000,2,600,400,"False",698,336,465,129,129,0
"E03DB",501,608,"1200x900",1000,2,600,400,"False",742,250,386,136,136,0
"E03DB",502,467,"1200x900",1000,0,600,400,"False",74,712,565,-147,147,1
"E03DB",503,207,"1200x900",600,2,600,400,"False",838,235,399,164,164,0
"E03DB",504,309,"1200x900",800,1,600,400,"False",186,225,546,321,321,0
"E03DB",505,130,"1200x900",600,1,600,400,"False",741,428,528,100,100,0
"E03DB",506,644,"1200x900",1000,2,600,400,"True",495,486,479,-7,7,0
"E03DB",507,263,"1200x900",800,0,600,400,"True",82,396,407,11,11,1
"E03DB",508,576,"1200x900",1000,1,600,400,"True",376,713,732,19,19,0
"E03DB",509,520,"1200x900",1000,1,600,400,"False",564,260,512,252,252,0
"E03DB",510,567,"1200x900",1000,1,600,400,"True",655,297,396,99,99,1
"E03DB",511,72,"1200x900",600,0,600,400,"True",158,537,515,-22,22,0
"E03DB",512,248,"1200x900",800,0,600,400,"True",94,240,234,-6,6,1
"E03DB",513,68,"1200x900",600,0,600,400,"True",165,367,388,21,21,0
"E03DB",514,274,"1200x900",800,0,600,400,"False",146,497,398,-99,99,1
"E03DB",515,266,"1200x900",800,0,600,400,"True",126,303,303,0,0,1
"E03DB",516,373,"1200x900",800,2,600,400,"False",694,326,428,102,102,0
"E03DB",517,176,"1200x900",600,2,600,400,"True",1033,281,304,23,23,0
"E03DB",518,92,"1200x900",600,1,600,400,"False",624,605,400,-205,205,0
"E03DB",519,510,"1200x900",1000,1,600,400,"True",486,338,313,-25,25,1
"E03DB",520,404,"1200x900",800,2,600,400,"True",842,396,374,-22,22,0
"E03DB",521,347,"1200x900",800,1,600,400,"False",757,295,456,161,161,1
"E03DB",522,39,"1200x900",600,0,600,400,"True",210,609,545,-64,64,0
"E03DB",523,27,"1200x900",600,0,600,400,"False",373,309,425,116,116,1
"E03DB",524,257,"1200x900",800,0,600,400,"False",97,219,304,85,85,1
"E03DB",525,607,"1200x900",1000,2,600,400,"False",900,573,656,83,83,1
"E03DB",526,42,"1200x900",600,0,600,400,"True",233,479,438,-41,41,0
"E03DB",527,552,"1200x900",1000,1,600,400,"False",255,412,524,112,112,0
"E03DB",528,80,"1200x900",600,1,600,400,"True",616,423,461,38,38,1
"E03DB",529,465,"1200x900",1000,0,600,400,"False",85,203,288,85,85,1
"E03DB",530,239,"1200x900",800,0,600,400,"True",114,231,243,12,12,1
"E03DB",531,254,"1200x900",800,0,600,400,"False",136,583,492,-91,91,1
"E03DB",532,543,"1200x900",1000,1,600,400,"False",88,202,633,431,431,0
"E03DB",533,374,"1200x900",800,2,600,400,"True",755,450,437,-13,13,0
"E03DB",534,518,"1200x900",1000,1,600,400,"True",583,717,657,-60,60,0
"E03DB",535,110,"1200x900",600,1,600,400,"False",776,550,751,201,201,1
"E03DB",536,197,"1200x900",600,2,600,400,"False",903,212,449,237,237,0
"E03DB",537,613,"1200x900",1000,2,600,400,"True",690,374,355,-19,19,0
"E03DB",538,601,"1200x900",1000,2,600,400,"False",735,697,354,-343,343,0
"E03DB",539,386,"1200x900",800,2,600,400,"True",774,301,313,12,12,0
"E03DB",540,142,"1200x900",600,1,600,400,"False",286,474,196,-278,278,0
"E03DB",541,540,"1200x900",1000,1,600,400,"False",389,568,263,-305,305,1
"E03DB",542,479,"1200x900",1000,0,600,400,"False",74,705,523,-182,182,1
"E03DB",543,327,"1200x900",800,1,600,400,"True",152,339,305,-34,34,0
"E03DB",544,434,"1200x900",1000,0,600,400,"False",89,657,526,-131,131,1
"E03DB",545,559,"1200x900",1000,1,600,400,"False",641,244,390,146,146,0
"E03DB",546,52,"1200x900",600,0,600,400,"True",171,188,198,10,10,0
"E03DB",547,413,"1200x900",800,2,600,400,"False",849,506,326,-180,180,0
"E03DB",548,286,"1200x900",800,0,600,400,"True",105,378,380,2,2,1
"E03DB",549,621,"1200x900",1000,2,600,400,"False",540,478,416,-62,62,0
"E03DB",551,399,"1200x900",800,2,600,400,"False",603,602,322,-280,280,0
"E03DB",552,541,"1200x900",1000,1,600,400,"True",339,478,496,18,18,0
"E03DB",553,139,"1200x900",600,1,600,400,"False",192,695,462,-233,233,0
"E03DB",554,240,"1200x900",800,0,600,400,"False",330,656,554,-102,102,1
"E03DB",555,258,"1200x900",800,0,600,400,"False",126,664,597,-67,67,1
"E03DB",556,153,"1200x900",600,2,600,400,"True",1037,601,627,26,26,0
"E03DB",557,419,"1200x900",800,2,600,400,"True",769,351,402,51,51,0
"E03DB",559,521,"1200x900",1000,1,600,400,"True",111,303,378,75,75,1
"E03DB",560,429,"1200x900",800,2,600,400,"False",682,692,344,-348,348,0
"E03DB",561,623,"1200x900",1000,2,600,400,"False",636,527,361,-166,166,0
"E03DB",562,448,"1200x900",1000,0,600,400,"False",107,641,522,-119,119,1
"E03DB",563,230,"1200x900",800,0,600,400,"True",99,678,656,-22,22,1
"E03DB",564,495,"1200x900",1000,0,600,400,"True",93,692,657,-35,35,1
"E03DB",565,99,"1200x900",600,1,600,400,"False",811,407,576,169,169,0
"E03DB",566,128,"1200x900",600,1,600,400,"True",661,258,293,35,35,1
"E03DB",567,205,"1200x900",600,2,600,400,"False",1021,504,306,-198,198,0
"E03DB",568,584,"1200x900",1000,2,600,400,"True",731,413,406,-7,7,0
"E03DB",569,339,"1200x900",800,1,600,400,"True",273,545,513,-32,32,1
"E03DB",570,598,"1200x900",1000,2,600,400,"False",706,559,380,-179,179,0
"E03DB",571,390,"1200x900",800,2,600,400,"True",982,674,634,-40,40,1
"E03DB",572,362,"1200x900",800,2,600,400,"True",819,338,382,44,44,0
"E03DB",573,451,"1200x900",1000,0,600,400,"False",110,702,590,-112,112,1
"E03DB",574,267,"1200x900",800,0,600,400,"True",145,665,699,34,34,1
"E03DB",575,313,"1200x900",800,1,600,400,"True",588,421,479,58,58,0
"E03DB",576,574,"1200x900",1000,1,600,400,"False",614,194,315,121,121,0
"E03DB",577,403,"1200x900",800,2,600,400,"False",625,704,333,-371,371,0
"E03DB",578,106,"1200x900",600,1,600,400,"True",803,659,678,19,19,1
"E03DB",579,572,"1200x900",1000,1,600,400,"False",302,260,366,106,106,0
"E03DB",580,97,"1200x900",600,1,600,400,"True",760,643,568,-75,75,1
"E03DB",581,44,"1200x900",600,0,600,400,"True",305,554,560,6,6,1
"E03DB",582,20,"1200x900",600,0,600,400,"True",204,545,525,-20,20,1
"E03DB",583,380,"1200x900",800,2,600,400,"False",942,228,384,156,156,0
"E03DB",584,504,"1200x900",1000,0,600,400,"True",107,699,697,-2,2,1
"E03DB",585,65,"1200x900",600,0,600,400,"True",442,645,663,18,18,1
"E03DB",586,597,"1200x900",1000,2,600,400,"False",352,239,418,179,179,0
"E03DB",587,283,"1200x900",800,0,600,400,"True",90,264,249,-15,15,1
"E03DB",588,524,"1200x900",1000,1,600,400,"False",534,470,526,56,56,0
"E03DB",589,183,"1200x900",600,2,600,400,"False",927,289,432,143,143,0
"E03DB",590,189,"1200x900",600,2,600,400,"True",881,397,424,27,27,0
"E03DB",591,256,"1200x900",800,0,600,400,"False",192,656,423,-233,233,1
"E03DB",592,595,"1200x900",1000,2,600,400,"False",687,640,304,-336,336,0
"E03DB",593,172,"1200x900",600,2,600,400,"True",912,444,395,-49,49,0
"E03DB",594,494,"1200x900",1000,0,600,400,"True",127,692,713,21,21,1
"E03DB",595,261,"1200x900",800,0,600,400,"True",86,713,714,1,1,1
"E03DB",596,366,"1200x900",800,2,600,400,"False",931,464,384,-80,80,0
"E03DB",597,294,"1200x900",800,1,600,400,"True",262,287,258,-29,29,0
"E03DB",598,90,"1200x900",600,1,600,400,"False",560,474,304,-170,170,0
"E03DB",599,445,"1200x900",1000,0,600,400,"False",78,302,152,-150,150,1
"E03DB",600,78,"1200x900",600,1,600,400,"False",885,684,513,-171,171,0
"E03DB",601,306,"1200x900",800,1,600,400,"True",164,524,508,-16,16,0
"E03DB",602,356,"1200x900",800,1,600,400,"True",123,484,442,-42,42,0
"E03DB",603,468,"1200x900",1000,0,600,400,"False",121,219,298,79,79,1
"E03DB",604,297,"1200x900",800,1,600,400,"False",625,244,361,117,117,0
"E03DB",605,124,"1200x900",600,1,600,400,"False",345,467,256,-211,211,0
"E03DB",606,538,"1200x900",1000,1,600,400,"False",308,457,269,-188,188,1
"E03DB",607,498,"1200x900",1000,0,600,400,"True",100,260,280,20,20,1
"E03DB",608,151,"1200x900",600,2,600,400,"False",828,680,520,-160,160,0
"E03DB",609,94,"1200x900",600,1,600,400,"True",729,482,533,51,51,0
"E03DB",610,511,"1200x900",1000,1,600,400,"False",408,390,532,142,142,1
"E03DB",611,348,"1200x900",800,1,600,400,"False",764,294,395,101,101,0
"E03DB",612,316,"1200x900",800,1,600,400,"True",362,319,296,-23,23,0
"E03DB",613,357,"1200x900",800,1,600,400,"False",109,594,293,-301,301,0
"E03DB",614,113,"1200x900",600,1,600,400,"True",897,657,619,-38,38,0
"E03DB",615,222,"1200x900",800,0,600,400,"True",152,206,265,59,59,1
"E03DB",616,228,"1200x900",800,0,600,400,"True",174,687,753,66,66,1
"E03DB",617,417,"1200x900",800,2,600,400,"False",750,280,501,221,221,0
"E03DB",618,377,"1200x900",800,2,600,400,"True",683,388,449,61,61,0
"E03DB",619,163,"1200x900",600,2,600,400,"True",1046,665,712,47,47,0
"E03DB",620,284,"1200x900",800,0,600,400,"True",135,293,305,12,12,1
"E03DB",621,590,"1200x900",1000,2,600,400,"True",636,278,299,21,21,0
"E03DB",622,531,"1200x900",1000,1,600,400,"False",233,362,448,86,86,0
"E03DB",623,551,"1200x900",1000,1,600,400,"True",146,445,428,-17,17,1
"E03DB",624,83,"1200x900",600,1,600,400,"False",763,568,477,-91,91,1
"E03DB",625,421,"1200x900",800,2,600,400,"True",898,394,347,-47,47,0
"E03DB",626,120,"1200x900",600,1,600,400,"False",690,655,567,-88,88,0
"E03DB",627,503,"1200x900",1000,0,600,400,"False",86,279,344,65,65,1
"E03DB",628,53,"1200x900",600,0,600,400,"True",177,189,234,45,45,0
"E03DB",629,616,"1200x900",1000,2,600,400,"True",854,357,346,-11,11,1
"E03DB",630,43,"1200x900",600,0,600,400,"True",277,446,424,-22,22,1
"E03DB",631,154,"1200x900",600,2,600,400,"False",941,454,379,-75,75,0
"E03DB",632,581,"1200x900",1000,2,600,400,"False",310,357,262,-95,95,0
"E03DB",633,244,"1200x900",800,0,600,400,"True",194,203,181,-22,22,1
"E03DB",634,646,"1200x900",1000,2,600,400,"False",829,227,390,163,163,1
"E03DB",635,209,"1200x900",600,2,600,400,"False",937,637,268,-369,369,0
"E03DB",636,354,"1200x900",800,1,600,400,"False",118,236,341,105,105,0
"E03DB",637,478,"1200x900",1000,0,600,400,"False",79,672,481,-191,191,1
"E03DB",638,47,"1200x900",600,0,600,400,"True",303,499,463,-36,36,1
"E03DB",639,578,"1200x900",1000,2,600,400,"True",966,276,259,-17,17,0
"E03DB",640,568,"1200x900",1000,1,600,400,"True",286,475,446,-29,29,1
"E03DB",641,408,"1200x900",800,2,600,400,"False",758,567,360,-207,207,0
"E03DB",642,69,"1200x900",600,0,600,400,"False",322,268,362,94,94,0
"E03DB",643,6,"1200x900",600,0,600,400,"False",217,689,629,-60,60,1
"E03DB",644,580,"1200x900",1000,2,600,400,"False",651,267,444,177,177,0
"E03DB",645,388,"1200x900",800,2,600,400,"True",930,320,304,-16,16,0
"E03DB",646,462,"1200x900",1000,0,600,400,"False",102,672,532,-140,140,1
"E03DB",647,586,"1200x900",1000,2,600,400,"False",802,262,417,155,155,0
"E03DB",648,269,"1200x900",800,0,600,400,"True",160,295,255,-40,40,1
"E04SM",1,120,"1200x900",600,1,600,400,"False",690,655,406,-249,249,0
"E04SM",2,385,"1200x900",800,2,600,400,"False",740,456,571,115,115,0
"E04SM",3,537,"1200x900",1000,1,600,400,"False",621,412,774,362,362,1
"E04SM",4,476,"1200x900",1000,0,600,400,"False",76,359,207,-152,152,1
"E04SM",5,1,"1200x900",600,0,600,400,"False",136,502,425,-77,77,0
"E04SM",6,617,"1200x900",1000,2,600,400,"False",294,180,521,341,341,0
"E04SM",7,558,"1200x900",1000,1,600,400,"False",72,464,705,241,241,1
"E04SM",8,445,"1200x900",1000,0,600,400,"True",78,302,354,52,52,1
"E04SM",9,578,"1200x900",1000,2,600,400,"False",966,276,717,441,441,0
"E04SM",10,50,"1200x900",600,0,600,400,"True",75,582,630,48,48,0
"E04SM",11,505,"1200x900",1000,1,600,400,"True",191,484,451,-33,33,1
"E04SM",12,43,"1200x900",600,0,600,400,"True",277,446,463,17,17,1
"E04SM",13,114,"1200x900",600,1,600,400,"True",183,697,617,-80,80,0
"E04SM",14,69,"1200x900",600,0,600,400,"True",322,268,303,35,35,0
"E04SM",15,466,"1200x900",1000,0,600,400,"True",82,205,176,-29,29,1
"E04SM",16,196,"1200x900",600,2,600,400,"False",1030,397,185,-212,212,0
"E04SM",17,72,"1200x900",600,0,600,400,"True",158,537,519,-18,18,0
"E04SM",18,363,"1200x900",800,2,600,400,"False",800,218,492,274,274,0
"E04SM",19,242,"1200x900",800,0,600,400,"True",117,448,431,-17,17,1
"E04SM",20,621,"1200x900",1000,2,600,400,"True",540,478,458,-20,20,0
"E04SM",21,87,"1200x900",600,1,600,400,"False",231,604,512,-92,92,0
"E04SM",22,83,"1200x900",600,1,600,400,"False",763,568,444,-124,124,1
"E04SM",23,351,"1200x900",800,1,600,400,"False",122,581,675,94,94,0
"E04SM",24,168,"1200x900",600,2,600,400,"False",1001,439,312,-127,127,0
"E04SM",25,5,"1200x900",600,0,600,400,"True",228,587,551,-36,36,0
"E04SM",26,521,"1200x900",1000,1,600,400,"True",111,303,254,-49,49,1
"E04SM",27,285,"1200x900",800,0,600,400,"False",237,396,483,87,87,1
"E04SM",28,155,"1200x900",600,2,600,400,"False",940,269,383,114,114,0
"E04SM",29,503,"1200x900",1000,0,600,400,"False",86,279,436,157,157,1
"E04SM",30,562,"1200x900",1000,1,600,400,"False",347,540,302,-238,238,0
"E04SM",31,446,"1200x900",1000,0,600,400,"False",72,298,388,90,90,1
"E04SM",32,240,"1200x900",800,0,600,400,"False",330,656,434,-222,222,1
"E04SM",33,290,"1200x900",800,1,600,400,"False",789,603,487,-116,116,0
"E04SM",34,150,"1200x900",600,2,600,400,"True",897,345,343,-2,2,0
"E04SM",35,113,"1200x900",600,1,600,400,"False",897,657,459,-198,198,0
"E04SM",36,94,"1200x900",600,1,600,400,"False",729,482,350,-132,132,0
"E04SM",37,323,"1200x900",800,1,600,400,"False",388,348,697,349,349,0
"E04SM",38,541,"1200x900",1000,1,600,400,"True",339,478,480,2,2,0
"E04SM",39,191,"1200x900",600,2,600,400,"False",962,396,284,-112,112,0
"E04SM",40,471,"1200x900",1000,0,600,400,"True",122,200,246,46,46,1
"E04SM",41,105,"1200x900",600,1,600,400,"False",527,440,735,295,295,0
"E04SM",42,220,"1200x900",800,0,600,400,"True",108,699,704,5,5,1
"E04SM",43,58,"1200x900",600,0,600,400,"True",353,655,660,5,5,1
"E04SM",44,464,"1200x900",1000,0,600,400,"False",82,222,144,-78,78,1
"E04SM",45,195,"1200x900",600,2,600,400,"False",942,249,163,-86,86,0
"E04SM",46,423,"1200x900",800,2,600,400,"True",1051,710,654,-56,56,1
"E04SM",47,48,"1200x900",600,0,600,400,"True",323,645,620,-25,25,1
"E04SM",48,297,"1200x900",800,1,600,400,"False",625,244,494,250,250,0
"E04SM",49,479,"1200x900",1000,0,600,400,"True",74,705,762,57,57,1
"E04SM",50,525,"1200x900",1000,1,600,400,"True",123,690,635,-55,55,0
"E04SM",51,163,"1200x900",600,2,600,400,"True",1046,665,716,51,51,0
"E04SM",52,602,"1200x900",1000,2,600,400,"True",865,452,468,16,16,0
"E04SM",53,460,"1200x900",1000,0,600,400,"True",155,189,242,53,53,1
"E04SM",54,301,"1200x900",800,1,600,400,"False",162,574,741,167,167,0
"E04SM",55,164,"1200x900",600,2,600,400,"True",1051,268,270,2,2,0
"E04SM",56,133,"1200x900",600,1,600,400,"False",345,551,748,197,197,0
"E04SM",57,431,"1200x900",800,2,600,400,"True",694,382,438,56,56,0
"E04SM",58,321,"1200x900",800,1,600,400,"False",601,190,382,192,192,0
"E04SM",59,307,"1200x900",800,1,600,400,"False",716,247,384,137,137,0
"E04SM",60,628,"1200x900",1000,2,600,400,"True",768,410,472,62,62,0
"E04SM",61,267,"1200x900",800,0,600,400,"True",145,665,654,-11,11,1
"E04SM",62,504,"1200x900",1000,0,600,400,"True",107,699,663,-36,36,1
"E04SM",63,407,"1200x900",800,2,600,400,"False",989,340,547,207,207,0
"E04SM",64,337,"1200x900",800,1,600,400,"True",299,622,619,-3,3,0
"E04SM",65,458,"1200x900",1000,0,600,400,"False",78,624,552,-72,72,1
"E04SM",66,587,"1200x900",1000,2,600,400,"False",741,686,259,-427,427,0
"E04SM",67,459,"1200x900",1000,0,600,400,"False",70,645,455,-190,190,1
"E04SM",68,634,"1200x900",1000,2,600,400,"True",735,313,349,36,36,0
"E04SM",69,141,"1200x900",600,1,600,400,"True",671,582,576,-6,6,0
"E04SM",70,183,"1200x900",600,2,600,400,"True",927,289,309,20,20,0
"E04SM",71,374,"1200x900",800,2,600,400,"True",755,450,494,44,44,0
"E04SM",72,199,"1200x900",600,2,600,400,"True",992,467,480,13,13,0
"E04SM",73,107,"1200x900",600,1,600,400,"False",878,678,564,-114,114,0
"E04SM",74,76,"1200x900",600,1,600,400,"False",647,614,718,104,104,0
"E04SM",75,99,"1200x900",600,1,600,400,"True",811,407,472,65,65,0
"E04SM",76,9,"1200x900",600,0,600,400,"False",509,654,556,-98,98,1
"E04SM",77,444,"1200x900",1000,0,600,400,"False",101,714,593,-121,121,1
"E04SM",78,404,"1200x900",800,2,600,400,"False",842,396,542,146,146,0
"E04SM",79,125,"1200x900",600,1,600,400,"True",750,531,489,-42,42,0
"E04SM",80,402,"1200x900",800,2,600,400,"True",878,234,300,66,66,0
"E04SM",81,238,"1200x900",800,0,600,400,"True",162,283,299,16,16,1
"E04SM",82,39,"1200x900",600,0,600,400,"False",210,609,429,-180,180,0
"E04SM",83,4,"1200x900",600,0,600,400,"True",602,200,257,57,57,1
"E04SM",84,419,"1200x900",800,2,600,400,"False",769,351,224,-127,127,0
"E04SM",85,564,"1200x900",1000,1,600,400,"True",215,264,264,0,0,0
"E04SM",86,7,"1200x900",600,0,600,400,"False",431,654,578,-76,76,1
"E04SM",87,349,"1200x900",800,1,600,400,"True",402,665,593,-72,72,0
"E04SM",88,47,"1200x900",600,0,600,400,"True",303,499,511,12,12,1
"E04SM",89,93,"1200x900",600,1,600,400,"True",139,540,502,-38,38,0
"E04SM",90,557,"1200x900",1000,1,600,400,"False",677,505,634,129,129,1
"E04SM",91,483,"1200x900",1000,0,600,400,"False",93,191,268,77,77,1
"E04SM",92,565,"1200x900",1000,1,600,400,"False",451,562,302,-260,260,0
"E04SM",93,344,"1200x900",800,1,600,400,"True",589,408,363,-45,45,0
"E04SM",94,543,"1200x900",1000,1,600,400,"False",88,202,393,191,191,0
"E04SM",95,442,"1200x900",1000,0,600,400,"True",87,183,172,-11,11,1
"E04SM",96,291,"1200x900",800,1,600,400,"False",522,694,576,-118,118,0
"E04SM",97,131,"1200x900",600,1,600,400,"False",531,367,504,137,137,0
"E04SM",98,594,"1200x900",1000,2,600,400,"False",537,637,221,-416,416,0
"E04SM",99,572,"1200x900",1000,1,600,400,"False",302,260,102,-158,158,0
"E04SM",100,84,"1200x900",600,1,600,400,"False",144,184,512,328,328,0
"E04SM",101,480,"1200x900",1000,0,600,400,"False",100,231,112,-119,119,1
"E04SM",102,549,"1200x900",1000,1,600,400,"False",657,366,180,-186,186,0
"E04SM",103,599,"1200x900",1000,2,600,400,"False",316,570,190,-380,380,0
"E04SM",104,553,"1200x900",1000,1,600,400,"False",116,712,477,-235,235,0
"E04SM",105,279,"1200x900",800,0,600,400,"False",252,202,335,133,133,1
"E04SM",106,365,"1200x900",800,2,600,400,"False",1055,305,712,407,407,0
"E04SM",107,265,"1200x900",800,0,600,400,"True",229,353,354,1,1,1
"E04SM",108,333,"1200x900",800,1,600,400,"True",521,548,494,-54,54,0
"E04SM",109,593,"1200x900",1000,2,600,400,"False",246,719,296,-423,423,0
"E04SM",110,88,"1200x900",600,1,600,400,"False",186,554,435,-119,119,0
"E04SM",111,318,"1200x900",800,1,600,400,"True",788,534,513,-21,21,0
"E04SM",112,488,"1200x900",1000,0,600,400,"True",129,687,669,-18,18,1
"E04SM",113,450,"1200x900",1000,0,600,400,"True",130,204,248,44,44,1
"E04SM",114,345,"1200x900",800,1,600,400,"False",841,566,446,-120,120,1
"E04SM",115,75,"1200x900",600,1,600,400,"True",635,558,519,-39,39,0
"E04SM",116,46,"1200x900",600,0,600,400,"True",193,355,384,29,29,1
"E04SM",117,492,"1200x900",1000,0,600,400,"False",76,692,584,-108,108,1
"E04SM",118,590,"1200x900",1000,2,600,400,"False",636,278,377,99,99,0
"E04SM",119,601,"1200x900",1000,2,600,400,"False",735,697,370,-327,327,0
"E04SM",120,439,"1200x900",1000,0,600,400,"True",110,229,226,-3,3,1
"E04SM",121,598,"1200x900",1000,2,600,400,"False",706,559,453,-106,106,0
"E04SM",122,330,"1200x900",800,1,600,400,"True",759,301,296,-5,5,1
"E04SM",123,317,"1200x900",800,1,600,400,"False",185,564,262,-302,302,0
"E04SM",124,160,"1200x900",600,2,600,400,"False",863,606,421,-185,185,0
"E04SM",125,171,"1200x900",600,2,600,400,"False",909,200,294,94,94,0
"E04SM",126,252,"1200x900",800,0,600,400,"False",224,673,564,-109,109,1
"E04SM",127,469,"1200x900",1000,0,600,400,"True",73,227,179,-48,48,1
"E04SM",128,410,"1200x900",800,2,600,400,"False",916,477,620,143,143,0
"E04SM",129,391,"1200x900",800,2,600,400,"False",895,521,393,-128,128,0
"E04SM",130,122,"1200x900",600,1,600,400,"True",817,709,720,11,11,0
"E04SM",131,421,"1200x900",800,2,600,400,"False",898,394,118,-276,276,0
"E04SM",132,556,"1200x900",1000,1,600,400,"False",415,420,576,156,156,0
"E04SM",133,21,"1200x900",600,0,600,400,"True",314,383,370,-13,13,1
"E04SM",134,637,"1200x900",1000,2,600,400,"True",750,460,513,53,53,0
"E04SM",135,175,"1200x900",600,2,600,400,"False",1028,432,553,121,121,0
"E04SM",136,386,"1200x900",800,2,600,400,"True",774,301,267,-34,34,0
"E04SM",137,200,"1200x900",600,2,600,400,"True",897,302,257,-45,45,0
"E04SM",138,6,"1200x900",600,0,600,400,"False",217,689,589,-100,100,1
"E04SM",139,26,"1200x900",600,0,600,400,"True",70,712,649,-63,63,0
"E04SM",140,236,"1200x900",800,0,600,400,"False",162,350,440,90,90,1
"E04SM",141,139,"1200x900",600,1,600,400,"False",192,695,356,-339,339,0
"E04SM",142,119,"1200x900",600,1,600,400,"True",168,563,483,-80,80,0
"E04SM",143,98,"1200x900",600,1,600,400,"True",625,530,558,28,28,0
"E04SM",144,325,"1200x900",800,1,600,400,"False",105,394,598,204,204,0
"E04SM",145,414,"1200x900",800,2,600,400,"False",831,592,465,-127,127,0
"E04SM",146,538,"1200x900",1000,1,600,400,"True",308,457,399,-58,58,1
"E04SM",147,132,"1200x900",600,1,600,400,"False",333,185,104,-81,81,0
"E04SM",148,514,"1200x900",1000,1,600,400,"False",539,690,485,-205,205,0
"E04SM",149,245,"1200x900",800,0,600,400,"True",296,235,255,20,20,1
"E04SM",150,289,"1200x900",800,1,600,400,"False",421,703,781,78,78,1
"E04SM",151,576,"1200x900",1000,1,600,400,"True",376,713,710,-3,3,0
"E04SM",152,134,"1200x900",600,1,600,400,"True",300,188,184,-4,4,0
"E04SM",153,544,"1200x900",1000,1,600,400,"False",602,620,465,-155,155,0
"E04SM",154,454,"1200x900",1000,0,600,400,"False",78,687,567,-120,120,1
"E04SM",155,412,"1200x900",800,2,600,400,"True",842,280,242,-38,38,0
"E04SM",156,509,"1200x900",1000,1,600,400,"False",509,434,223,-211,211,0
"E04SM",157,270,"1200x900",800,0,600,400,"True",192,418,352,-66,66,1
"E04SM",158,108,"1200x900",600,1,600,400,"False",830,239,343,104,104,0
"E04SM",159,207,"1200x900",600,2,600,400,"False",838,235,366,131,131,0
"E04SM",160,216,"1200x900",600,2,600,400,"False",1029,286,460,174,174,0
"E04SM",161,579,"1200x900",1000,2,600,400,"False",803,394,588,194,194,0
"E04SM",162,338,"1200x900",800,1,600,400,"False",813,253,396,143,143,1
"E04SM",163,370,"1200x900",800,2,600,400,"False",874,336,249,-87,87,0
"E04SM",164,468,"1200x900",1000,0,600,400,"False",121,219,386,167,167,1
"E04SM",165,282,"1200x900",800,0,600,400,"True",109,246,290,44,44,1
"E04SM",166,554,"1200x900",1000,1,600,400,"True",79,309,305,-4,4,1
"E04SM",167,273,"1200x900",800,0,600,400,"True",180,309,360,51,51,1
"E04SM",168,502,"1200x900",1000,0,600,400,"False",111,639,469,-170,170,1
"E04SM",169,274,"1200x900",800,0,600,400,"True",146,497,486,-11,11,1
"E04SM",170,405,"1200x900",800,2,600,400,"False",790,307,465,158,158,0
"E04SM",171,52,"1200x900",600,0,600,400,"False",171,188,342,154,154,0
"E04SM",172,577,"1200x900",1000,2,600,400,"False",455,420,575,155,155,0
"E04SM",173,185,"1200x900",600,2,600,400,"False",907,212,335,123,123,0
"E04SM",174,630,"1200x900",1000,2,600,400,"False",754,559,418,-141,141,0
"E04SM",175,387,"1200x900",800,2,600,400,"False",990,444,367,-77,77,0
"E04SM",176,166,"1200x900",600,2,600,400,"False",896,274,426,152,152,0
"E04SM",177,642,"1200x900",1000,2,600,400,"False",776,316,516,200,200,0
"E04SM",178,159,"1200x900",600,2,600,400,"True",992,309,299,-10,10,0
"E04SM",179,498,"1200x900",1000,0,600,400,"False",100,260,353,93,93,1
"E04SM",180,42,"1200x900",600,0,600,400,"True",233,479,487,8,8,0
"E04SM",181,408,"1200x900",800,2,600,400,"False",758,567,408,-159,159,0
"E04SM",182,124,"1200x900",600,1,600,400,"False",345,467,608,141,141,0
"E04SM",183,89,"1200x900",600,1,600,400,"False",917,366,286,-80,80,1
"E04SM",184,149,"1200x900",600,2,600,400,"False",890,289,472,183,183,0
"E04SM",185,595,"1200x900",1000,2,600,400,"False",687,640,292,-348,348,0
"E04SM",186,68,"1200x900",600,0,600,400,"True",165,367,386,19,19,0
"E04SM",187,427,"1200x900",800,2,600,400,"False",812,380,309,-71,71,0
"E04SM",188,156,"1200x900",600,2,600,400,"False",913,197,356,159,159,0
"E04SM",189,627,"1200x900",1000,2,600,400,"True",760,510,440,-70,70,0
"E04SM",190,596,"1200x900",1000,2,600,400,"False",706,513,400,-113,113,0
"E04SM",191,569,"1200x900",1000,1,600,400,"False",494,720,471,-249,249,0
"E04SM",192,332,"1200x900",800,1,600,400,"False",260,699,609,-90,90,0
"E04SM",193,154,"1200x900",600,2,600,400,"False",941,454,350,-104,104,0
"E04SM",194,477,"1200x900",1000,0,600,400,"True",88,640,628,-12,12,1
"E04SM",195,529,"1200x900",1000,1,600,400,"False",267,412,502,90,90,1
"E04SM",196,97,"1200x900",600,1,600,400,"True",760,643,586,-57,57,1
"E04SM",197,372,"1200x900",800,2,600,400,"True",833,620,560,-60,60,0
"E04SM",198,41,"1200x900",600,0,600,400,"True",370,452,492,40,40,1
"E04SM",199,296,"1200x900",800,1,600,400,"False",89,279,530,251,251,0
"E04SM",200,67,"1200x900",600,0,600,400,"True",289,308,287,-21,21,1
"E04SM",201,211,"1200x900",600,2,600,400,"False",986,407,345,-62,62,0
"E04SM",202,136,"1200x900",600,1,600,400,"True",264,205,248,43,43,0
"E04SM",203,360,"1200x900",800,1,600,400,"False",203,608,460,-148,148,0
"E04SM",204,35,"1200x900",600,0,600,400,"True",366,555,532,-23,23,1
"E04SM",205,501,"1200x900",1000,0,600,400,"True",96,323,348,25,25,1
"E04SM",206,14,"1200x900",600,0,600,400,"True",399,224,278,54,54,1
"E04SM",207,394,"1200x900",800,2,600,400,"False",847,292,442,150,150,0
"E04SM",208,486,"1200x900",1000,0,600,400,"True",102,676,710,34,34,1
"E04SM",209,36,"1200x900",600,0,600,400,"True",128,346,419,73,73,1
"E04SM",210,209,"1200x900",600,2,600,400,"False",937,637,462,-175,175,0
"E04SM",211,582,"1200x900",1000,2,600,400,"False",554,347,505,158,158,0
"E04SM",212,547,"1200x900",1000,1,600,400,"True",369,384,443,59,59,1
"E04SM",213,272,"1200x900",800,0,600,400,"True",200,181,121,-60,60,1
"E04SM",214,500,"1200x900",1000,0,600,400,"False",105,700,528,-172,172,1
"E04SM",215,623,"1200x900",1000,2,600,400,"False",636,527,330,-197,197,0
"E04SM",216,622,"1200x900",1000,2,600,400,"False",307,683,284,-399,399,0
"E04SM",217,169,"1200x900",600,2,600,400,"True",924,290,315,25,25,0
"E04SM",218,54,"1200x900",600,0,600,400,"False",474,564,500,-64,64,1
"E04SM",219,294,"1200x900",800,1,600,400,"False",262,287,438,151,151,0
"E04SM",220,539,"1200x900",1000,1,600,400,"False",510,383,603,220,220,0
"E04SM",221,102,"1200x900",600,1,600,400,"True",861,603,600,-3,3,0
"E04SM",222,420,"1200x900",800,2,600,400,"False",519,223,492,269,269,0
"E04SM",223,515,"1200x900",1000,1,600,400,"False",307,217,487,270,270,0
"E04SM",224,235,"1200x900",800,0,600,400,"True",146,646,652,6,6,1
"E04SM",225,520,"1200x900",1000,1,600,400,"False",564,260,350,90,90,0
"E04SM",226,452,"1200x900",1000,0,600,400,"True",97,273,294,21,21,1
"E04SM",227,510,"1200x900",1000,1,600,400,"True",486,338,319,-19,19,1
"E04SM",228,251,"1200x900",800,0,600,400,"False",88,352,265,-87,87,1
"E04SM",229,545,"1200x900",1000,1,600,400,"False",358,562,391,-171,171,0
"E04SM",230,367,"1200x900",800,2,600,400,"True",613,464,468,4,4,0
"E04SM",231,399,"1200x900",800,2,600,400,"False",603,602,429,-173,173,0
"E04SM",232,130,"1200x900",600,1,600,400,"True",741,428,449,21,21,0
"E04SM",233,143,"1200x900",600,1,600,400,"True",479,284,340,56,56,1
"E04SM",234,499,"1200x900",1000,0,600,400,"False",93,271,157,-114,114,1
"E04SM",235,8,"1200x900",600,0,600,400,"True",156,679,619,-60,60,0
"E04SM",236,51,"1200x900",600,0,600,400,"True",272,181,250,69,69,1
"E04SM",237,161,"1200x900",600,2,600,400,"True",939,553,471,-82,82,0
"E04SM",238,223,"1200x900",800,0,600,400,"False",179,191,346,155,155,1
"E04SM",239,157,"1200x900",600,2,600,400,"False",1016,323,258,-65,65,0
"E04SM",240,15,"1200x900",600,0,600,400,"True",473,352,325,-27,27,1
"E04SM",241,177,"1200x900",600,2,600,400,"True",912,236,235,-1,1,0
"E04SM",242,542,"1200x900",1000,1,600,400,"False",304,401,253,-148,148,0
"E04SM",243,147,"1200x900",600,2,600,400,"True",942,418,450,32,32,0
"E04SM",244,507,"1200x900",1000,1,600,400,"False",608,583,340,-243,243,1
"E04SM",245,648,"1200x900",1000,2,600,400,"True",557,394,357,-37,37,0
"E04SM",246,560,"1200x900",1000,1,600,400,"False",516,693,403,-290,290,0
"E04SM",247,71,"1200x900",600,0,600,400,"False",219,248,137,-111,111,0
"E04SM",248,417,"1200x900",800,2,600,400,"False",750,280,440,160,160,0
"E04SM",249,614,"1200x900",1000,2,600,400,"True",823,563,517,-46,46,0
"E04SM",250,206,"1200x900",600,2,600,400,"False",975,223,377,154,154,0
"E04SM",251,276,"1200x900",800,0,600,400,"True",281,217,195,-22,22,1
"E04SM",252,403,"1200x900",800,2,600,400,"False",625,704,410,-294,294,0
"E04SM",253,295,"1200x900",800,1,600,400,"False",471,334,203,-131,131,0
"E04SM",254,597,"1200x900",1000,2,600,400,"False",352,239,514,275,275,0
"E04SM",255,64,"1200x900",600,0,600,400,"True",102,339,275,-64,64,0
"E04SM",256,406,"1200x900",800,2,600,400,"False",971,233,523,290,290,0
"E04SM",257,320,"1200x900",800,1,600,400,"True",644,376,411,35,35,0
"E04SM",258,229,"1200x900",800,0,600,400,"True",117,697,702,5,5,1
"E04SM",259,371,"1200x900",800,2,600,400,"True",730,560,536,-24,24,0
"E04SM",260,341,"1200x900",800,1,600,400,"True",735,632,630,-2,2,1
"E04SM",261,366,"1200x900",800,2,600,400,"False",931,464,306,-158,158,0
"E04SM",262,306,"1200x900",800,1,600,400,"False",164,524,684,160,160,0
"E04SM",263,85,"1200x900",600,1,600,400,"False",434,347,694,347,347,0
"E04SM",264,478,"1200x900",1000,0,600,400,"False",79,672,755,83,83,1
"E04SM",265,62,"1200x900",600,0,600,400,"True",345,346,397,51,51,1
"E04SM",266,382,"1200x900",800,2,600,400,"False",870,523,339,-184,184,0
"E04SM",267,348,"1200x900",800,1,600,400,"True",764,294,309,15,15,0
"E04SM",268,187,"1200x900",600,2,600,400,"False",857,639,440,-199,199,0
"E04SM",269,300,"1200x900",800,1,600,400,"True",620,693,684,-9,9,0
"E04SM",270,433,"1200x900",1000,0,600,400,"True",76,222,218,-4,4,1
"E04SM",271,604,"1200x900",1000,2,600,400,"False",459,593,686,93,93,0
"E04SM",272,190,"1200x900",600,2,600,400,"False",977,238,351,113,113,0
"E04SM",273,197,"1200x900",600,2,600,400,"True",903,212,267,55,55,0
"E04SM",274,436,"1200x900",1000,0,600,400,"True",82,617,655,38,38,1
"E04SM",275,364,"1200x900",800,2,600,400,"False",1018,204,332,128,128,0
"E04SM",276,463,"1200x900",1000,0,600,400,"True",115,693,639,-54,54,1
"E04SM",277,126,"1200x900",600,1,600,400,"False",849,354,500,146,146,0
"E04SM",278,606,"1200x900",1000,2,600,400,"False",653,627,322,-305,305,0
"E04SM",279,620,"1200x900",1000,2,600,400,"False",832,649,572,-77,77,0
"E04SM",280,212,"1200x900",600,2,600,400,"False",841,206,424,218,218,0
"E04SM",281,473,"1200x900",1000,0,600,400,"False",75,323,435,112,112,1
"E04SM",282,266,"1200x900",800,0,600,400,"True",126,303,301,-2,2,1
"E04SM",283,66,"1200x900",600,0,600,400,"True",155,673,680,7,7,0
"E04SM",284,63,"1200x900",600,0,600,400,"True",311,188,217,29,29,1
"E04SM",285,571,"1200x900",1000,1,600,400,"True",239,522,535,13,13,1
"E04SM",286,377,"1200x900",800,2,600,400,"False",683,388,591,203,203,0
"E04SM",287,13,"1200x900",600,0,600,400,"True",296,211,245,34,34,1
"E04SM",288,484,"1200x900",1000,0,600,400,"False",100,223,407,184,184,1
"E04SM",289,244,"1200x900",800,0,600,400,"True",194,203,197,-6,6,1
"E04SM",290,328,"1200x900",800,1,600,400,"False",104,649,247,-402,402,0
"E04SM",291,232,"1200x900",800,0,600,400,"True",84,511,521,10,10,1
"E04SM",292,489,"1200x900",1000,0,600,400,"False",88,604,490,-114,114,1
"E04SM",293,65,"1200x900",600,0,600,400,"True",442,645,656,11,11,1
"E04SM",294,401,"1200x900",800,2,600,400,"True",821,260,285,25,25,0
"E04SM",295,381,"1200x900",800,2,600,400,"True",705,408,390,-18,18,0
"E04SM",296,322,"1200x900",800,1,600,400,"False",703,206,294,88,88,1
"E04SM",297,413,"1200x900",800,2,600,400,"False",849,506,231,-275,275,0
"E04SM",298,467,"1200x900",1000,0,600,400,"True",74,712,763,51,51,1
"E04SM",299,57,"1200x900",600,0,600,400,"True",354,508,519,11,11,1
"E04SM",300,281,"1200x900",800,0,600,400,"True",112,611,626,15,15,1
"E04SM",301,380,"1200x900",800,2,600,400,"False",942,228,428,200,200,0
"E04SM",302,25,"1200x900",600,0,600,400,"True",263,403,391,-12,12,1
"E04SM",303,37,"1200x900",600,0,600,400,"True",258,403,475,72,72,1
"E04SM",304,495,"1200x900",1000,0,600,400,"False",93,692,625,-67,67,1
"E04SM",305,359,"1200x900",800,1,600,400,"False",653,241,544,303,303,0
"E04SM",306,115,"1200x900",600,1,600,400,"True",545,307,292,-15,15,0
"E04SM",307,353,"1200x900",800,1,600,400,"True",90,476,514,38,38,0
"E04SM",308,110,"1200x900",600,1,600,400,"False",776,550,698,148,148,1
"E04SM",309,142,"1200x900",600,1,600,400,"True",286,474,521,47,47,0
"E04SM",310,249,"1200x900",800,0,600,400,"True",126,306,345,39,39,1
"E04SM",311,226,"1200x900",800,0,600,400,"True",187,229,214,-15,15,1
"E04SM",312,45,"1200x900",600,0,600,400,"True",487,678,694,16,16,1
"E04SM",313,641,"1200x900",1000,2,600,400,"False",897,272,729,457,457,0
"E04SM",314,481,"1200x900",1000,0,600,400,"True",80,185,159,-26,26,1
"E04SM",315,22,"1200x900",600,0,600,400,"True",398,591,586,-5,5,1
"E04SM",316,335,"1200x900",800,1,600,400,"True",124,360,291,-69,69,0
"E04SM",317,111,"1200x900",600,1,600,400,"True",922,552,629,77,77,1
"E04SM",318,259,"1200x900",800,0,600,400,"False",156,180,276,96,96,1
"E04SM",319,528,"1200x900",1000,1,600,400,"False",839,227,592,365,365,1
"E04SM",320,218,"1200x900",800,0,600,400,"False",106,397,311,-86,86,1
"E04SM",321,425,"1200x900",800,2,600,400,"False",621,438,629,191,191,0
"E04SM",322,357,"1200x900",800,1,600,400,"False",109,594,505,-89,89,0
"E04SM",323,339,"1200x900",800,1,600,400,"True",273,545,476,-69,69,1
"E04SM",324,563,"1200x900",1000,1,600,400,"True",201,696,637,-59,59,0
"E04SM",325,180,"1200x900",600,2,600,400,"False",929,270,406,136,136,0
"E04SM",326,373,"1200x900",800,2,600,400,"False",694,326,544,218,218,0
"E04SM",327,588,"1200x900",1000,2,600,400,"False",585,350,213,-137,137,0
"E04SM",328,340,"1200x900",800,1,600,400,"False",226,240,509,269,269,0
"E04SM",329,186,"1200x900",600,2,600,400,"True",997,197,277,80,80,0
"E04SM",330,586,"1200x900",1000,2,600,400,"False",802,262,418,156,156,0
"E04SM",331,475,"1200x900",1000,0,600,400,"False",101,715,609,-106,106,1
"E04SM",332,389,"1200x900",800,2,600,400,"True",843,530,487,-43,43,0
"E04SM",333,395,"1200x900",800,2,600,400,"False",743,334,247,-87,87,0
"E04SM",334,248,"1200x900",800,0,600,400,"False",94,240,108,-132,132,1
"E04SM",335,49,"1200x900",600,0,600,400,"True",109,380,409,29,29,0
"E04SM",336,472,"1200x900",1000,0,600,400,"True",77,685,620,-65,65,1
"E04SM",337,354,"1200x900",800,1,600,400,"False",118,236,348,112,112,0
"E04SM",338,101,"1200x900",600,1,600,400,"False",541,656,376,-280,280,0
"E04SM",339,246,"1200x900",800,0,600,400,"True",196,418,389,-29,29,1
"E04SM",340,224,"1200x900",800,0,600,400,"False",161,474,326,-148,148,1
"E04SM",341,603,"1200x900",1000,2,600,400,"True",693,280,358,78,78,0
"E04SM",342,262,"1200x900",800,0,600,400,"True",196,481,432,-49,49,1
"E04SM",343,626,"1200x900",1000,2,600,400,"True",329,449,523,74,74,0
"E04SM",344,280,"1200x900",800,0,600,400,"True",104,302,312,10,10,1
"E04SM",345,324,"1200x900",800,1,600,400,"False",719,712,397,-315,315,1
"E04SM",346,497,"1200x900",1000,0,600,400,"True",106,696,741,45,45,1
"E04SM",347,73,"1200x900",600,1,600,400,"True",94,665,584,-81,81,0
"E04SM",348,222,"1200x900",800,0,600,400,"True",152,206,213,7,7,1
"E04SM",349,448,"1200x900",1000,0,600,400,"True",107,641,584,-57,57,1
"E04SM",350,217,"1200x900",800,0,600,400,"True",85,573,587,14,14,1
"E04SM",351,580,"1200x900",1000,2,600,400,"False",651,267,348,81,81,0
"E04SM",352,453,"1200x900",1000,0,600,400,"True",71,393,407,14,14,1
"E04SM",353,298,"1200x900",800,1,600,400,"True",311,457,527,70,70,0
"E04SM",354,109,"1200x900",600,1,600,400,"False",691,589,293,-296,296,0
"E04SM",355,123,"1200x900",600,1,600,400,"True",761,365,314,-51,51,1
"E04SM",356,585,"1200x900",1000,2,600,400,"False",698,688,581,-107,107,1
"E04SM",357,292,"1200x900",800,1,600,400,"False",88,565,704,139,139,0
"E04SM",358,523,"1200x900",1000,1,600,400,"True",339,318,299,-19,19,0
"E04SM",359,491,"1200x900",1000,0,600,400,"True",108,198,164,-34,34,1
"E04SM",360,350,"1200x900",800,1,600,400,"False",182,566,447,-119,119,0
"E04SM",361,78,"1200x900",600,1,600,400,"True",885,684,597,-87,87,0
"E04SM",362,416,"1200x900",800,2,600,400,"True",748,617,599,-18,18,0
"E04SM",363,117,"1200x900",600,1,600,400,"False",711,456,367,-89,89,0
"E04SM",364,496,"1200x900",1000,0,600,400,"True",70,639,703,64,64,1
"E04SM",365,293,"1200x900",800,1,600,400,"True",561,396,332,-64,64,0
"E04SM",366,59,"1200x900",600,0,600,400,"True",391,692,643,-49,49,1
"E04SM",367,56,"1200x900",600,0,600,400,"True",148,491,468,-23,23,0
"E04SM",368,32,"1200x900",600,0,600,400,"True",152,563,620,57,57,1
"E04SM",369,591,"1200x900",1000,2,600,400,"False",698,336,459,123,123,0
"E04SM",370,611,"1200x900",1000,2,600,400,"True",414,511,496,-15,15,0
"E04SM",371,567,"1200x900",1000,1,600,400,"False",655,297,127,-170,170,1
"E04SM",372,208,"1200x900",600,2,600,400,"False",946,399,572,173,173,0
"E04SM",373,396,"1200x900",800,2,600,400,"False",678,663,337,-326,326,0
"E04SM",374,368,"1200x900",800,2,600,400,"True",778,515,488,-27,27,0
"E04SM",375,230,"1200x900",800,0,600,400,"True",99,678,713,35,35,1
"E04SM",376,215,"1200x900",600,2,600,400,"True",939,596,573,-23,23,0
"E04SM",377,393,"1200x900",800,2,600,400,"False",657,620,490,-130,130,0
"E04SM",378,40,"1200x900",600,0,600,400,"True",143,513,540,27,27,0
"E04SM",379,12,"1200x900",600,0,600,400,"False",365,336,439,103,103,1
"E04SM",380,100,"1200x900",600,1,600,400,"False",453,511,404,-107,107,0
"E04SM",381,490,"1200x900",1000,0,600,400,"False",114,183,390,207,207,1
"E04SM",382,435,"1200x900",1000,0,600,400,"True",119,200,210,10,10,1
"E04SM",383,315,"1200x900",800,1,600,400,"True",105,211,255,44,44,0
"E04SM",384,411,"1200x900",800,2,600,400,"False",805,361,478,117,117,0
"E04SM",385,162,"1200x900",600,2,600,400,"True",849,279,247,-32,32,0
"E04SM",386,247,"1200x900",800,0,600,400,"False",160,424,488,64,64,1
"E04SM",387,618,"1200x900",1000,2,600,400,"False",276,671,315,-356,356,0
"E04SM",388,90,"1200x900",600,1,600,400,"False",560,474,373,-101,101,0
"E04SM",389,552,"1200x900",1000,1,600,400,"False",255,412,480,68,68,0
"E04SM",390,455,"1200x900",1000,0,600,400,"True",107,718,692,-26,26,1
"E04SM",391,17,"1200x900",600,0,600,400,"True",402,496,514,18,18,1
"E04SM",392,213,"1200x900",600,2,600,400,"False",822,275,380,105,105,0
"E04SM",393,540,"1200x900",1000,1,600,400,"False",389,568,420,-148,148,1
"E04SM",394,434,"1200x900",1000,0,600,400,"True",89,657,702,45,45,1
"E04SM",395,517,"1200x900",1000,1,600,400,"False",548,182,408,226,226,0
"E04SM",396,16,"1200x900",600,0,600,400,"True",297,514,531,17,17,1
"E04SM",397,205,"1200x900",600,2,600,400,"True",1021,504,519,15,15,0
"E04SM",398,312,"1200x900",800,1,600,400,"False",238,683,570,-113,113,0
"E04SM",399,625,"1200x900",1000,2,600,400,"False",279,228,161,-67,67,0
"E04SM",400,145,"1200x900",600,2,600,400,"False",1004,630,353,-277,277,0
"E04SM",401,19,"1200x900",600,0,600,400,"True",286,686,653,-33,33,0
"E04SM",402,493,"1200x900",1000,0,600,400,"True",80,582,632,50,50,1
"E04SM",403,55,"1200x900",600,0,600,400,"True",211,305,261,-44,44,1
"E04SM",404,112,"1200x900",600,1,600,400,"False",681,490,367,-123,123,0
"E04SM",405,82,"1200x900",600,1,600,400,"False",108,213,341,128,128,0
"E04SM",406,182,"1200x900",600,2,600,400,"False",933,389,270,-119,119,0
"E04SM",407,34,"1200x900",600,0,600,400,"True",361,242,303,61,61,1
"E04SM",408,619,"1200x900",1000,2,600,400,"False",803,247,427,180,180,0
"E04SM",409,516,"1200x900",1000,1,600,400,"False",440,559,480,-79,79,0
"E04SM",410,137,"1200x900",600,1,600,400,"True",789,577,513,-64,64,0
"E04SM",411,18,"1200x900",600,0,600,400,"True",400,318,308,-10,10,1
"E04SM",412,633,"1200x900",1000,2,600,400,"False",564,253,314,61,61,0
"E04SM",413,86,"1200x900",600,1,600,400,"False",692,388,231,-157,157,1
"E04SM",414,167,"1200x900",600,2,600,400,"False",956,241,503,262,262,0
"E04SM",415,129,"1200x900",600,1,600,400,"False",859,482,356,-126,126,1
"E04SM",416,314,"1200x900",800,1,600,400,"False",277,616,453,-163,163,1
"E04SM",417,449,"1200x900",1000,0,600,400,"True",105,683,706,23,23,1
"E04SM",418,555,"1200x900",1000,1,600,400,"False",444,556,351,-205,205,0
"E04SM",419,257,"1200x900",800,0,600,400,"False",97,219,103,-116,116,1
"E04SM",420,146,"1200x900",600,2,600,400,"False",989,492,353,-139,139,0
"E04SM",421,327,"1200x900",800,1,600,400,"True",152,339,420,81,81,0
"E04SM",422,415,"1200x900",800,2,600,400,"False",823,684,356,-328,328,0
"E04SM",423,512,"1200x900",1000,1,600,400,"False",139,261,123,-138,138,0
"E04SM",424,470,"1200x900",1000,0,600,400,"True",91,666,638,-28,28,1
"E04SM",425,153,"1200x900",600,2,600,400,"False",1037,601,496,-105,105,0
"E04SM",426,106,"1200x900",600,1,600,400,"True",803,659,622,-37,37,1
"E04SM",427,548,"1200x900",1000,1,600,400,"False",103,278,165,-113,113,0
"E04SM",428,77,"1200x900",600,1,600,400,"False",780,525,337,-188,188,0
"E04SM",429,181,"1200x900",600,2,600,400,"False",1018,223,329,106,106,0
"E04SM",430,189,"1200x900",600,2,600,400,"False",881,397,492,95,95,0
"E04SM",431,636,"1200x900",1000,2,600,400,"False",575,583,327,-256,256,0
"E04SM",432,24,"1200x900",600,0,600,400,"True",430,538,598,60,60,1
"E04SM",433,561,"1200x900",1000,1,600,400,"False",231,406,520,114,114,0
"E04SM",434,430,"1200x900",800,2,600,400,"False",922,254,500,246,246,0
"E04SM",435,451,"1200x900",1000,0,600,400,"True",110,702,668,-34,34,1
"E04SM",436,400,"1200x900",800,2,600,400,"False",733,297,486,189,189,0
"E04SM",437,534,"1200x900",1000,1,600,400,"True",328,504,490,-14,14,1
"E04SM",438,225,"1200x900",800,0,600,400,"True",178,423,425,2,2,1
"E04SM",439,583,"1200x900",1000,2,600,400,"True",949,284,355,71,71,1
"E04SM",440,260,"1200x900",800,0,600,400,"True",103,525,560,35,35,1
"E04SM",441,253,"1200x900",800,0,600,400,"True",177,424,399,-25,25,1
"E04SM",442,10,"1200x900",600,0,600,400,"False",400,499,432,-67,67,1
"E04SM",443,384,"1200x900",800,2,600,400,"False",821,707,376,-331,331,0
"E04SM",444,639,"1200x900",1000,2,600,400,"False",504,456,276,-180,180,0
"E04SM",445,255,"1200x900",800,0,600,400,"True",93,709,703,-6,6,1
"E04SM",446,91,"1200x900",600,1,600,400,"False",417,630,377,-253,253,1
"E04SM",447,271,"1200x900",800,0,600,400,"True",74,360,431,71,71,1
"E04SM",448,3,"1200x900",600,0,600,400,"True",298,443,403,-40,40,1
"E04SM",449,331,"1200x900",800,1,600,400,"False",240,620,475,-145,145,0
"E04SM",450,369,"1200x900",800,2,600,400,"True",903,594,583,-11,11,0
"E04SM",451,616,"1200x900",1000,2,600,400,"True",854,357,306,-51,51,1
"E04SM",452,530,"1200x900",1000,1,600,400,"True",584,405,416,11,11,1
"E04SM",453,268,"1200x900",800,0,600,400,"True",148,400,358,-42,42,1
"E04SM",454,214,"1200x900",600,2,600,400,"False",1046,305,183,-122,122,0
"E04SM",455,550,"1200x900",1000,1,600,400,"True",301,459,402,-57,57,0
"E04SM",456,429,"1200x900",800,2,600,400,"False",682,692,448,-244,244,0
"E04SM",457,358,"1200x900",800,1,600,400,"False",263,635,331,-304,304,0
"E04SM",458,392,"1200x900",800,2,600,400,"False",1031,618,449,-169,169,0
"E04SM",459,44,"1200x900",600,0,600,400,"True",305,554,603,49,49,1
"E04SM",460,176,"1200x900",600,2,600,400,"False",1033,281,386,105,105,0
"E04SM",461,361,"1200x900",800,2,600,400,"True",931,328,312,-16,16,0
"E04SM",462,329,"1200x900",800,1,600,400,"True",517,239,282,43,43,0
"E04SM",463,256,"1200x900",800,0,600,400,"True",192,656,631,-25,25,1
"E04SM",464,624,"1200x900",1000,2,600,400,"False",693,501,643,142,142,0
"E04SM",465,178,"1200x900",600,2,600,400,"False",1041,510,622,112,112,0
"E04SM",466,574,"1200x900",1000,1,600,400,"False",614,194,393,199,199,0
"E04SM",467,311,"1200x900",800,1,600,400,"False",710,261,504,243,243,0
"E04SM",468,287,"1200x900",800,0,600,400,"True",120,567,640,73,73,1
"E04SM",469,104,"1200x900",600,1,600,400,"True",448,584,613,29,29,0
"E04SM",470,397,"1200x900",800,2,600,400,"False",817,692,584,-108,108,0
"E04SM",471,174,"1200x900",600,2,600,400,"False",998,457,578,121,121,0
"E04SM",473,607,"1200x900",1000,2,600,400,"True",900,573,564,-9,9,1
"E04SM",474,193,"1200x900",600,2,600,400,"False",874,588,395,-193,193,0
"E04SM",475,286,"1200x900",800,0,600,400,"True",105,378,328,-50,50,1
"E04SM",476,461,"1200x900",1000,0,600,400,"False",95,711,645,-66,66,1
"E04SM",477,326,"1200x900",800,1,600,400,"True",103,482,462,-20,20,0
"E04SM",478,535,"1200x900",1000,1,600,400,"False",372,410,568,158,158,0
"E04SM",479,30,"1200x900",600,0,600,400,"True",107,353,346,-7,7,0
"E04SM",480,524,"1200x900",1000,1,600,400,"True",534,470,434,-36,36,0
"E04SM",481,173,"1200x900",600,2,600,400,"False",948,693,399,-294,294,0
"E04SM",482,23,"1200x900",600,0,600,400,"True",308,463,436,-27,27,1
"E04SM",483,288,"1200x900",800,0,600,400,"True",180,547,519,-28,28,1
"E04SM",484,151,"1200x900",600,2,600,400,"False",828,680,455,-225,225,0
"E04SM",485,494,"1200x900",1000,0,600,400,"True",127,692,730,38,38,1
"E04SM",486,316,"1200x900",800,1,600,400,"False",362,319,409,90,90,0
"E04SM",487,118,"1200x900",600,1,600,400,"False",190,588,415,-173,173,0
"E04SM",488,546,"1200x900",1000,1,600,400,"False",305,374,600,226,226,0
"E04SM",489,443,"1200x900",1000,0,600,400,"True",99,651,703,52,52,1
"E04SM",490,158,"1200x900",600,2,600,400,"True",939,300,374,74,74,0
"E04SM",491,121,"1200x900",600,1,600,400,"False",884,364,496,132,132,0
"E04SM",492,239,"1200x900",800,0,600,400,"True",114,231,226,-5,5,1
"E04SM",493,589,"1200x900",1000,2,600,400,"True",856,418,446,28,28,0
"E04SM",494,511,"1200x900",1000,1,600,400,"False",408,390,661,271,271,1
"E04SM",495,600,"1200x900",1000,2,600,400,"False",765,207,439,232,232,0
"E04SM",496,2,"1200x900",600,0,600,400,"True",159,323,299,-24,24,0
"E04SM",497,526,"1200x900",1000,1,600,400,"False",497,710,413,-297,297,0
"E04SM",498,144,"1200x900",600,1,600,400,"False",718,371,565,194,194,0
"E04SM",499,635,"1200x900",1000,2,600,400,"True",833,402,468,66,66,0
"E04SM",500,608,"1200x900",1000,2,600,400,"False",742,250,338,88,88,0
"E04SM",501,96,"1200x900",600,1,600,400,"False",433,458,587,129,129,0
"E04SM",502,95,"1200x900",600,1,600,400,"True",749,425,409,-16,16,1
"E04SM",503,592,"1200x900",1000,2,600,400,"False",492,392,609,217,217,0
"E04SM",504,356,"1200x900",800,1,600,400,"True",123,484,462,-22,22,0
"E04SM",505,11,"1200x900",600,0,600,400,"True",372,670,626,-44,44,1
"E04SM",506,570,"1200x900",1000,1,600,400,"False",315,352,636,284,284,0
"E04SM",507,243,"1200x900",800,0,600,400,"False",114,332,424,92,92,1
"E04SM",508,437,"1200x900",1000,0,600,400,"True",74,667,625,-42,42,1
"E04SM",509,519,"1200x900",1000,1,600,400,"False",319,565,411,-154,154,1
"E04SM",510,424,"1200x900",800,2,600,400,"True",903,545,550,5,5,0
"E04SM",511,194,"1200x900",600,2,600,400,"False",896,236,513,277,277,0
"E04SM",512,80,"1200x900",600,1,600,400,"False",616,423,539,116,116,1
"E04SM",513,474,"1200x900",1000,0,600,400,"False",85,339,224,-115,115,1
"E04SM",514,219,"1200x900",800,0,600,400,"True",202,502,447,-55,55,1
"E04SM",515,527,"1200x900",1000,1,600,400,"False",565,601,336,-265,265,0
"E04SM",516,179,"1200x900",600,2,600,400,"True",908,602,601,-1,1,0
"E04SM",517,398,"1200x900",800,2,600,400,"False",944,698,523,-175,175,0
"E04SM",518,202,"1200x900",600,2,600,400,"False",966,460,339,-121,121,0
"E04SM",519,346,"1200x900",800,1,600,400,"False",269,635,511,-124,124,0
"E04SM",520,531,"1200x900",1000,1,600,400,"False",233,362,689,327,327,0
"E04SM",521,116,"1200x900",600,1,600,400,"False",767,289,494,205,205,0
"E04SM",522,378,"1200x900",800,2,600,400,"False",1018,708,396,-312,312,0
"E04SM",523,27,"1200x900",600,0,600,400,"True",373,309,244,-65,65,1
"E04SM",524,309,"1200x900",800,1,600,400,"False",186,225,458,233,233,0
"E04SM",525,140,"1200x900",600,1,600,400,"False",700,523,425,-98,98,0
"E04SM",526,584,"1200x900",1000,2,600,400,"True",731,413,442,29,29,0
"E04SM",527,302,"1200x900",800,1,600,400,"True",479,467,521,54,54,1
"E04SM",528,172,"1200x900",600,2,600,400,"True",912,444,398,-46,46,0
"E04SM",529,165,"1200x900",600,2,600,400,"True",912,554,506,-48,48,0
"E04SM",530,31,"1200x900",600,0,600,400,"True",365,338,391,53,53,1
"E04SM",531,632,"1200x900",1000,2,600,400,"False",984,227,602,375,375,0
"E04SM",532,647,"1200x900",1000,2,600,400,"False",560,637,745,108,108,0
"E04SM",533,573,"1200x900",1000,1,600,400,"False",486,615,531,-84,84,0
"E04SM",534,250,"1200x900",800,0,600,400,"False",290,248,110,-138,138,1
"E04SM",535,559,"1200x900",1000,1,600,400,"False",641,244,550,306,306,0
"E04SM",536,79,"1200x900",600,1,600,400,"True",731,289,238,-51,51,0
"E04SM",537,61,"1200x900",600,0,600,400,"True",272,670,679,9,9,1
"E04SM",538,532,"1200x900",1000,1,600,400,"False",215,207,541,334,334,0
"E04SM",539,184,"1200x900",600,2,600,400,"True",1067,441,487,46,46,0
"E04SM",540,612,"1200x900",1000,2,600,400,"False",706,198,529,331,331,0
"E04SM",541,581,"1200x900",1000,2,600,400,"False",310,357,155,-202,202,0
"E04SM",542,388,"1200x900",800,2,600,400,"True",930,320,334,14,14,0
"E04SM",543,432,"1200x900",800,2,600,400,"False",792,380,152,-228,228,0
"E04SM",544,643,"1200x900",1000,2,600,400,"False",740,325,452,127,127,0
"E04SM",545,29,"1200x900",600,0,600,400,"True",385,533,468,-65,65,1
"E04SM",546,128,"1200x900",600,1,600,400,"False",661,258,415,157,157,1
"E04SM",547,70,"1200x900",600,0,600,400,"False",309,703,597,-106,106,1
"E04SM",548,60,"1200x900",600,0,600,400,"True",365,213,137,-76,76,1
"E04SM",549,53,"1200x900",600,0,600,400,"True",177,189,165,-24,24,0
"E04SM",550,336,"1200x900",800,1,600,400,"False",251,587,472,-115,115,0
"E04SM",551,551,"1200x900",1000,1,600,400,"False",146,445,652,207,207,1
"E04SM",552,284,"1200x900",800,0,600,400,"True",135,293,248,-45,45,1
"E04SM",553,237,"1200x900",800,0,600,400,"True",204,481,448,-33,33,1
"E04SM",554,518,"1200x900",1000,1,600,400,"False",583,717,523,-194,194,0
"E04SM",555,533,"1200x900",1000,1,600,400,"False",355,483,246,-237,237,0
"E04SM",556,508,"1200x900",1000,1,600,400,"False",596,485,388,-97,97,0
"E04SM",557,299,"1200x900",800,1,600,400,"False",779,274,551,277,277,0
"E04SM",558,343,"1200x900",800,1,600,400,"False",407,557,363,-194,194,0
"E04SM",559,375,"1200x900",800,2,600,400,"False",716,384,122,-262,262,0
"E04SM",560,170,"1200x900",600,2,600,400,"False",996,468,365,-103,103,0
"E04SM",561,319,"1200x900",800,1,600,400,"True",494,587,553,-34,34,1
"E04SM",562,342,"1200x900",800,1,600,400,"False",677,204,289,85,85,0
"E04SM",563,20,"1200x900",600,0,600,400,"False",204,545,451,-94,94,1
"E04SM",564,610,"1200x900",1000,2,600,400,"False",702,293,434,141,141,0
"E04SM",565,264,"1200x900",800,0,600,400,"True",198,660,643,-17,17,1
"E04SM",566,513,"1200x900",1000,1,600,400,"False",235,602,325,-277,277,0
"E04SM",567,428,"1200x900",800,2,600,400,"False",732,665,397,-268,268,0
"E04SM",568,426,"1200x900",800,2,600,400,"True",830,263,342,79,79,0
"E04SM",569,38,"1200x900",600,0,600,400,"True",120,628,586,-42,42,1
"E04SM",570,536,"1200x900",1000,1,600,400,"False",580,213,343,130,130,0
"E04SM",571,629,"1200x900",1000,2,600,400,"True",681,257,292,35,35,0
"E04SM",572,204,"1200x900",600,2,600,400,"False",1053,432,545,113,113,0
"E04SM",573,228,"1200x900",800,0,600,400,"True",174,687,645,-42,42,1
"E04SM",574,447,"1200x900",1000,0,600,400,"True",71,339,303,-36,36,1
"E04SM",575,28,"1200x900",600,0,600,400,"True",336,410,417,7,7,1
"E04SM",576,566,"1200x900",1000,1,600,400,"False",378,472,409,-63,63,1
"E04SM",577,203,"1200x900",600,2,600,400,"False",938,603,331,-272,272,0
"E04SM",578,646,"1200x900",1000,2,600,400,"True",829,227,185,-42,42,1
"E04SM",579,638,"1200x900",1000,2,600,400,"True",385,198,139,-59,59,0
"E04SM",580,210,"1200x900",600,2,600,400,"False",835,506,385,-121,121,0
"E04SM",581,613,"1200x900",1000,2,600,400,"False",690,374,459,85,85,0
"E04SM",582,456,"1200x900",1000,0,600,400,"True",91,257,305,48,48,1
"E04SM",583,135,"1200x900",600,1,600,400,"False",759,569,386,-183,183,0
"E04SM",584,261,"1200x900",800,0,600,400,"True",86,713,686,-27,27,1
"E04SM",585,254,"1200x900",800,0,600,400,"True",136,583,635,52,52,1
"E04SM",586,127,"1200x900",600,1,600,400,"True",309,691,711,20,20,0
"E04SM",587,227,"1200x900",800,0,600,400,"True",196,551,522,-29,29,1
"E04SM",588,568,"1200x900",1000,1,600,400,"True",286,475,495,20,20,1
"E04SM",589,303,"1200x900",800,1,600,400,"True",241,431,503,72,72,0
"E04SM",590,277,"1200x900",800,0,600,400,"True",140,310,241,-69,69,1
"E04SM",591,390,"1200x900",800,2,600,400,"False",982,674,521,-153,153,1
"E04SM",592,231,"1200x900",800,0,600,400,"True",251,718,672,-46,46,1
"E04SM",593,462,"1200x900",1000,0,600,400,"True",102,672,619,-53,53,1
"E04SM",594,278,"1200x900",800,0,600,400,"True",251,711,671,-40,40,1
"E04SM",595,304,"1200x900",800,1,600,400,"False",667,605,528,-77,77,0
"E04SM",596,482,"1200x900",1000,0,600,400,"True",79,686,670,-16,16,1
"E04SM",597,522,"1200x900",1000,1,600,400,"False",223,379,615,236,236,0
"E04SM",598,313,"1200x900",800,1,600,400,"True",588,421,488,67,67,0
"E04SM",599,188,"1200x900",600,2,600,400,"False",900,195,334,139,139,0
"E04SM",600,376,"1200x900",800,2,600,400,"False",788,275,130,-145,145,0
"E04SM",601,234,"1200x900",800,0,600,400,"True",72,344,282,-62,62,1
"E04SM",602,152,"1200x900",600,2,600,400,"True",971,399,498,99,99,0
"E04SM",603,103,"1200x900",600,1,600,400,"True",528,320,375,55,55,1
"E04SM",604,138,"1200x900",600,1,600,400,"True",844,580,568,-12,12,1
"E04SM",605,506,"1200x900",1000,1,600,400,"False",559,567,303,-264,264,1
"E04SM",606,422,"1200x900",800,2,600,400,"False",712,558,178,-380,380,0
"E04SM",607,457,"1200x900",1000,0,600,400,"True",97,630,623,-7,7,1
"E04SM",608,379,"1200x900",800,2,600,400,"False",994,325,516,191,191,0
"E04SM",609,645,"1200x900",1000,2,600,400,"True",619,396,362,-34,34,0
"E04SM",610,362,"1200x900",800,2,600,400,"False",819,338,558,220,220,0
"E04SM",611,201,"1200x900",600,2,600,400,"False",1005,462,370,-92,92,0
"E04SM",612,334,"1200x900",800,1,600,400,"False",481,665,269,-396,396,0
"E04SM",613,440,"1200x900",1000,0,600,400,"True",71,237,279,42,42,1
"E04SM",614,310,"1200x900",800,1,600,400,"False",559,592,501,-91,91,0
"E04SM",615,615,"1200x900",1000,2,600,400,"False",736,634,325,-309,309,0
"E04SM",616,352,"1200x900",800,1,600,400,"False",235,717,523,-194,194,0
"E04SM",617,92,"1200x900",600,1,600,400,"True",624,605,659,54,54,0
"E04SM",618,192,"1200x900",600,2,600,400,"True",1064,320,147,-173,173,0
"E04SM",619,258,"1200x900",800,0,600,400,"True",126,664,657,-7,7,1
"E04SM",620,383,"1200x900",800,2,600,400,"True",855,407,412,5,5,0
"E04SM",621,575,"1200x900",1000,1,600,400,"False",272,693,541,-152,152,0
"E04SM",622,269,"1200x900",800,0,600,400,"True",160,295,322,27,27,1
"E04SM",623,263,"1200x900",800,0,600,400,"True",82,396,369,-27,27,1
"E04SM",624,33,"1200x900",600,0,600,400,"False",198,533,444,-89,89,1
"E04SM",625,233,"1200x900",800,0,600,400,"True",164,700,718,18,18,1
"E04SM",626,305,"1200x900",800,1,600,400,"True",471,716,708,-8,8,0
"E04SM",627,644,"1200x900",1000,2,600,400,"True",495,486,520,34,34,0
"E04SM",628,465,"1200x900",1000,0,600,400,"False",85,203,285,82,82,1
"E04SM",629,308,"1200x900",800,1,600,400,"False",437,425,593,168,168,0
"E04SM",630,438,"1200x900",1000,0,600,400,"True",77,713,767,54,54,1
"E04SM",631,355,"1200x900",800,1,600,400,"True",77,386,356,-30,30,0
"E04SM",632,283,"1200x900",800,0,600,400,"True",90,264,268,4,4,1
"E04SM",633,609,"1200x900",1000,2,600,400,"False",697,627,435,-192,192,0
"E04SM",634,81,"1200x900",600,1,600,400,"False",696,225,387,162,162,0
"E04SM",635,409,"1200x900",800,2,600,400,"False",501,659,259,-400,400,0
"E04SM",636,487,"1200x900",1000,0,600,400,"False",78,670,749,79,79,1
"E04SM",637,221,"1200x900",800,0,600,400,"False",132,520,619,99,99,1
"E04SM",638,441,"1200x900",1000,0,600,400,"True",85,684,667,-17,17,1
"E04SM",639,347,"1200x900",800,1,600,400,"False",757,295,603,308,308,1
"E04SM",640,198,"1200x900",600,2,600,400,"False",976,500,330,-170,170,0
"E04SM",641,631,"1200x900",1000,2,600,400,"False",699,479,610,131,131,0
"E04SM",642,148,"1200x900",600,2,600,400,"True",907,330,370,40,40,0
"E04SM",644,275,"1200x900",800,0,600,400,"False",120,594,688,94,94,0
"E04SM",645,485,"1200x900",1000,0,600,400,"True",121,694,695,1,1,1
"E04SM",646,418,"1200x900",800,2,600,400,"True",754,507,567,60,60,0
"E04SM",647,241,"1200x900",800,0,600,400,"False",129,227,146,-81,81,1
"E04SM",648,74,"1200x900",600,1,600,400,"False",115,358,206,-152,152,0
"E05FJ",1,101,"1200x900",600,1,600,400,"True",541,656,566,-90,90,0
"E05FJ",2,604,"1200x900",1000,2,600,400,"False",459,593,487,-106,106,0
"E05FJ",3,204,"1200x900",600,2,600,400,"True",1053,432,505,73,73,0
"E05FJ",4,301,"1200x900",800,1,600,400,"False",162,574,417,-157,157,0
"E05FJ",5,142,"1200x900",600,1,600,400,"True",286,474,424,-50,50,0
"E05FJ",6,148,"1200x900",600,2,600,400,"False",907,330,440,110,110,0
"E05FJ",7,498,"1200x900",1000,0,600,400,"False",100,260,400,140,140,1
"E05FJ",8,597,"1200x900",1000,2,600,400,"False",352,239,534,295,295,0
"E05FJ",9,323,"1200x900",800,1,600,400,"True",388,348,339,-9,9,0
"E05FJ",10,576,"1200x900",1000,1,600,400,"False",376,713,414,-299,299,0
"E05FJ",11,593,"1200x900",1000,2,600,400,"False",246,719,300,-419,419,0
"E05FJ",12,489,"1200x900",1000,0,600,400,"False",88,604,466,-138,138,1
"E05FJ",13,420,"1200x900",800,2,600,400,"False",519,223,402,179,179,0
"E05FJ",14,241,"1200x900",800,0,600,400,"False",129,227,492,265,265,1
"E05FJ",15,71,"1200x900",600,0,600,400,"False",219,248,404,156,156,0
"E05FJ",16,568,"1200x900",1000,1,600,400,"False",286,475,264,-211,211,1
"E05FJ",17,97,"1200x900",600,1,600,400,"False",760,643,350,-293,293,1
"E05FJ",18,337,"1200x900",800,1,600,400,"False",299,622,293,-329,329,0
"E05FJ",19,259,"1200x900",800,0,600,400,"False",156,180,340,160,160,1
"E05FJ",20,95,"1200x900",600,1,600,400,"False",749,425,341,-84,84,1
"E05FJ",21,93,"1200x900",600,1,600,400,"False",139,540,374,-166,166,0
"E05FJ",22,448,"1200x900",1000,0,600,400,"False",107,641,311,-330,330,1
"E05FJ",23,346,"1200x900",800,1,600,400,"False",269,635,312,-323,323,0
"E05FJ",24,209,"1200x900",600,2,600,400,"False",937,637,362,-275,275,0
"E05FJ",25,49,"1200x900",600,0,600,400,"True",109,380,429,49,49,0
"E05FJ",26,328,"1200x900",800,1,600,400,"False",104,649,314,-335,335,0
"E05FJ",27,342,"1200x900",800,1,600,400,"False",677,204,353,149,149,0
"E05FJ",28,279,"1200x900",800,0,600,400,"True",252,202,249,47,47,1
"E05FJ",29,161,"1200x900",600,2,600,400,"False",939,553,313,-240,240,0
"E05FJ",30,85,"1200x900",600,1,600,400,"True",434,347,249,-98,98,0
"E05FJ",31,269,"1200x900",800,0,600,400,"True",160,295,266,-29,29,1
"E05FJ",32,145,"1200x900",600,2,600,400,"False",1004,630,367,-263,263,0
"E05FJ",33,127,"1200x900",600,1,600,400,"False",309,691,414,-277,277,0
"E05FJ",34,632,"1200x900",1000,2,600,400,"False",984,227,448,221,221,0
"E05FJ",35,610,"1200x900",1000,2,600,400,"True",702,293,297,4,4,0
"E05FJ",36,640,"1200x900",1000,2,600,400,"True",361,334,311,-23,23,0
"E05FJ",37,542,"1200x900",1000,1,600,400,"False",304,401,241,-160,160,0
"E05FJ",38,438,"1200x900",1000,0,600,400,"False",77,713,354,-359,359,1
"E05FJ",39,276,"1200x900",800,0,600,400,"True",281,217,279,62,62,1
"E05FJ",40,428,"1200x900",800,2,600,400,"False",732,665,261,-404,404,0
"E05FJ",41,330,"1200x900",800,1,600,400,"False",759,301,210,-91,91,1
"E05FJ",42,584,"1200x900",1000,2,600,400,"False",731,413,186,-227,227,0
"E05FJ",43,418,"1200x900",800,2,600,400,"False",754,507,392,-115,115,0
"E05FJ",44,517,"1200x900",1000,1,600,400,"False",548,182,371,189,189,0
"E05FJ",45,182,"1200x900",600,2,600,400,"False",933,389,300,-89,89,0
"E05FJ",46,42,"1200x900",600,0,600,400,"False",233,479,369,-110,110,0
"E05FJ",47,137,"1200x900",600,1,600,400,"False",789,577,401,-176,176,0
"E05FJ",48,300,"1200x900",800,1,600,400,"False",620,693,406,-287,287,0
"E05FJ",50,351,"1200x900",800,1,600,400,"True",122,581,541,-40,40,0
"E05FJ",51,338,"1200x900",800,1,600,400,"False",813,253,475,222,222,1
"E05FJ",52,533,"1200x900",1000,1,600,400,"True",355,483,485,2,2,0
"E05FJ",53,244,"1200x900",800,0,600,400,"False",194,203,482,279,279,1
"E05FJ",54,235,"1200x900",800,0,600,400,"False",146,646,462,-184,184,1
"E05FJ",55,11,"1200x900",600,0,600,400,"False",372,670,502,-168,168,1
"E05FJ",56,386,"1200x900",800,2,600,400,"True",774,301,388,87,87,0
"E05FJ",57,187,"1200x900",600,2,600,400,"False",857,639,440,-199,199,0
"E05FJ",58,14,"1200x900",600,0,600,400,"True",399,224,229,5,5,1
"E05FJ",59,227,"1200x900",800,0,600,400,"False",196,551,359,-192,192,1
"E05FJ",60,252,"1200x900",800,0,600,400,"False",224,673,372,-301,301,1
"E05FJ",61,266,"1200x900",800,0,600,400,"True",126,303,317,14,14,1
"E05FJ",62,275,"1200x900",800,0,600,400,"False",120,594,386,-208,208,0
"E05FJ",63,201,"1200x900",600,2,600,400,"False",1005,462,336,-126,126,0
"E05FJ",64,202,"1200x900",600,2,600,400,"True",966,460,417,-43,43,0
"E05FJ",65,44,"1200x900",600,0,600,400,"False",305,554,418,-136,136,1
"E05FJ",66,603,"1200x900",1000,2,600,400,"False",693,280,426,146,146,0
"E05FJ",67,298,"1200x900",800,1,600,400,"False",311,457,392,-65,65,0
"E05FJ",68,453,"1200x900",1000,0,600,400,"True",71,393,395,2,2,1
"E05FJ",69,469,"1200x900",1000,0,600,400,"True",73,227,271,44,44,1
"E05FJ",70,377,"1200x900",800,2,600,400,"True",683,388,375,-13,13,0
"E05FJ",71,470,"1200x900",1000,0,600,400,"False",91,666,305,-361,361,1
"E05FJ",72,607,"1200x900",1000,2,600,400,"False",900,573,299,-274,274,1
"E05FJ",73,191,"1200x900",600,2,600,400,"False",962,396,326,-70,70,0
"E05FJ",74,94,"1200x900",600,1,600,400,"False",729,482,307,-175,175,0
"E05FJ",75,136,"1200x900",600,1,600,400,"False",264,205,369,164,164,0
"E05FJ",76,460,"1200x900",1000,0,600,400,"False",155,189,328,139,139,1
"E05FJ",77,206,"1200x900",600,2,600,400,"False",975,223,299,76,76,0
"E05FJ",78,439,"1200x900",1000,0,600,400,"False",110,229,414,185,185,1
"E05FJ",79,524,"1200x900",1000,1,600,400,"True",534,470,380,-90,90,0
"E05FJ",80,118,"1200x900",600,1,600,400,"False",190,588,378,-210,210,0
"E05FJ",81,290,"1200x900",800,1,600,400,"False",789,603,391,-212,212,0
"E05FJ",82,579,"1200x900",1000,2,600,400,"True",803,394,438,44,44,0
"E05FJ",83,26,"1200x900",600,0,600,400,"False",70,712,464,-248,248,0
"E05FJ",84,561,"1200x900",1000,1,600,400,"True",231,406,434,28,28,0
"E05FJ",85,381,"1200x900",800,2,600,400,"True",705,408,443,35,35,0
"E05FJ",86,286,"1200x900",800,0,600,400,"True",105,378,420,42,42,1
"E05FJ",87,84,"1200x900",600,1,600,400,"True",144,184,230,46,46,0
"E05FJ",88,537,"1200x900",1000,1,600,400,"False",621,412,517,105,105,1
"E05FJ",89,429,"1200x900",800,2,600,400,"False",682,692,472,-220,220,0
"E05FJ",90,558,"1200x900",1000,1,600,400,"False",72,464,386,-78,78,1
"E05FJ",91,425,"1200x900",800,2,600,400,"True",621,438,401,-37,37,0
"E05FJ",92,586,"1200x900",1000,2,600,400,"False",802,262,412,150,150,0
"E05FJ",94,495,"1200x900",1000,0,600,400,"False",93,692,447,-245,245,1
"E05FJ",95,450,"1200x900",1000,0,600,400,"True",130,204,257,53,53,1
"E05FJ",96,61,"1200x900",600,0,600,400,"False",272,670,498,-172,172,1
"E05FJ",97,309,"1200x900",800,1,600,400,"False",186,225,380,155,155,0
"E05FJ",98,205,"1200x900",600,2,600,400,"True",1021,504,468,-36,36,0
"E05FJ",99,334,"1200x900",800,1,600,400,"False",481,665,387,-278,278,0
"E05FJ",100,523,"1200x900",1000,1,600,400,"True",339,318,339,21,21,0
"E05FJ",101,507,"1200x900",1000,1,600,400,"False",608,583,397,-186,186,1
"E05FJ",102,69,"1200x900",600,0,600,400,"False",322,268,371,103,103,0
"E05FJ",103,177,"1200x900",600,2,600,400,"False",912,236,352,116,116,0
"E05FJ",104,456,"1200x900",1000,0,600,400,"False",91,257,353,96,96,1
"E05FJ",105,173,"1200x900",600,2,600,400,"False",948,693,506,-187,187,0
"E05FJ",106,68,"1200x900",600,0,600,400,"False",165,367,463,96,96,0
"E05FJ",107,89,"1200x900",600,1,600,400,"False",917,366,456,90,90,1
"E05FJ",108,24,"1200x900",600,0,600,400,"False",430,538,408,-130,130,1
"E05FJ",109,504,"1200x900",1000,0,600,400,"False",107,699,390,-309,309,1
"E05FJ",111,582,"1200x900",1000,2,600,400,"True",554,347,351,4,4,0
"E05FJ",112,132,"1200x900",600,1,600,400,"True",333,185,237,52,52,0
"E05FJ",113,119,"1200x900",600,1,600,400,"False",168,563,303,-260,260,0
"E05FJ",114,170,"1200x900",600,2,600,400,"False",996,468,287,-181,181,0
"E05FJ",115,548,"1200x900",1000,1,600,400,"False",103,278,363,85,85,0
"E05FJ",116,354,"1200x900",800,1,600,400,"False",118,236,344,108,108,0
"E05FJ",117,90,"1200x900",600,1,600,400,"False",560,474,319,-155,155,0
"E05FJ",118,149,"1200x900",600,2,600,400,"True",890,289,318,29,29,0
"E05FJ",119,15,"1200x900",600,0,600,400,"True",473,352,298,-54,54,1
"E05FJ",120,444,"1200x900",1000,0,600,400,"False",101,714,366,-348,348,1
"E05FJ",121,578,"1200x900",1000,2,600,400,"True",966,276,308,32,32,0
"E05FJ",122,614,"1200x900",1000,2,600,400,"False",823,563,336,-227,227,0
"E05FJ",123,630,"1200x900",1000,2,600,400,"False",754,559,305,-254,254,0
"E05FJ",124,514,"1200x900",1000,1,600,400,"False",539,690,260,-430,430,0
"E05FJ",125,555,"1200x900",1000,1,600,400,"False",444,556,289,-267,267,0
"E05FJ",126,416,"1200x900",800,2,600,400,"False",748,617,366,-251,251,0
"E05FJ",128,243,"1200x900",800,0,600,400,"True",114,332,340,8,8,1
"E05FJ",129,248,"1200x900",800,0,600,400,"False",94,240,309,69,69,1
"E05FJ",130,403,"1200x900",800,2,600,400,"False",625,704,282,-422,422,0
"E05FJ",131,513,"1200x900",1000,1,600,400,"False",235,602,406,-196,196,0
"E05FJ",132,168,"1200x900",600,2,600,400,"True",1001,439,475,36,36,0
"E05FJ",133,296,"1200x900",800,1,600,400,"True",89,279,287,8,8,0
"E05FJ",134,141,"1200x900",600,1,600,400,"False",671,582,332,-250,250,0
"E05FJ",135,589,"1200x900",1000,2,600,400,"False",856,418,316,-102,102,0
"E05FJ",137,571,"1200x900",1000,1,600,400,"False",239,522,311,-211,211,1
"E05FJ",138,29,"1200x900",600,0,600,400,"False",385,533,323,-210,210,1
"E05FJ",139,146,"1200x900",600,2,600,400,"False",989,492,433,-59,59,0
"E05FJ",140,635,"1200x900",1000,2,600,400,"True",833,402,369,-33,33,0
"E05FJ",141,538,"1200x900",1000,1,600,400,"False",308,457,360,-97,97,1
"E05FJ",143,522,"1200x900",1000,1,600,400,"False",223,379,538,159,159,0
"E05FJ",144,55,"1200x900",600,0,600,400,"True",211,305,294,-11,11,1
"E05FJ",145,217,"1200x900",800,0,600,400,"False",85,573,453,-120,120,1
"E05FJ",147,271,"1200x900",800,0,600,400,"True",74,360,402,42,42,1
"E05FJ",148,307,"1200x900",800,1,600,400,"False",716,247,328,81,81,0
"E05FJ",149,183,"1200x900",600,2,600,400,"True",927,289,350,61,61,0
"E05FJ",150,647,"1200x900",1000,2,600,400,"False",560,637,396,-241,241,0
"E05FJ",151,505,"1200x900",1000,1,600,400,"False",191,484,331,-153,153,1
"E05FJ",152,171,"1200x900",600,2,600,400,"False",909,200,326,126,126,0
"E05FJ",153,112,"1200x900",600,1,600,400,"False",681,490,288,-202,202,0
"E05FJ",154,475,"1200x900",1000,0,600,400,"False",101,715,360,-355,355,1
"E05FJ",155,158,"1200x900",600,2,600,400,"True",939,300,354,54,54,0
"E05FJ",156,308,"1200x900",800,1,600,400,"True",437,425,410,-15,15,0
"E05FJ",157,114,"1200x900",600,1,600,400,"False",183,697,375,-322,322,0
"E05FJ",158,189,"1200x900",600,2,600,400,"True",881,397,365,-32,32,0
"E05FJ",159,265,"1200x900",800,0,600,400,"True",229,353,333,-20,20,1
"E05FJ",160,437,"1200x900",1000,0,600,400,"False",74,667,472,-195,195,1
"E05FJ",161,211,"1200x900",600,2,600,400,"True",986,407,454,47,47,0
"E05FJ",162,331,"1200x900",800,1,600,400,"False",240,620,422,-198,198,0
"E05FJ",163,220,"1200x900",800,0,600,400,"False",108,699,496,-203,203,1
"E05FJ",164,73,"1200x900",600,1,600,400,"False",94,665,500,-165,165,0
"E05FJ",165,19,"1200x900",600,0,600,400,"False",286,686,525,-161,161,0
"E05FJ",166,111,"1200x900",600,1,600,400,"True",922,552,521,-31,31,1
"E05FJ",167,432,"1200x900",800,2,600,400,"False",792,380,486,106,106,0
"E05FJ",168,583,"1200x900",1000,2,600,400,"False",949,284,430,146,146,1
"E05FJ",169,291,"1200x900",800,1,600,400,"False",522,694,401,-293,293,0
"E05FJ",170,254,"1200x900",800,0,600,400,"False",136,583,446,-137,137,1
"E05FJ",171,379,"1200x900",800,2,600,400,"True",994,325,376,51,51,0
"E05FJ",172,40,"1200x900",600,0,600,400,"True",143,513,476,-37,37,0
"E05FJ",173,409,"1200x900",800,2,600,400,"False",501,659,426,-233,233,0
"E05FJ",174,54,"1200x900",600,0,600,400,"False",474,564,440,-124,124,1
"E05FJ",175,449,"1200x900",1000,0,600,400,"False",105,683,471,-212,212,1
"E05FJ",176,612,"1200x900",1000,2,600,400,"False",706,198,426,228,228,0
"E05FJ",177,75,"1200x900",600,1,600,400,"False",635,558,383,-175,175,0
"E05FJ",178,17,"1200x900",600,0,600,400,"False",402,496,376,-120,120,1
"E05FJ",179,577,"1200x900",1000,2,600,400,"False",455,420,309,-111,111,0
"E05FJ",180,353,"1200x900",800,1,600,400,"False",90,476,375,-101,101,0
"E05FJ",181,387,"1200x900",800,2,600,400,"False",990,444,355,-89,89,0
"E05FJ",182,371,"1200x900",800,2,600,400,"False",730,560,357,-203,203,0
"E05FJ",183,382,"1200x900",800,2,600,400,"False",870,523,358,-165,165,0
"E05FJ",185,500,"1200x900",1000,0,600,400,"False",105,700,418,-282,282,1
"E05FJ",186,484,"1200x900",1000,0,600,400,"False",100,223,339,116,116,1
"E05FJ",187,510,"1200x900",1000,1,600,400,"False",486,338,245,-93,93,1
"E05FJ",188,544,"1200x900",1000,1,600,400,"False",602,620,357,-263,263,0
"E05FJ",189,520,"1200x900",1000,1,600,400,"True",564,260,312,52,52,0
"E05FJ",190,30,"1200x900",600,0,600,400,"True",107,353,314,-39,39,0
"E05FJ",191,518,"1200x900",1000,1,600,400,"False",583,717,389,-328,328,0
"E05FJ",192,218,"1200x900",800,0,600,400,"True",106,397,369,-28,28,1
"E05FJ",193,443,"1200x900",1000,0,600,400,"False",99,651,450,-201,201,1
"E05FJ",194,278,"1200x900",800,0,600,400,"False",251,711,611,-100,100,1
"E05FJ",195,246,"1200x900",800,0,600,400,"True",196,418,462,44,44,1
"E05FJ",196,59,"1200x900",600,0,600,400,"True",391,692,634,-58,58,1
"E05FJ",197,599,"1200x900",1000,2,600,400,"False",316,570,411,-159,159,0
"E05FJ",198,360,"1200x900",800,1,600,400,"False",203,608,698,90,90,0
"E05FJ",199,195,"1200x900",600,2,600,400,"False",942,249,614,365,365,0
"E05FJ",200,283,"1200x900",800,0,600,400,"False",90,264,370,106,106,1
"E05FJ",201,445,"1200x900",1000,0,600,400,"True",78,302,250,-52,52,1
"E05FJ",202,213,"1200x900",600,2,600,400,"True",822,275,337,62,62,0
"E05FJ",203,138,"1200x900",600,1,600,400,"False",844,580,323,-257,257,1
"E05FJ",204,256,"1200x900",800,0,600,400,"False",192,656,424,-232,232,1
"E05FJ",205,367,"1200x900",800,2,600,400,"False",613,464,549,85,85,0
"E05FJ",206,8,"1200x900",600,0,600,400,"False",156,679,566,-113,113,0
"E05FJ",207,451,"1200x900",1000,0,600,400,"False",110,702,478,-224,224,1
"E05FJ",208,219,"1200x900",800,0,600,400,"False",202,502,408,-94,94,1
"E05FJ",209,468,"1200x900",1000,0,600,400,"True",121,219,269,50,50,1
"E05FJ",210,6,"1200x900",600,0,600,400,"False",217,689,547,-142,142,1
"E05FJ",211,232,"1200x900",800,0,600,400,"False",84,511,383,-128,128,1
"E05FJ",212,178,"1200x900",600,2,600,400,"True",1041,510,503,-7,7,0
"E05FJ",213,176,"1200x900",600,2,600,400,"False",1033,281,632,351,351,0
"E05FJ",214,27,"1200x900",600,0,600,400,"True",373,309,338,29,29,1
"E05FJ",215,261,"1200x900",800,0,600,400,"True",86,713,684,-29,29,1
"E05FJ",216,488,"1200x900",1000,0,600,400,"False",129,687,487,-200,200,1
"E05FJ",217,372,"1200x900",800,2,600,400,"False",833,620,480,-140,140,0
"E05FJ",218,80,"1200x900",600,1,600,400,"False",616,423,509,86,86,1
"E05FJ",219,144,"1200x900",600,1,600,400,"True",718,371,438,67,67,0
"E05FJ",220,547,"1200x900",1000,1,600,400,"True",369,384,437,53,53,1
"E05FJ",221,503,"1200x900",1000,0,600,400,"False",86,279,365,86,86,1
"E05FJ",222,316,"1200x900",800,1,600,400,"False",362,319,555,236,236,0
"E05FJ",223,28,"1200x900",600,0,600,400,"True",336,410,420,10,10,1
"E05FJ",224,212,"1200x900",600,2,600,400,"False",841,206,417,211,211,0
"E05FJ",225,233,"1200x900",800,0,600,400,"False",164,700,410,-290,290,1
"E05FJ",227,51,"1200x900",600,0,600,400,"True",272,181,180,-1,1,1
"E05FJ",228,74,"1200x900",600,1,600,400,"False",115,358,187,-171,171,0
"E05FJ",229,631,"1200x900",1000,2,600,400,"False",699,479,378,-101,101,0
"E05FJ",230,502,"1200x900",1000,0,600,400,"False",111,639,294,-345,345,1
"E05FJ",231,595,"1200x900",1000,2,600,400,"False",687,640,312,-328,328,0
"E05FJ",232,255,"1200x900",800,0,600,400,"False",93,709,465,-244,244,1
"E05FJ",233,492,"1200x900",1000,0,600,400,"False",76,692,430,-262,262,1
"E05FJ",234,421,"1200x900",800,2,600,400,"True",898,394,363,-31,31,0
"E05FJ",236,359,"1200x900",800,1,600,400,"False",653,241,320,79,79,0
"E05FJ",237,294,"1200x900",800,1,600,400,"False",262,287,389,102,102,0
"E05FJ",238,92,"1200x900",600,1,600,400,"True",624,605,515,-90,90,0
"E05FJ",239,285,"1200x900",800,0,600,400,"False",237,396,489,93,93,1
"E05FJ",240,311,"1200x900",800,1,600,400,"False",710,261,519,258,258,0
"E05FJ",241,98,"1200x900",600,1,600,400,"True",625,530,518,-12,12,0
"E05FJ",242,180,"1200x900",600,2,600,400,"False",929,270,505,235,235,0
"E05FJ",243,646,"1200x900",1000,2,600,400,"False",829,227,422,195,195,1
"E05FJ",244,228,"1200x900",800,0,600,400,"True",174,687,667,-20,20,1
"E05FJ",245,629,"1200x900",1000,2,600,400,"False",681,257,380,123,123,0
"E05FJ",246,99,"1200x900",600,1,600,400,"True",811,407,448,41,41,0
"E05FJ",247,249,"1200x900",800,0,600,400,"True",126,306,341,35,35,1
"E05FJ",248,303,"1200x900",800,1,600,400,"False",241,431,354,-77,77,0
"E05FJ",249,368,"1200x900",800,2,600,400,"False",778,515,412,-103,103,0
"E05FJ",250,413,"1200x900",800,2,600,400,"False",849,506,323,-183,183,0
"E05FJ",251,267,"1200x900",800,0,600,400,"True",145,665,622,-43,43,1
"E05FJ",252,251,"1200x900",800,0,600,400,"True",88,352,403,51,51,1
"E05FJ",253,240,"1200x900",800,0,600,400,"False",330,656,399,-257,257,1
"E05FJ",254,13,"1200x900",600,0,600,400,"False",296,211,290,79,79,1
"E05FJ",255,320,"1200x900",800,1,600,400,"False",644,376,248,-128,128,0
"E05FJ",256,91,"1200x900",600,1,600,400,"False",417,630,285,-345,345,1
"E05FJ",257,455,"1200x900",1000,0,600,400,"False",107,718,464,-254,254,1
"E05FJ",258,67,"1200x900",600,0,600,400,"True",289,308,304,-4,4,1
"E05FJ",259,611,"1200x900",1000,2,600,400,"False",414,511,348,-163,163,0
"E05FJ",260,60,"1200x900",600,0,600,400,"True",365,213,272,59,59,1
"E05FJ",261,411,"1200x900",800,2,600,400,"True",805,361,357,-4,4,0
"E05FJ",262,154,"1200x900",600,2,600,400,"False",941,454,378,-76,76,0
"E05FJ",263,486,"1200x900",1000,0,600,400,"False",102,676,310,-366,366,1
"E05FJ",264,539,"1200x900",1000,1,600,400,"True",510,383,384,1,1,0
"E05FJ",265,536,"1200x900",1000,1,600,400,"False",580,213,301,88,88,0
"E05FJ",266,590,"1200x900",1000,2,600,400,"True",636,278,227,-51,51,0
"E05FJ",267,185,"1200x900",600,2,600,400,"True",907,212,210,-2,2,0
"E05FJ",268,423,"1200x900",800,2,600,400,"False",1051,710,394,-316,316,1
"E05FJ",269,247,"1200x900",800,0,600,400,"True",160,424,351,-73,73,1
"E05FJ",270,373,"1200x900",800,2,600,400,"True",694,326,357,31,31,0
"E05FJ",271,214,"1200x900",600,2,600,400,"True",1046,305,316,11,11,0
"E05FJ",272,404,"1200x900",800,2,600,400,"True",842,396,350,-46,46,0
"E05FJ",273,531,"1200x900",1000,1,600,400,"False",233,362,291,-71,71,0
"E05FJ",274,167,"1200x900",600,2,600,400,"True",956,241,273,32,32,0
"E05FJ",275,609,"1200x900",1000,2,600,400,"False",697,627,301,-326,326,0
"E05FJ",276,163,"1200x900",600,2,600,400,"False",1046,665,354,-311,311,0
"E05FJ",277,637,"1200x900",1000,2,600,400,"False",750,460,359,-101,101,0
"E05FJ",278,487,"1200x900",1000,0,600,400,"False",78,670,368,-302,302,1
"E05FJ",279,186,"1200x900",600,2,600,400,"False",997,197,346,149,149,0
"E05FJ",280,534,"1200x900",1000,1,600,400,"True",328,504,402,-102,102,1
"E05FJ",281,436,"1200x900",1000,0,600,400,"False",82,617,327,-290,290,1
"E05FJ",282,370,"1200x900",800,2,600,400,"True",874,336,333,-3,3,0
"E05FJ",283,284,"1200x900",800,0,600,400,"True",135,293,356,63,63,1
"E05FJ",284,181,"1200x900",600,2,600,400,"False",1018,223,354,131,131,0
"E05FJ",285,128,"1200x900",600,1,600,400,"True",661,258,263,5,5,1
"E05FJ",286,292,"1200x900",800,1,600,400,"False",88,565,349,-216,216,0
"E05FJ",287,643,"1200x900",1000,2,600,400,"True",740,325,328,3,3,0
"E05FJ",288,150,"1200x900",600,2,600,400,"True",897,345,336,-9,9,0
"E05FJ",289,66,"1200x900",600,0,600,400,"False",155,673,480,-193,193,0
"E05FJ",290,358,"1200x900",800,1,600,400,"False",263,635,423,-212,212,0
"E05FJ",291,130,"1200x900",600,1,600,400,"False",741,428,343,-85,85,0
"E05FJ",292,390,"1200x900",800,2,600,400,"False",982,674,411,-263,263,1
"E05FJ",293,46,"1200x900",600,0,600,400,"True",193,355,339,-16,16,1
"E05FJ",294,490,"1200x900",1000,0,600,400,"False",114,183,310,127,127,1
"E05FJ",295,447,"1200x900",1000,0,600,400,"True",71,339,333,-6,6,1
"E05FJ",297,648,"1200x900",1000,2,600,400,"False",557,394,283,-111,111,0
"E05FJ",298,319,"1200x900",800,1,600,400,"False",494,587,488,-99,99,1
"E05FJ",299,332,"1200x900",800,1,600,400,"False",260,699,587,-112,112,0
"E05FJ",300,457,"1200x900",1000,0,600,400,"False",97,630,457,-173,173,1
"E05FJ",301,21,"1200x900",600,0,600,400,"True",314,383,414,31,31,1
"E05FJ",302,280,"1200x900",800,0,600,400,"True",104,302,338,36,36,1
"E05FJ",303,474,"1200x900",1000,0,600,400,"True",85,339,302,-37,37,1
"E05FJ",304,366,"1200x900",800,2,600,400,"False",931,464,301,-163,163,0
"E05FJ",305,424,"1200x900",800,2,600,400,"False",903,545,358,-187,187,0
"E05FJ",306,9,"1200x900",600,0,600,400,"False",509,654,421,-233,233,1
"E05FJ",307,600,"1200x900",1000,2,600,400,"False",765,207,461,254,254,0
"E05FJ",308,126,"1200x900",600,1,600,400,"True",849,354,374,20,20,0
"E05FJ",309,463,"1200x900",1000,0,600,400,"False",115,693,453,-240,240,1
"E05FJ",310,315,"1200x900",800,1,600,400,"False",105,211,298,87,87,0
"E05FJ",311,545,"1200x900",1000,1,600,400,"False",358,562,400,-162,162,0
"E05FJ",312,64,"1200x900",600,0,600,400,"True",102,339,370,31,31,0
"E05FJ",313,642,"1200x900",1000,2,600,400,"False",776,316,396,80,80,0
"E05FJ",314,466,"1200x900",1000,0,600,400,"False",82,205,382,177,177,1
"E05FJ",315,414,"1200x900",800,2,600,400,"False",831,592,394,-198,198,0
"E05FJ",316,65,"1200x900",600,0,600,400,"False",442,645,475,-170,170,1
"E05FJ",317,419,"1200x900",800,2,600,400,"True",769,351,367,16,16,0
"E05FJ",318,580,"1200x900",1000,2,600,400,"True",651,267,291,24,24,0
"E05FJ",319,117,"1200x900",600,1,600,400,"False",711,456,273,-183,183,0
"E05FJ",320,193,"1200x900",600,2,600,400,"False",874,588,369,-219,219,0
"E05FJ",321,175,"1200x900",600,2,600,400,"True",1028,432,402,-30,30,0
"E05FJ",322,39,"1200x900",600,0,600,400,"False",210,609,413,-196,196,0
"E05FJ",323,483,"1200x900",1000,0,600,400,"False",93,191,400,209,209,1
"E05FJ",324,380,"1200x900",800,2,600,400,"False",942,228,341,113,113,0
"E05FJ",325,587,"1200x900",1000,2,600,400,"False",741,686,429,-257,257,0
"E05FJ",326,53,"1200x900",600,0,600,400,"False",177,189,358,169,169,0
"E05FJ",327,573,"1200x900",1000,1,600,400,"False",486,615,434,-181,181,0
"E05FJ",328,594,"1200x900",1000,2,600,400,"False",537,637,409,-228,228,0
"E05FJ",329,389,"1200x900",800,2,600,400,"False",843,530,434,-96,96,0
"E05FJ",330,155,"1200x900",600,2,600,400,"False",940,269,503,234,234,0
"E05FJ",331,273,"1200x900",800,0,600,400,"False",180,309,392,83,83,1
"E05FJ",332,633,"1200x900",1000,2,600,400,"False",564,253,338,85,85,0
"E05FJ",333,314,"1200x900",800,1,600,400,"False",277,616,489,-127,127,1
"E05FJ",334,557,"1200x900",1000,1,600,400,"False",677,505,620,115,115,1
"E05FJ",335,289,"1200x900",800,1,600,400,"True",421,703,647,-56,56,1
"E05FJ",336,270,"1200x900",800,0,600,400,"False",192,418,503,85,85,1
"E05FJ",337,567,"1200x900",1000,1,600,400,"True",655,297,275,-22,22,1
"E05FJ",338,473,"1200x900",1000,0,600,400,"True",75,323,319,-4,4,1
"E05FJ",339,216,"1200x900",600,2,600,400,"True",1029,286,323,37,37,0
"E05FJ",340,174,"1200x900",600,2,600,400,"False",998,457,330,-127,127,0
"E05FJ",341,472,"1200x900",1000,0,600,400,"False",77,685,379,-306,306,1
"E05FJ",342,76,"1200x900",600,1,600,400,"True",647,614,537,-77,77,0
"E05FJ",343,264,"1200x900",800,0,600,400,"False",198,660,397,-263,263,1
"E05FJ",344,321,"1200x900",800,1,600,400,"False",601,190,365,175,175,0
"E05FJ",345,606,"1200x900",1000,2,600,400,"False",653,627,380,-247,247,0
"E05FJ",346,25,"1200x900",600,0,600,400,"True",263,403,378,-25,25,1
"E05FJ",347,506,"1200x900",1000,1,600,400,"False",559,567,324,-243,243,1
"E05FJ",348,645,"1200x900",1000,2,600,400,"False",619,396,297,-99,99,0
"E05FJ",349,125,"1200x900",600,1,600,400,"False",750,531,343,-188,188,0
"E05FJ",350,446,"1200x900",1000,0,600,400,"True",72,298,357,59,59,1
"E05FJ",351,422,"1200x900",800,2,600,400,"False",712,558,377,-181,181,0
"E05FJ",352,385,"1200x900",800,2,600,400,"True",740,456,487,31,31,0
"E05FJ",353,627,"1200x900",1000,2,600,400,"True",760,510,491,-19,19,0
"E05FJ",354,476,"1200x900",1000,0,600,400,"False",76,359,432,73,73,1
"E05FJ",355,478,"1200x900",1000,0,600,400,"False",79,672,456,-216,216,1
"E05FJ",356,556,"1200x900",1000,1,600,400,"True",415,420,423,3,3,0
"E05FJ",357,52,"1200x900",600,0,600,400,"False",171,188,284,96,96,0
"E05FJ",358,305,"1200x900",800,1,600,400,"False",471,716,276,-440,440,0
"E05FJ",359,326,"1200x900",800,1,600,400,"True",103,482,476,-6,6,0
"E05FJ",360,288,"1200x900",800,0,600,400,"False",180,547,443,-104,104,1
"E05FJ",361,199,"1200x900",600,2,600,400,"True",992,467,413,-54,54,0
"E05FJ",362,356,"1200x900",800,1,600,400,"True",123,484,401,-83,83,0
"E05FJ",363,23,"1200x900",600,0,600,400,"True",308,463,395,-68,68,1
"E05FJ",364,459,"1200x900",1000,0,600,400,"False",70,645,452,-193,193,1
"E05FJ",365,431,"1200x900",800,2,600,400,"False",694,382,462,80,80,0
"E05FJ",366,110,"1200x900",600,1,600,400,"True",776,550,549,-1,1,1
"E05FJ",367,563,"1200x900",1000,1,600,400,"False",201,696,523,-173,173,0
"E05FJ",368,129,"1200x900",600,1,600,400,"True",859,482,510,28,28,1
"E05FJ",369,554,"1200x900",1000,1,600,400,"True",79,309,370,61,61,1
"E05FJ",370,626,"1200x900",1000,2,600,400,"False",329,449,368,-81,81,0
"E05FJ",371,38,"1200x900",600,0,600,400,"False",120,628,430,-198,198,1
"E05FJ",372,400,"1200x900",800,2,600,400,"True",733,297,379,82,82,0
"E05FJ",373,394,"1200x900",800,2,600,400,"False",847,292,416,124,124,0
"E05FJ",374,250,"1200x900",800,0,600,400,"False",290,248,411,163,163,1
"E05FJ",375,238,"1200x900",800,0,600,400,"True",162,283,307,24,24,1
"E05FJ",376,169,"1200x900",600,2,600,400,"True",924,290,335,45,45,0
"E05FJ",377,620,"1200x900",1000,2,600,400,"False",832,649,383,-266,266,0
"E05FJ",378,33,"1200x900",600,0,600,400,"True",198,533,467,-66,66,1
"E05FJ",379,333,"1200x900",800,1,600,400,"False",521,548,377,-171,171,0
"E05FJ",380,362,"1200x900",800,2,600,400,"False",819,338,451,113,113,0
"E05FJ",381,258,"1200x900",800,0,600,400,"False",126,664,447,-217,217,1
"E05FJ",382,41,"1200x900",600,0,600,400,"True",370,452,427,-25,25,1
"E05FJ",383,18,"1200x900",600,0,600,400,"True",400,318,323,5,5,1
"E05FJ",384,335,"1200x900",800,1,600,400,"False",124,360,492,132,132,0
"E05FJ",385,464,"1200x900",1000,0,600,400,"False",82,222,394,172,172,1
"E05FJ",386,116,"1200x900",600,1,600,400,"False",767,289,482,193,193,0
"E05FJ",387,324,"1200x900",800,1,600,400,"False",719,712,417,-295,295,1
"E05FJ",388,532,"1200x900",1000,1,600,400,"False",215,207,285,78,78,0
"E05FJ",389,569,"1200x900",1000,1,600,400,"False",494,720,336,-384,384,0
"E05FJ",390,541,"1200x900",1000,1,600,400,"True",339,478,434,-44,44,0
"E05FJ",391,467,"1200x900",1000,0,600,400,"False",74,712,444,-268,268,1
"E05FJ",392,357,"1200x900",800,1,600,400,"True",109,594,645,51,51,0
"E05FJ",393,325,"1200x900",800,1,600,400,"True",105,394,402,8,8,0
"E05FJ",394,465,"1200x900",1000,0,600,400,"False",85,203,391,188,188,1
"E05FJ",395,623,"1200x900",1000,2,600,400,"False",636,527,370,-157,157,0
"E05FJ",396,608,"1200x900",1000,2,600,400,"False",742,250,424,174,174,0
"E05FJ",397,426,"1200x900",800,2,600,400,"False",830,263,370,107,107,0
"E05FJ",398,215,"1200x900",600,2,600,400,"False",939,596,402,-194,194,0
"E05FJ",399,572,"1200x900",1000,1,600,400,"False",302,260,426,166,166,0
"E05FJ",400,461,"1200x900",1000,0,600,400,"False",95,711,382,-329,329,1
"E05FJ",401,302,"1200x900",800,1,600,400,"False",479,467,530,63,63,1
"E05FJ",402,105,"1200x900",600,1,600,400,"False",527,440,574,134,134,0
"E05FJ",403,526,"1200x900",1000,1,600,400,"False",497,710,461,-249,249,0
"E05FJ",404,565,"1200x900",1000,1,600,400,"True",451,562,503,-59,59,0
"E05FJ",405,295,"1200x900",800,1,600,400,"False",471,334,427,93,93,0
"E05FJ",406,624,"1200x900",1000,2,600,400,"False",693,501,367,-134,134,0
"E05FJ",407,274,"1200x900",800,0,600,400,"False",146,497,333,-164,164,1
"E05FJ",408,77,"1200x900",600,1,600,400,"False",780,525,366,-159,159,0
"E05FJ",409,397,"1200x900",800,2,600,400,"False",817,692,482,-210,210,0
"E05FJ",410,62,"1200x900",600,0,600,400,"True",345,346,355,9,9,1
"E05FJ",411,297,"1200x900",800,1,600,400,"True",625,244,273,29,29,0
"E05FJ",412,401,"1200x900",800,2,600,400,"True",821,260,340,80,80,0
"E05FJ",413,384,"1200x900",800,2,600,400,"False",821,707,499,-208,208,0
"E05FJ",414,133,"1200x900",600,1,600,400,"True",345,551,555,4,4,0
"E05FJ",415,479,"1200x900",1000,0,600,400,"False",74,705,406,-299,299,1
"E05FJ",416,245,"1200x900",800,0,600,400,"False",296,235,430,195,195,1
"E05FJ",417,70,"1200x900",600,0,600,400,"False",309,703,612,-91,91,1
"E05FJ",418,260,"1200x900",800,0,600,400,"False",103,525,424,-101,101,1
"E05FJ",419,369,"1200x900",800,2,600,400,"False",903,594,478,-116,116,0
"E05FJ",420,151,"1200x900",600,2,600,400,"False",828,680,523,-157,157,0
"E05FJ",421,104,"1200x900",600,1,600,400,"False",448,584,641,57,57,0
"E05FJ",422,530,"1200x900",1000,1,600,400,"True",584,405,426,21,21,1
"E05FJ",423,120,"1200x900",600,1,600,400,"True",690,655,583,-72,72,0
"E05FJ",424,410,"1200x900",800,2,600,400,"True",916,477,488,11,11,0
"E05FJ",425,499,"1200x900",1000,0,600,400,"False",93,271,539,268,268,1
"E05FJ",426,287,"1200x900",800,0,600,400,"False",120,567,363,-204,204,1
"E05FJ",427,549,"1200x900",1000,1,600,400,"False",657,366,438,72,72,0
"E05FJ",428,343,"1200x900",800,1,600,400,"False",407,557,366,-191,191,0
"E05FJ",429,347,"1200x900",800,1,600,400,"False",757,295,446,151,151,1
"E05FJ",430,327,"1200x900",800,1,600,400,"True",152,339,338,-1,1,0
"E05FJ",431,641,"1200x900",1000,2,600,400,"False",897,272,437,165,165,0
"E05FJ",432,317,"1200x900",800,1,600,400,"True",185,564,533,-31,31,0
"E05FJ",433,35,"1200x900",600,0,600,400,"True",366,555,584,29,29,1
"E05FJ",434,78,"1200x900",600,1,600,400,"True",885,684,611,-73,73,0
"E05FJ",435,543,"1200x900",1000,1,600,400,"False",88,202,622,420,420,0
"E05FJ",436,124,"1200x900",600,1,600,400,"True",345,467,506,39,39,0
"E05FJ",437,501,"1200x900",1000,0,600,400,"True",96,323,314,-9,9,1
"E05FJ",438,223,"1200x900",800,0,600,400,"True",179,191,180,-11,11,1
"E05FJ",439,10,"1200x900",600,0,600,400,"False",400,499,391,-108,108,1
"E05FJ",440,494,"1200x900",1000,0,600,400,"False",127,692,431,-261,261,1
"E05FJ",441,546,"1200x900",1000,1,600,400,"True",305,374,347,-27,27,0
"E05FJ",442,621,"1200x900",1000,2,600,400,"False",540,478,382,-96,96,0
"E05FJ",443,322,"1200x900",800,1,600,400,"False",703,206,375,169,169,1
"E05FJ",444,123,"1200x900",600,1,600,400,"True",761,365,377,12,12,1
"E05FJ",445,239,"1200x900",800,0,600,400,"False",114,231,305,74,74,1
"E05FJ",446,395,"1200x900",800,2,600,400,"False",743,334,264,-70,70,0
"E05FJ",447,415,"1200x900",800,2,600,400,"False",823,684,364,-320,320,0
"E05FJ",448,477,"1200x900",1000,0,600,400,"False",88,640,357,-283,283,1
"E05FJ",449,550,"1200x900",1000,1,600,400,"False",301,459,335,-124,124,0
"E05FJ",450,263,"1200x900",800,0,600,400,"True",82,396,405,9,9,1
"E05FJ",451,106,"1200x900",600,1,600,400,"False",803,659,410,-249,249,1
"E05FJ",452,462,"1200x900",1000,0,600,400,"False",102,672,380,-292,292,1
"E05FJ",453,619,"1200x900",1000,2,600,400,"False",803,247,467,220,220,0
"E05FJ",454,575,"1200x900",1000,1,600,400,"False",272,693,569,-124,124,0
"E05FJ",455,639,"1200x900",1000,2,600,400,"False",504,456,536,80,80,0
"E05FJ",456,225,"1200x900",800,0,600,400,"False",178,423,357,-66,66,1
"E05FJ",457,349,"1200x900",800,1,600,400,"False",402,665,511,-154,154,0
"E05FJ",458,221,"1200x900",800,0,600,400,"False",132,520,382,-138,138,1
"E05FJ",459,598,"1200x900",1000,2,600,400,"True",706,559,570,11,11,0
"E05FJ",460,257,"1200x900",800,0,600,400,"False",97,219,396,177,177,1
"E05FJ",461,166,"1200x900",600,2,600,400,"False",896,274,438,164,164,0
"E05FJ",462,184,"1200x900",600,2,600,400,"True",1067,441,480,39,39,0
"E05FJ",463,304,"1200x900",800,1,600,400,"False",667,605,318,-287,287,0
"E05FJ",464,253,"1200x900",800,0,600,400,"True",177,424,477,53,53,1
"E05FJ",465,454,"1200x900",1000,0,600,400,"False",78,687,454,-233,233,1
"E05FJ",466,511,"1200x900",1000,1,600,400,"True",408,390,389,-1,1,1
"E05FJ",467,363,"1200x900",800,2,600,400,"False",800,218,401,183,183,0
"E05FJ",468,262,"1200x900",800,0,600,400,"False",196,481,351,-130,130,1
"E05FJ",469,339,"1200x900",800,1,600,400,"True",273,545,594,49,49,1
"E05FJ",470,196,"1200x900",600,2,600,400,"False",1030,397,559,162,162,0
"E05FJ",471,121,"1200x900",600,1,600,400,"True",884,364,364,0,0,0
"E05FJ",472,156,"1200x900",600,2,600,400,"False",913,197,296,99,99,0
"E05FJ",473,237,"1200x900",800,0,600,400,"True",204,481,443,-38,38,1
"E05FJ",474,32,"1200x900",600,0,600,400,"False",152,563,307,-256,256,1
"E05FJ",475,45,"1200x900",600,0,600,400,"False",487,678,498,-180,180,1
"E05FJ",476,434,"1200x900",1000,0,600,400,"False",89,657,411,-246,246,1
"E05FJ",477,100,"1200x900",600,1,600,400,"False",453,511,415,-96,96,0
"E05FJ",478,131,"1200x900",600,1,600,400,"False",531,367,440,73,73,0
"E05FJ",479,398,"1200x900",800,2,600,400,"False",944,698,494,-204,204,0
"E05FJ",480,485,"1200x900",1000,0,600,400,"False",121,694,426,-268,268,1
"E05FJ",481,58,"1200x900",600,0,600,400,"False",353,655,518,-137,137,1
"E05FJ",482,417,"1200x900",800,2,600,400,"False",750,280,433,153,153,0
"E05FJ",483,392,"1200x900",800,2,600,400,"False",1031,618,333,-285,285,0
"E05FJ",485,115,"1200x900",600,1,600,400,"True",545,307,302,-5,5,0
"E05FJ",486,613,"1200x900",1000,2,600,400,"True",690,374,400,26,26,0
"E05FJ",487,162,"1200x900",600,2,600,400,"True",849,279,303,24,24,0
"E05FJ",488,336,"1200x900",800,1,600,400,"False",251,587,437,-150,150,0
"E05FJ",489,2,"1200x900",600,0,600,400,"True",159,323,314,-9,9,0
"E05FJ",490,152,"1200x900",600,2,600,400,"False",971,399,252,-147,147,0
"E05FJ",491,616,"1200x900",1000,2,600,400,"False",854,357,258,-99,99,1
"E05FJ",492,83,"1200x900",600,1,600,400,"False",763,568,361,-207,207,1
"E05FJ",493,157,"1200x900",600,2,600,400,"True",1016,323,274,-49,49,0
"E05FJ",494,96,"1200x900",600,1,600,400,"True",433,458,472,14,14,0
"E05FJ",495,47,"1200x900",600,0,600,400,"True",303,499,440,-59,59,1
"E05FJ",496,480,"1200x900",1000,0,600,400,"True",100,231,278,47,47,1
"E05FJ",497,197,"1200x900",600,2,600,400,"False",903,212,329,117,117,0
"E05FJ",498,229,"1200x900",800,0,600,400,"False",117,697,515,-182,182,1
"E05FJ",499,375,"1200x900",800,2,600,400,"True",716,384,383,-1,1,0
"E05FJ",500,1,"1200x900",600,0,600,400,"True",136,502,473,-29,29,0
"E05FJ",501,190,"1200x900",600,2,600,400,"False",977,238,414,176,176,0
"E05FJ",502,566,"1200x900",1000,1,600,400,"False",378,472,240,-232,232,1
"E05FJ",503,140,"1200x900",600,1,600,400,"True",700,523,479,-44,44,0
"E05FJ",504,236,"1200x900",800,0,600,400,"False",162,350,237,-113,113,1
"E05FJ",505,441,"1200x900",1000,0,600,400,"False",85,684,478,-206,206,1
"E05FJ",506,644,"1200x900",1000,2,600,400,"False",495,486,326,-160,160,0
"E05FJ",507,440,"1200x900",1000,0,600,400,"False",71,237,322,85,85,1
"E05FJ",508,37,"1200x900",600,0,600,400,"False",258,403,336,-67,67,1
"E05FJ",509,86,"1200x900",600,1,600,400,"True",692,388,327,-61,61,1
"E05FJ",510,36,"1200x900",600,0,600,400,"False",128,346,277,-69,69,1
"E05FJ",511,143,"1200x900",600,1,600,400,"True",479,284,270,-14,14,1
"E05FJ",512,147,"1200x900",600,2,600,400,"False",942,418,309,-109,109,0
"E05FJ",513,496,"1200x900",1000,0,600,400,"False",70,639,416,-223,223,1
"E05FJ",514,471,"1200x900",1000,0,600,400,"True",122,200,209,9,9,1
"E05FJ",515,153,"1200x900",600,2,600,400,"False",1037,601,262,-339,339,0
"E05FJ",516,203,"1200x900",600,2,600,400,"False",938,603,413,-190,190,0
"E05FJ",517,527,"1200x900",1000,1,600,400,"False",565,601,336,-265,265,0
"E05FJ",518,224,"1200x900",800,0,600,400,"False",161,474,398,-76,76,1
"E05FJ",519,591,"1200x900",1000,2,600,400,"True",698,336,370,34,34,0
"E05FJ",520,636,"1200x900",1000,2,600,400,"False",575,583,491,-92,92,0
"E05FJ",522,230,"1200x900",800,0,600,400,"False",99,678,571,-107,107,1
"E05FJ",523,391,"1200x900",800,2,600,400,"True",895,521,469,-52,52,0
"E05FJ",524,234,"1200x900",800,0,600,400,"True",72,344,405,61,61,1
"E05FJ",525,50,"1200x900",600,0,600,400,"False",75,582,504,-78,78,0
"E05FJ",527,310,"1200x900",800,1,600,400,"False",559,592,457,-135,135,0
"E05FJ",528,361,"1200x900",800,2,600,400,"True",931,328,405,77,77,0
"E05FJ",529,497,"1200x900",1000,0,600,400,"False",106,696,552,-144,144,1
"E05FJ",530,406,"1200x900",800,2,600,400,"False",971,233,438,205,205,0
"E05FJ",531,208,"1200x900",600,2,600,400,"False",946,399,503,104,104,0
"E05FJ",532,135,"1200x900",600,1,600,400,"False",759,569,391,-178,178,0
"E05FJ",533,552,"1200x900",1000,1,600,400,"False",255,412,602,190,190,0
"E05FJ",534,519,"1200x900",1000,1,600,400,"False",319,565,645,80,80,1
"E05FJ",535,159,"1200x900",600,2,600,400,"False",992,309,592,283,283,0
"E05FJ",536,344,"1200x900",800,1,600,400,"True",589,408,369,-39,39,0
"E05FJ",537,3,"1200x900",600,0,600,400,"False",298,443,368,-75,75,1
"E05FJ",538,48,"1200x900",600,0,600,400,"False",323,645,469,-176,176,1
"E05FJ",539,481,"1200x900",1000,0,600,400,"False",80,185,328,143,143,1
"E05FJ",540,312,"1200x900",800,1,600,400,"False",238,683,540,-143,143,0
"E05FJ",541,34,"1200x900",600,0,600,400,"True",361,242,298,56,56,1
"E05FJ",542,396,"1200x900",800,2,600,400,"False",678,663,466,-197,197,0
"E05FJ",543,108,"1200x900",600,1,600,400,"False",830,239,348,109,109,0
"E05FJ",544,12,"1200x900",600,0,600,400,"True",365,336,288,-48,48,1
"E05FJ",545,268,"1200x900",800,0,600,400,"True",148,400,336,-64,64,1
"E05FJ",546,179,"1200x900",600,2,600,400,"False",908,602,427,-175,175,0
"E05FJ",547,617,"1200x900",1000,2,600,400,"False",294,180,278,98,98,0
"E05FJ",548,412,"1200x900",800,2,600,400,"True",842,280,259,-21,21,0
"E05FJ",549,134,"1200x900",600,1,600,400,"False",300,188,318,130,130,0
"E05FJ",550,16,"1200x900",600,0,600,400,"False",297,514,352,-162,162,1
"E05FJ",551,574,"1200x900",1000,1,600,400,"False",614,194,373,179,179,0
"E05FJ",552,592,"1200x900",1000,2,600,400,"True",492,392,331,-61,61,0
"E05FJ",553,57,"1200x900",600,0,600,400,"False",354,508,337,-171,171,1
"E05FJ",554,535,"1200x900",1000,1,600,400,"True",372,410,380,-30,30,0
"E05FJ",555,628,"1200x900",1000,2,600,400,"True",768,410,361,-49,49,0
"E05FJ",556,560,"1200x900",1000,1,600,400,"False",516,693,345,-348,348,0
"E05FJ",557,102,"1200x900",600,1,600,400,"False",861,603,343,-260,260,0
"E05FJ",558,515,"1200x900",1000,1,600,400,"True",307,217,281,64,64,0
"E05FJ",559,82,"1200x900",600,1,600,400,"False",108,213,354,141,141,0
"E05FJ",560,348,"1200x900",800,1,600,400,"True",764,294,299,5,5,0
"E05FJ",561,231,"1200x900",800,0,600,400,"False",251,718,442,-276,276,1
"E05FJ",562,364,"1200x900",800,2,600,400,"False",1018,204,483,279,279,0
"E05FJ",563,31,"1200x900",600,0,600,400,"True",365,338,343,5,5,1
"E05FJ",564,299,"1200x900",800,1,600,400,"False",779,274,535,261,261,0
"E05FJ",565,601,"1200x900",1000,2,600,400,"False",735,697,401,-296,296,0
"E05FJ",566,602,"1200x900",1000,2,600,400,"True",865,452,497,45,45,0
"E05FJ",567,345,"1200x900",800,1,600,400,"True",841,566,577,11,11,1
"E05FJ",568,306,"1200x900",800,1,600,400,"True",164,524,531,7,7,0
"E05FJ",569,355,"1200x900",800,1,600,400,"False",77,386,621,235,235,0
"E05FJ",570,293,"1200x900",800,1,600,400,"False",561,396,482,86,86,0
"E05FJ",571,378,"1200x900",800,2,600,400,"False",1018,708,424,-284,284,0
"E05FJ",572,4,"1200x900",600,0,600,400,"False",602,200,355,155,155,1
"E05FJ",573,63,"1200x900",600,0,600,400,"True",311,188,241,53,53,1
"E05FJ",574,433,"1200x900",1000,0,600,400,"True",76,222,231,9,9,1
"E05FJ",575,452,"1200x900",1000,0,600,400,"True",97,273,226,-47,47,1
"E05FJ",576,226,"1200x900",800,0,600,400,"True",187,229,268,39,39,1
"E05FJ",577,605,"1200x900",1000,2,600,400,"False",493,665,352,-313,313,0
"E05FJ",578,139,"1200x900",600,1,600,400,"False",192,695,526,-169,169,0
"E05FJ",579,402,"1200x900",800,2,600,400,"False",878,234,440,206,206,0
"E05FJ",580,493,"1200x900",1000,0,600,400,"False",80,582,319,-263,263,1
"E05FJ",581,615,"1200x900",1000,2,600,400,"False",736,634,471,-163,163,0
"E05FJ",582,313,"1200x900",800,1,600,400,"True",588,421,449,28,28,0
"E05FJ",584,22,"1200x900",600,0,600,400,"True",398,591,573,-18,18,1
"E05FJ",585,340,"1200x900",800,1,600,400,"False",226,240,683,443,443,0
"E05FJ",586,585,"1200x900",1000,2,600,400,"False",698,688,570,-118,118,1
"E05FJ",587,491,"1200x900",1000,0,600,400,"False",108,198,330,132,132,1
"E05FJ",588,192,"1200x900",600,2,600,400,"False",1064,320,619,299,299,0
"E05FJ",589,113,"1200x900",600,1,600,400,"False",897,657,461,-196,196,0
"E05FJ",590,634,"1200x900",1000,2,600,400,"False",735,313,536,223,223,0
"E05FJ",591,540,"1200x900",1000,1,600,400,"False",389,568,454,-114,114,1
"E05FJ",592,107,"1200x900",600,1,600,400,"False",878,678,492,-186,186,0
"E05FJ",593,521,"1200x900",1000,1,600,400,"True",111,303,352,49,49,1
"E05FJ",594,570,"1200x900",1000,1,600,400,"True",315,352,319,-33,33,0
"E05FJ",595,564,"1200x900",1000,1,600,400,"True",215,264,270,6,6,0
"E05FJ",596,210,"1200x900",600,2,600,400,"False",835,506,353,-153,153,0
"E05FJ",597,525,"1200x900",1000,1,600,400,"False",123,690,321,-369,369,0
"E05FJ",598,43,"1200x900",600,0,600,400,"False",277,446,382,-64,64,1
"E05FJ",599,408,"1200x900",800,2,600,400,"False",758,567,414,-153,153,0
"E05FJ",600,388,"1200x900",800,2,600,400,"False",930,320,484,164,164,0
"E05FJ",601,277,"1200x900",800,0,600,400,"True",140,310,314,4,4,1
"E05FJ",602,122,"1200x900",600,1,600,400,"False",817,709,389,-320,320,0
"E05FJ",603,596,"1200x900",1000,2,600,400,"True",706,513,535,22,22,0
"E05FJ",604,81,"1200x900",600,1,600,400,"True",696,225,240,15,15,0
"E05FJ",605,551,"1200x900",1000,1,600,400,"False",146,445,348,-97,97,1
"E05FJ",606,562,"1200x900",1000,1,600,400,"False",347,540,409,-131,131,0
"E05FJ",607,399,"1200x900",800,2,600,400,"False",603,602,512,-90,90,0
"E05FJ",608,242,"1200x900",800,0,600,400,"False",117,448,373,-75,75,1
"E05FJ",609,350,"1200x900",800,1,600,400,"False",182,566,371,-195,195,0
"E05FJ",610,79,"1200x900",600,1,600,400,"False",731,289,360,71,71,0
"E05FJ",611,7,"1200x900",600,0,600,400,"False",431,654,483,-171,171,1
"E05FJ",612,442,"1200x900",1000,0,600,400,"True",87,183,230,47,47,1
"E05FJ",613,528,"1200x900",1000,1,600,400,"False",839,227,487,260,260,1
"E05FJ",614,427,"1200x900",800,2,600,400,"True",812,380,369,-11,11,0
"E05FJ",615,87,"1200x900",600,1,600,400,"False",231,604,469,-135,135,0
"E05FJ",616,625,"1200x900",1000,2,600,400,"False",279,228,371,143,143,0
"E05FJ",617,88,"1200x900",600,1,600,400,"False",186,554,458,-96,96,0
"E05FJ",618,553,"1200x900",1000,1,600,400,"False",116,712,400,-312,312,0
"E05FJ",619,509,"1200x900",1000,1,600,400,"True",509,434,486,52,52,0
"E05FJ",620,588,"1200x900",1000,2,600,400,"True",585,350,411,61,61,0
"E05FJ",621,282,"1200x900",800,0,600,400,"True",109,246,308,62,62,1
"E05FJ",622,281,"1200x900",800,0,600,400,"True",112,611,558,-53,53,1
"E05FJ",623,318,"1200x900",800,1,600,400,"True",788,534,536,2,2,0
"E05FJ",624,72,"1200x900",600,0,600,400,"False",158,537,455,-82,82,0
"E05FJ",625,374,"1200x900",800,2,600,400,"True",755,450,506,56,56,0
"E05FJ",626,160,"1200x900",600,2,600,400,"False",863,606,476,-130,130,0
"E05FJ",627,222,"1200x900",800,0,600,400,"False",152,206,353,147,147,1
"E05FJ",628,109,"1200x900",600,1,600,400,"False",691,589,411,-178,178,0
"E05FJ",629,516,"1200x900",1000,1,600,400,"False",440,559,439,-120,120,0
"E05FJ",630,638,"1200x900",1000,2,600,400,"False",385,198,320,122,122,0
"E05FJ",631,165,"1200x900",600,2,600,400,"False",912,554,455,-99,99,0
"E05FJ",632,435,"1200x900",1000,0,600,400,"False",119,200,308,108,108,1
"E05FJ",633,329,"1200x900",800,1,600,400,"False",517,239,328,89,89,0
"E05FJ",634,622,"1200x900",1000,2,600,400,"False",307,683,346,-337,337,0
"E05FJ",635,352,"1200x900",800,1,600,400,"False",235,717,501,-216,216,0
"E05FJ",636,458,"1200x900",1000,0,600,400,"False",78,624,422,-202,202,1
"E05FJ",637,172,"1200x900",600,2,600,400,"True",912,444,439,-5,5,0
"E05FJ",638,430,"1200x900",800,2,600,400,"False",922,254,396,142,142,0
"E05FJ",639,482,"1200x900",1000,0,600,400,"False",79,686,424,-262,262,1
"E05FJ",640,56,"1200x900",600,0,600,400,"True",148,491,505,14,14,0
"E05FJ",641,365,"1200x900",800,2,600,400,"False",1055,305,492,187,187,0
"E05FJ",642,200,"1200x900",600,2,600,400,"False",897,302,453,151,151,0
"E05FJ",643,207,"1200x900",600,2,600,400,"False",838,235,347,112,112,0
"E05FJ",644,272,"1200x900",800,0,600,400,"False",200,181,315,134,134,1
"E05FJ",645,618,"1200x900",1000,2,600,400,"False",276,671,483,-188,188,0
"E05FJ",646,529,"1200x900",1000,1,600,400,"True",267,412,359,-53,53,1
"E05FJ",647,405,"1200x900",800,2,600,400,"False",790,307,504,197,197,0
"E05FJ",648,164,"1200x900",600,2,600,400,"True",1051,268,318,50,50,0
"E06BN",1,61,"1200x900",600,0,600,400,"False",272,670,488,-182,182,1
"E06BN",2,513,"1200x900",1000,1,600,400,"False",235,602,288,-314,314,0
"E06BN",3,54,"1200x900",600,0,600,400,"False",474,564,651,87,87,1
"E06BN",4,147,"1200x900",600,2,600,400,"False",942,418,305,-113,113,0
"E06BN",5,435,"1200x900",1000,0,600,400,"True",119,200,226,26,26,1
"E06BN",6,327,"1200x900",800,1,600,400,"False",152,339,236,-103,103,0
"E06BN",7,499,"1200x900",1000,0,600,400,"False",93,271,404,133,133,1
"E06BN",8,15,"1200x900",600,0,600,400,"True",473,352,344,-8,8,1
"E06BN",9,405,"1200x900",800,2,600,400,"True",790,307,358,51,51,0
"E06BN",10,589,"1200x900",1000,2,600,400,"False",856,418,268,-150,150,0
"E06BN",11,91,"1200x900",600,1,600,400,"True",417,630,617,-13,13,1
"E06BN",12,493,"1200x900",1000,0,600,400,"True",80,582,581,-1,1,1
"E06BN",13,593,"1200x900",1000,2,600,400,"False",246,719,392,-327,327,0
"E06BN",14,260,"1200x900",800,0,600,400,"False",103,525,405,-120,120,1
"E06BN",15,368,"1200x900",800,2,600,400,"False",778,515,612,97,97,0
"E06BN",16,116,"1200x900",600,1,600,400,"False",767,289,225,-64,64,0
"E06BN",17,385,"1200x900",800,2,600,400,"False",740,456,293,-163,163,0
"E06BN",18,360,"1200x900",800,1,600,400,"False",203,608,666,58,58,0
"E06BN",19,393,"1200x900",800,2,600,400,"False",657,620,375,-245,245,0
"E06BN",20,312,"1200x900",800,1,600,400,"False",238,683,525,-158,158,0
"E06BN",21,420,"1200x900",800,2,600,400,"False",519,223,372,149,149,0
"E06BN",22,40,"1200x900",600,0,600,400,"False",143,513,391,-122,122,0
"E06BN",23,437,"1200x900",1000,0,600,400,"True",74,667,636,-31,31,1
"E06BN",24,41,"1200x900",600,0,600,400,"True",370,452,496,44,44,1
"E06BN",25,399,"1200x900",800,2,600,400,"False",603,602,445,-157,157,0
"E06BN",26,426,"1200x900",800,2,600,400,"True",830,263,312,49,49,0
"E06BN",27,321,"1200x900",800,1,600,400,"False",601,190,464,274,274,0
"E06BN",28,145,"1200x900",600,2,600,400,"False",1004,630,446,-184,184,0
"E06BN",29,333,"1200x900",800,1,600,400,"False",521,548,423,-125,125,0
"E06BN",30,151,"1200x900",600,2,600,400,"True",828,680,659,-21,21,0
"E06BN",31,423,"1200x900",800,2,600,400,"True",1051,710,637,-73,73,1
"E06BN",32,16,"1200x900",600,0,600,400,"True",297,514,543,29,29,1
"E06BN",33,185,"1200x900",600,2,600,400,"False",907,212,492,280,280,0
"E06BN",34,290,"1200x900",800,1,600,400,"False",789,603,404,-199,199,0
"E06BN",35,472,"1200x900",1000,0,600,400,"False",77,685,604,-81,81,1
"E06BN",36,257,"1200x900",800,0,600,400,"False",97,219,355,136,136,1
"E06BN",37,522,"1200x900",1000,1,600,400,"False",223,379,668,289,289,0
"E06BN",38,568,"1200x900",1000,1,600,400,"False",286,475,558,83,83,1
"E06BN",39,68,"1200x900",600,0,600,400,"True",165,367,333,-34,34,0
"E06BN",40,79,"1200x900",600,1,600,400,"True",731,289,334,45,45,0
"E06BN",41,519,"1200x900",1000,1,600,400,"False",319,565,446,-119,119,1
"E06BN",42,128,"1200x900",600,1,600,400,"True",661,258,339,81,81,1
"E06BN",43,32,"1200x900",600,0,600,400,"False",152,563,463,-100,100,1
"E06BN",44,364,"1200x900",800,2,600,400,"False",1018,204,577,373,373,0
"E06BN",45,482,"1200x900",1000,0,600,400,"False",79,686,568,-118,118,1
"E06BN",46,614,"1200x900",1000,2,600,400,"False",823,563,384,-179,179,0
"E06BN",47,190,"1200x900",600,2,600,400,"True",977,238,214,-24,24,0
"E06BN",48,608,"1200x900",1000,2,600,400,"False",742,250,385,135,135,0
"E06BN",49,580,"1200x900",1000,2,600,400,"False",651,267,383,116,116,0
"E06BN",50,400,"1200x900",800,2,600,400,"True",733,297,297,0,0,0
"E06BN",51,49,"1200x900",600,0,600,400,"True",109,380,373,-7,7,0
"E06BN",52,45,"1200x900",600,0,600,400,"False",487,678,540,-138,138,1
"E06BN",53,277,"1200x900",800,0,600,400,"False",140,310,449,139,139,1
"E06BN",54,69,"1200x900",600,0,600,400,"True",322,268,294,26,26,0
"E06BN",55,107,"1200x900",600,1,600,400,"False",878,678,594,-84,84,0
"E06BN",56,311,"1200x900",800,1,600,400,"False",710,261,640,379,379,0
"E06BN",57,227,"1200x900",800,0,600,400,"True",196,551,569,18,18,1
"E06BN",58,238,"1200x900",800,0,600,400,"True",162,283,239,-44,44,1
"E06BN",59,460,"1200x900",1000,0,600,400,"True",155,189,164,-25,25,1
"E06BN",60,552,"1200x900",1000,1,600,400,"False",255,412,594,182,182,0
"E06BN",61,272,"1200x900",800,0,600,400,"False",200,181,407,226,226,1
"E06BN",62,629,"1200x900",1000,2,600,400,"False",681,257,598,341,341,0
"E06BN",63,2,"1200x900",600,0,600,400,"False",159,323,404,81,81,0
"E06BN",64,586,"1200x900",1000,2,600,400,"False",802,262,435,173,173,0
"E06BN",65,201,"1200x900",600,2,600,400,"False",1005,462,363,-99,99,0
"E06BN",66,631,"1200x900",1000,2,600,400,"False",699,479,638,159,159,0
"E06BN",67,369,"1200x900",800,2,600,400,"False",903,594,721,127,127,0
"E06BN",68,164,"1200x900",600,2,600,400,"True",1051,268,291,23,23,0
"E06BN",69,379,"1200x900",800,2,600,400,"False",994,325,612,287,287,0
"E06BN",70,439,"1200x900",1000,0,600,400,"False",110,229,429,200,200,1
"E06BN",71,222,"1200x900",800,0,600,400,"False",152,206,343,137,137,1
"E06BN",72,480,"1200x900",1000,0,600,400,"True",100,231,204,-27,27,1
"E06BN",73,224,"1200x900",800,0,600,400,"True",161,474,408,-66,66,1
"E06BN",74,347,"1200x900",800,1,600,400,"False",757,295,664,369,369,1
"E06BN",75,338,"1200x900",800,1,600,400,"False",813,253,455,202,202,1
"E06BN",76,606,"1200x900",1000,2,600,400,"False",653,627,443,-184,184,0
"E06BN",77,267,"1200x900",800,0,600,400,"True",145,665,617,-48,48,1
"E06BN",78,74,"1200x900",600,1,600,400,"False",115,358,264,-94,94,0
"E06BN",79,506,"1200x900",1000,1,600,400,"False",559,567,420,-147,147,1
"E06BN",80,22,"1200x900",600,0,600,400,"True",398,591,561,-30,30,1
"E06BN",81,492,"1200x900",1000,0,600,400,"False",76,692,532,-160,160,1
"E06BN",82,271,"1200x900",800,0,600,400,"True",74,360,415,55,55,1
"E06BN",83,26,"1200x900",600,0,600,400,"False",70,712,581,-131,131,0
"E06BN",84,529,"1200x900",1000,1,600,400,"False",267,412,339,-73,73,1
"E06BN",85,135,"1200x900",600,1,600,400,"False",759,569,431,-138,138,0
"E06BN",86,166,"1200x900",600,2,600,400,"True",896,274,311,37,37,0
"E06BN",87,523,"1200x900",1000,1,600,400,"True",339,318,277,-41,41,0
"E06BN",88,133,"1200x900",600,1,600,400,"False",345,551,621,70,70,0
"E06BN",89,159,"1200x900",600,2,600,400,"True",992,309,322,13,13,0
"E06BN",90,340,"1200x900",800,1,600,400,"False",226,240,410,170,170,0
"E06BN",91,124,"1200x900",600,1,600,400,"True",345,467,438,-29,29,0
"E06BN",92,481,"1200x900",1000,0,600,400,"False",80,185,266,81,81,1
"E06BN",93,64,"1200x900",600,0,600,400,"False",102,339,170,-169,169,0
"E06BN",94,70,"1200x900",600,0,600,400,"True",309,703,666,-37,37,1
"E06BN",95,254,"1200x900",800,0,600,400,"True",136,583,604,21,21,1
"E06BN",96,226,"1200x900",800,0,600,400,"False",187,229,321,92,92,1
"E06BN",97,456,"1200x900",1000,0,600,400,"False",91,257,150,-107,107,1
"E06BN",98,408,"1200x900",800,2,600,400,"False",758,567,429,-138,138,0
"E06BN",99,105,"1200x900",600,1,600,400,"False",527,440,767,327,327,0
"E06BN",100,235,"1200x900",800,0,600,400,"False",146,646,526,-120,120,1
"E06BN",101,483,"1200x900",1000,0,600,400,"True",93,191,124,-67,67,1
"E06BN",102,101,"1200x900",600,1,600,400,"False",541,656,281,-375,375,0
"E06BN",103,186,"1200x900",600,2,600,400,"False",997,197,338,141,141,0
"E06BN",104,278,"1200x900",800,0,600,400,"True",251,711,697,-14,14,1
"E06BN",105,295,"1200x900",800,1,600,400,"True",471,334,388,54,54,0
"E06BN",106,540,"1200x900",1000,1,600,400,"False",389,568,271,-297,297,1
"E06BN",107,634,"1200x900",1000,2,600,400,"False",735,313,503,190,190,0
"E06BN",108,639,"1200x900",1000,2,600,400,"False",504,456,315,-141,141,0
"E06BN",109,390,"1200x900",800,2,600,400,"False",982,674,733,59,59,1
"E06BN",110,299,"1200x900",800,1,600,400,"False",779,274,649,375,375,0
"E06BN",111,504,"1200x900",1000,0,600,400,"True",107,699,747,48,48,1
"E06BN",112,381,"1200x900",800,2,600,400,"False",705,408,720,312,312,0
"E06BN",113,502,"1200x900",1000,0,600,400,"True",111,639,659,20,20,1
"E06BN",114,532,"1200x900",1000,1,600,400,"False",215,207,693,486,486,0
"E06BN",115,179,"1200x900",600,2,600,400,"True",908,602,533,-69,69,0
"E06BN",116,132,"1200x900",600,1,600,400,"True",333,185,133,-52,52,0
"E06BN",117,219,"1200x900",800,0,600,400,"False",202,502,316,-186,186,1
"E06BN",118,578,"1200x900",1000,2,600,400,"False",966,276,411,135,135,0
"E06BN",119,550,"1200x900",1000,1,600,400,"False",301,459,611,152,152,0
"E06BN",120,80,"1200x900",600,1,600,400,"False",616,423,495,72,72,1
"E06BN",121,526,"1200x900",1000,1,600,400,"False",497,710,483,-227,227,0
"E06BN",122,251,"1200x900",800,0,600,400,"True",88,352,388,36,36,1
"E06BN",123,6,"1200x900",600,0,600,400,"False",217,689,596,-93,93,1
"E06BN",124,276,"1200x900",800,0,600,400,"True",281,217,280,63,63,1
"E06BN",126,37,"1200x900",600,0,600,400,"True",258,403,411,8,8,1
"E06BN",127,574,"1200x900",1000,1,600,400,"False",614,194,312,118,118,0
"E06BN",128,73,"1200x900",600,1,600,400,"False",94,665,774,109,109,0
"E06BN",129,587,"1200x900",1000,2,600,400,"False",741,686,528,-158,158,0
"E06BN",130,560,"1200x900",1000,1,600,400,"True",516,693,765,72,72,0
"E06BN",131,314,"1200x900",800,1,600,400,"False",277,616,348,-268,268,1
"E06BN",132,76,"1200x900",600,1,600,400,"False",647,614,422,-192,192,0
"E06BN",133,243,"1200x900",800,0,600,400,"True",114,332,356,24,24,1
"E06BN",134,398,"1200x900",800,2,600,400,"False",944,698,552,-146,146,0
"E06BN",135,163,"1200x900",600,2,600,400,"False",1046,665,799,134,134,0
"E06BN",136,454,"1200x900",1000,0,600,400,"True",78,687,714,27,27,1
"E06BN",137,245,"1200x900",800,0,600,400,"False",296,235,322,87,87,1
"E06BN",138,283,"1200x900",800,0,600,400,"True",90,264,268,4,4,1
"E06BN",139,510,"1200x900",1000,1,600,400,"False",486,338,266,-72,72,1
"E06BN",140,88,"1200x900",600,1,600,400,"False",186,554,291,-263,263,0
"E06BN",141,117,"1200x900",600,1,600,400,"True",711,456,491,35,35,0
"E06BN",142,351,"1200x900",800,1,600,400,"False",122,581,423,-158,158,0
"E06BN",143,157,"1200x900",600,2,600,400,"False",1016,323,477,154,154,0
"E06BN",144,300,"1200x900",800,1,600,400,"True",620,693,677,-16,16,0
"E06BN",145,334,"1200x900",800,1,600,400,"True",481,665,648,-17,17,0
"E06BN",146,218,"1200x900",800,0,600,400,"False",106,397,489,92,92,1
"E06BN",147,231,"1200x900",800,0,600,400,"True",251,718,695,-23,23,1
"E06BN",148,404,"1200x900",800,2,600,400,"False",842,396,690,294,294,0
"E06BN",149,234,"1200x900",800,0,600,400,"True",72,344,398,54,54,1
"E06BN",150,478,"1200x900",1000,0,600,400,"True",79,672,653,-19,19,1
"E06BN",151,446,"1200x900",1000,0,600,400,"False",72,298,365,67,67,1
"E06BN",152,419,"1200x900",800,2,600,400,"True",769,351,364,13,13,0
"E06BN",153,95,"1200x900",600,1,600,400,"False",749,425,192,-233,233,1
"E06BN",154,34,"1200x900",600,0,600,400,"True",361,242,227,-15,15,1
"E06BN",155,620,"1200x900",1000,2,600,400,"False",832,649,285,-364,364,0
"E06BN",156,563,"1200x900",1000,1,600,400,"False",201,696,600,-96,96,0
"E06BN",157,553,"1200x900",1000,1,600,400,"False",116,712,321,-391,391,0
"E06BN",158,561,"1200x900",1000,1,600,400,"True",231,406,309,-97,97,0
"E06BN",159,288,"1200x900",800,0,600,400,"False",180,547,653,106,106,1
"E06BN",160,174,"1200x900",600,2,600,400,"False",998,457,587,130,130,0
"E06BN",161,565,"1200x900",1000,1,600,400,"True",451,562,536,-26,26,0
"E06BN",162,220,"1200x900",800,0,600,400,"True",108,699,656,-43,43,1
"E06BN",163,112,"1200x900",600,1,600,400,"False",681,490,338,-152,152,0
"E06BN",164,432,"1200x900",800,2,600,400,"True",792,380,444,64,64,0
"E06BN",165,386,"1200x900",800,2,600,400,"True",774,301,359,58,58,0
"E06BN",166,337,"1200x900",800,1,600,400,"True",299,622,535,-87,87,0
"E06BN",167,365,"1200x900",800,2,600,400,"False",1055,305,669,364,364,0
"E06BN",168,344,"1200x900",800,1,600,400,"False",589,408,499,91,91,0
"E06BN",169,349,"1200x900",800,1,600,400,"False",402,665,442,-223,223,0
"E06BN",170,309,"1200x900",800,1,600,400,"False",186,225,626,401,401,0
"E06BN",171,286,"1200x900",800,0,600,400,"True",105,378,406,28,28,1
"E06BN",172,424,"1200x900",800,2,600,400,"False",903,545,408,-137,137,0
"E06BN",174,169,"1200x900",600,2,600,400,"False",924,290,561,271,271,0
"E06BN",175,412,"1200x900",800,2,600,400,"False",842,280,374,94,94,0
"E06BN",176,134,"1200x900",600,1,600,400,"False",300,188,87,-101,101,0
"E06BN",177,263,"1200x900",800,0,600,400,"False",82,396,308,-88,88,1
"E06BN",178,567,"1200x900",1000,1,600,400,"False",655,297,192,-105,105,1
"E06BN",179,342,"1200x900",800,1,600,400,"True",677,204,138,-66,66,0
"E06BN",180,115,"1200x900",600,1,600,400,"False",545,307,127,-180,180,0
"E06BN",181,354,"1200x900",800,1,600,400,"False",118,236,446,210,210,0
"E06BN",182,601,"1200x900",1000,2,600,400,"False",735,697,392,-305,305,0
"E06BN",183,401,"1200x900",800,2,600,400,"False",821,260,391,131,131,0
"E06BN",184,249,"1200x900",800,0,600,400,"True",126,306,342,36,36,1
"E06BN",185,223,"1200x900",800,0,600,400,"True",179,191,213,22,22,1
"E06BN",186,566,"1200x900",1000,1,600,400,"True",378,472,464,-8,8,1
"E06BN",187,13,"1200x900",600,0,600,400,"False",296,211,366,155,155,1
"E06BN",188,215,"1200x900",600,2,600,400,"False",939,596,363,-233,233,0
"E06BN",189,498,"1200x900",1000,0,600,400,"True",100,260,303,43,43,1
"E06BN",190,48,"1200x900",600,0,600,400,"False",323,645,568,-77,77,1
"E06BN",191,273,"1200x900",800,0,600,400,"False",180,309,407,98,98,1
"E06BN",192,239,"1200x900",800,0,600,400,"False",114,231,325,94,94,1
"E06BN",193,421,"1200x900",800,2,600,400,"True",898,394,467,73,73,0
"E06BN",194,375,"1200x900",800,2,600,400,"False",716,384,474,90,90,0
"E06BN",195,392,"1200x900",800,2,600,400,"True",1031,618,586,-32,32,0
"E06BN",196,136,"1200x900",600,1,600,400,"True",264,205,249,44,44,0
"E06BN",197,471,"1200x900",1000,0,600,400,"True",122,200,219,19,19,1
"E06BN",198,3,"1200x900",600,0,600,400,"True",298,443,386,-57,57,1
"E06BN",199,46,"1200x900",600,0,600,400,"True",193,355,368,13,13,1
"E06BN",200,307,"1200x900",800,1,600,400,"False",716,247,349,102,102,0
"E06BN",201,75,"1200x900",600,1,600,400,"True",635,558,523,-35,35,0
"E06BN",202,285,"1200x900",800,0,600,400,"True",237,396,359,-37,37,1
"E06BN",203,92,"1200x900",600,1,600,400,"True",624,605,593,-12,12,0
"E06BN",204,391,"1200x900",800,2,600,400,"True",895,521,517,-4,4,0
"E06BN",205,9,"1200x900",600,0,600,400,"False",509,654,594,-60,60,1
"E06BN",206,237,"1200x900",800,0,600,400,"True",204,481,547,66,66,1
"E06BN",207,296,"1200x900",800,1,600,400,"False",89,279,364,85,85,0
"E06BN",209,25,"1200x900",600,0,600,400,"True",263,403,405,2,2,1
"E06BN",210,168,"1200x900",600,2,600,400,"True",1001,439,401,-38,38,0
"E06BN",211,605,"1200x900",1000,2,600,400,"False",493,665,489,-176,176,0
"E06BN",212,330,"1200x900",800,1,600,400,"False",759,301,150,-151,151,1
"E06BN",213,12,"1200x900",600,0,600,400,"True",365,336,332,-4,4,1
"E06BN",214,609,"1200x900",1000,2,600,400,"False",697,627,417,-210,210,0
"E06BN",215,537,"1200x900",1000,1,600,400,"False",621,412,655,243,243,1
"E06BN",216,440,"1200x900",1000,0,600,400,"False",71,237,357,120,120,1
"E06BN",217,577,"1200x900",1000,2,600,400,"False",455,420,513,93,93,0
"E06BN",218,455,"1200x900",1000,0,600,400,"False",107,718,567,-151,151,1
"E06BN",219,192,"1200x900",600,2,600,400,"False",1064,320,568,248,248,0
"E06BN",220,411,"1200x900",800,2,600,400,"True",805,361,426,65,65,0
"E06BN",221,180,"1200x900",600,2,600,400,"False",929,270,422,152,152,0
"E06BN",222,545,"1200x900",1000,1,600,400,"False",358,562,485,-77,77,0
"E06BN",223,417,"1200x900",800,2,600,400,"False",750,280,486,206,206,0
"E06BN",224,50,"1200x900",600,0,600,400,"False",75,582,507,-75,75,0
"E06BN",225,461,"1200x900",1000,0,600,400,"False",95,711,607,-104,104,1
"E06BN",226,5,"1200x900",600,0,600,400,"True",228,587,603,16,16,0
"E06BN",227,474,"1200x900",1000,0,600,400,"False",85,339,413,74,74,1
"E06BN",228,291,"1200x900",800,1,600,400,"True",522,694,738,44,44,0
"E06BN",229,326,"1200x900",800,1,600,400,"False",103,482,298,-184,184,0
"E06BN",230,598,"1200x900",1000,2,600,400,"True",706,559,557,-2,2,0
"E06BN",231,575,"1200x900",1000,1,600,400,"True",272,693,678,-15,15,0
"E06BN",232,331,"1200x900",800,1,600,400,"False",240,620,414,-206,206,0
"E06BN",234,304,"1200x900",800,1,600,400,"False",667,605,372,-233,233,0
"E06BN",235,66,"1200x900",600,0,600,400,"False",155,673,588,-85,85,0
"E06BN",236,59,"1200x900",600,0,600,400,"True",391,692,673,-19,19,1
"E06BN",237,221,"1200x900",800,0,600,400,"True",132,520,554,34,34,1
"E06BN",238,352,"1200x900",800,1,600,400,"False",235,717,583,-134,134,0
"E06BN",239,430,"1200x900",800,2,600,400,"False",922,254,456,202,202,0
"E06BN",240,200,"1200x900",600,2,600,400,"True",897,302,343,41,41,0
"E06BN",241,82,"1200x900",600,1,600,400,"False",108,213,352,139,139,0
"E06BN",242,623,"1200x900",1000,2,600,400,"False",636,527,283,-244,244,0
"E06BN",243,137,"1200x900",600,1,600,400,"False",789,577,452,-125,125,0
"E06BN",244,372,"1200x900",800,2,600,400,"True",833,620,545,-75,75,0
"E06BN",245,554,"1200x900",1000,1,600,400,"False",79,309,201,-108,108,1
"E06BN",246,557,"1200x900",1000,1,600,400,"False",677,505,688,183,183,1
"E06BN",247,52,"1200x900",600,0,600,400,"True",171,188,249,61,61,0
"E06BN",248,612,"1200x900",1000,2,600,400,"True",706,198,250,52,52,0
"E06BN",249,97,"1200x900",600,1,600,400,"True",760,643,581,-62,62,1
"E06BN",250,181,"1200x900",600,2,600,400,"False",1018,223,352,129,129,0
"E06BN",251,281,"1200x900",800,0,600,400,"True",112,611,547,-64,64,1
"E06BN",252,355,"1200x900",800,1,600,400,"True",77,386,372,-14,14,0
"E06BN",253,329,"1200x900",800,1,600,400,"True",517,239,298,59,59,0
"E06BN",254,491,"1200x900",1000,0,600,400,"True",108,198,208,10,10,1
"E06BN",255,602,"1200x900",1000,2,600,400,"True",865,452,431,-21,21,0
"E06BN",256,464,"1200x900",1000,0,600,400,"False",82,222,288,66,66,1
"E06BN",257,403,"1200x900",800,2,600,400,"False",625,704,287,-417,417,0
"E06BN",258,397,"1200x900",800,2,600,400,"True",817,692,611,-81,81,0
"E06BN",259,81,"1200x900",600,1,600,400,"False",696,225,460,235,235,0
"E06BN",260,573,"1200x900",1000,1,600,400,"True",486,615,609,-6,6,0
"E06BN",261,353,"1200x900",800,1,600,400,"True",90,476,488,12,12,0
"E06BN",262,384,"1200x900",800,2,600,400,"False",821,707,331,-376,376,0
"E06BN",263,535,"1200x900",1000,1,600,400,"True",372,410,456,46,46,0
"E06BN",264,39,"1200x900",600,0,600,400,"False",210,609,517,-92,92,0
"E06BN",266,394,"1200x900",800,2,600,400,"False",847,292,462,170,170,0
"E06BN",269,173,"1200x900",600,2,600,400,"False",948,693,564,-129,129,0
"E06BN",270,433,"1200x900",1000,0,600,400,"False",76,222,499,277,277,1
"E06BN",271,604,"1200x900",1000,2,600,400,"True",459,593,658,65,65,0
"E06BN",272,111,"1200x900",600,1,600,400,"True",922,552,636,84,84,1
"E06BN",273,648,"1200x900",1000,2,600,400,"False",557,394,525,131,131,0
"E06BN",274,320,"1200x900",800,1,600,400,"True",644,376,329,-47,47,0
"E06BN",275,176,"1200x900",600,2,600,400,"True",1033,281,363,82,82,0
"E06BN",276,597,"1200x900",1000,2,600,400,"False",352,239,485,246,246,0
"E06BN",277,63,"1200x900",600,0,600,400,"True",311,188,177,-11,11,1
"E06BN",278,29,"1200x900",600,0,600,400,"True",385,533,537,4,4,1
"E06BN",279,638,"1200x900",1000,2,600,400,"False",385,198,603,405,405,0
"E06BN",280,370,"1200x900",800,2,600,400,"True",874,336,353,17,17,0
"E06BN",281,362,"1200x900",800,2,600,400,"True",819,338,377,39,39,0
"E06BN",282,156,"1200x900",600,2,600,400,"False",913,197,475,278,278,0
"E06BN",283,508,"1200x900",1000,1,600,400,"True",596,485,433,-52,52,0
"E06BN",284,62,"1200x900",600,0,600,400,"True",345,346,393,47,47,1
"E06BN",285,477,"1200x900",1000,0,600,400,"True",88,640,659,19,19,1
"E06BN",286,217,"1200x900",800,0,600,400,"True",85,573,584,11,11,1
"E06BN",287,325,"1200x900",800,1,600,400,"True",105,394,455,61,61,0
"E06BN",288,516,"1200x900",1000,1,600,400,"False",440,559,636,77,77,0
"E06BN",289,206,"1200x900",600,2,600,400,"False",975,223,465,242,242,0
"E06BN",290,130,"1200x900",600,1,600,400,"False",741,428,534,106,106,0
"E06BN",291,17,"1200x900",600,0,600,400,"True",402,496,489,-7,7,1
"E06BN",292,127,"1200x900",600,1,600,400,"False",309,691,588,-103,103,0
"E06BN",293,14,"1200x900",600,0,600,400,"False",399,224,404,180,180,1
"E06BN",294,395,"1200x900",800,2,600,400,"True",743,334,329,-5,5,0
"E06BN",295,544,"1200x900",1000,1,600,400,"False",602,620,505,-115,115,0
"E06BN",296,161,"1200x900",600,2,600,400,"False",939,553,678,125,125,0
"E06BN",297,374,"1200x900",800,2,600,400,"True",755,450,501,51,51,0
"E06BN",298,60,"1200x900",600,0,600,400,"False",365,213,366,153,153,1
"E06BN",299,255,"1200x900",800,0,600,400,"True",93,709,717,8,8,1
"E06BN",300,357,"1200x900",800,1,600,400,"False",109,594,427,-167,167,0
"E06BN",301,100,"1200x900",600,1,600,400,"False",453,511,444,-67,67,0
"E06BN",302,528,"1200x900",1000,1,600,400,"False",839,227,646,419,419,1
"E06BN",303,203,"1200x900",600,2,600,400,"True",938,603,554,-49,49,0
"E06BN",304,441,"1200x900",1000,0,600,400,"False",85,684,575,-109,109,1
"E06BN",305,270,"1200x900",800,0,600,400,"True",192,418,403,-15,15,1
"E06BN",306,371,"1200x900",800,2,600,400,"False",730,560,386,-174,174,0
"E06BN",307,195,"1200x900",600,2,600,400,"False",942,249,391,142,142,0
"E06BN",308,55,"1200x900",600,0,600,400,"True",211,305,338,33,33,1
"E06BN",309,301,"1200x900",800,1,600,400,"False",162,574,434,-140,140,0
"E06BN",310,229,"1200x900",800,0,600,400,"True",117,697,660,-37,37,1
"E06BN",311,86,"1200x900",600,1,600,400,"False",692,388,650,262,262,1
"E06BN",312,414,"1200x900",800,2,600,400,"False",831,592,438,-154,154,0
"E06BN",313,4,"1200x900",600,0,600,400,"True",602,200,222,22,22,1
"E06BN",314,242,"1200x900",800,0,600,400,"True",117,448,428,-20,20,1
"E06BN",315,274,"1200x900",800,0,600,400,"True",146,497,486,-11,11,1
"E06BN",316,103,"1200x900",600,1,600,400,"False",528,320,435,115,115,1
"E06BN",317,556,"1200x900",1000,1,600,400,"False",415,420,547,127,127,0
"E06BN",318,305,"1200x900",800,1,600,400,"False",471,716,628,-88,88,0
"E06BN",319,443,"1200x900",1000,0,600,400,"True",99,651,654,3,3,1
"E06BN",320,53,"1200x900",600,0,600,400,"False",177,189,337,148,148,0
"E06BN",321,324,"1200x900",800,1,600,400,"False",719,712,449,-263,263,1
"E06BN",322,282,"1200x900",800,0,600,400,"True",109,246,305,59,59,1
"E06BN",324,505,"1200x900",1000,1,600,400,"True",191,484,544,60,60,1
"E06BN",325,518,"1200x900",1000,1,600,400,"False",583,717,562,-155,155,0
"E06BN",326,141,"1200x900",600,1,600,400,"False",671,582,661,79,79,0
"E06BN",327,470,"1200x900",1000,0,600,400,"False",91,666,576,-90,90,1
"E06BN",328,298,"1200x900",800,1,600,400,"True",311,457,408,-49,49,0
"E06BN",329,144,"1200x900",600,1,600,400,"False",718,371,490,119,119,0
"E06BN",330,83,"1200x900",600,1,600,400,"True",763,568,560,-8,8,1
"E06BN",331,193,"1200x900",600,2,600,400,"False",874,588,688,100,100,0
"E06BN",332,332,"1200x900",800,1,600,400,"False",260,699,591,-108,108,0
"E06BN",333,409,"1200x900",800,2,600,400,"True",501,659,644,-15,15,0
"E06BN",334,143,"1200x900",600,1,600,400,"False",479,284,513,229,229,1
"E06BN",335,594,"1200x900",1000,2,600,400,"False",537,637,506,-131,131,0
"E06BN",336,261,"1200x900",800,0,600,400,"True",86,713,737,24,24,1
"E06BN",337,468,"1200x900",1000,0,600,400,"True",121,219,225,6,6,1
"E06BN",338,617,"1200x900",1000,2,600,400,"False",294,180,623,443,443,0
"E06BN",339,47,"1200x900",600,0,600,400,"False",303,499,579,80,80,1
"E06BN",340,113,"1200x900",600,1,600,400,"True",897,657,666,9,9,0
"E06BN",341,520,"1200x900",1000,1,600,400,"True",564,260,265,5,5,0
"E06BN",342,425,"1200x900",800,2,600,400,"False",621,438,595,157,157,0
"E06BN",343,148,"1200x900",600,2,600,400,"True",907,330,302,-28,28,0
"E06BN",344,343,"1200x900",800,1,600,400,"False",407,557,439,-118,118,0
"E06BN",345,462,"1200x900",1000,0,600,400,"True",102,672,691,19,19,1
"E06BN",346,415,"1200x900",800,2,600,400,"False",823,684,567,-117,117,0
"E06BN",347,465,"1200x900",1000,0,600,400,"False",85,203,277,74,74,1
"E06BN",348,198,"1200x900",600,2,600,400,"False",976,500,273,-227,227,0
"E06BN",349,451,"1200x900",1000,0,600,400,"True",110,702,701,-1,1,1
"E06BN",350,431,"1200x900",800,2,600,400,"True",694,382,334,-48,48,0
"E06BN",351,289,"1200x900",800,1,600,400,"False",421,703,567,-136,136,1
"E06BN",352,21,"1200x900",600,0,600,400,"True",314,383,443,60,60,1
"E06BN",353,625,"1200x900",1000,2,600,400,"False",279,228,559,331,331,0
"E06BN",354,485,"1200x900",1000,0,600,400,"False",121,694,622,-72,72,1
"E06BN",355,410,"1200x900",800,2,600,400,"False",916,477,238,-239,239,0
"E06BN",356,630,"1200x900",1000,2,600,400,"True",754,559,547,-12,12,0
"E06BN",357,521,"1200x900",1000,1,600,400,"False",111,303,657,354,354,1
"E06BN",358,123,"1200x900",600,1,600,400,"False",761,365,155,-210,210,1
"E06BN",359,490,"1200x900",1000,0,600,400,"True",114,183,227,44,44,1
"E06BN",360,627,"1200x900",1000,2,600,400,"False",760,510,405,-105,105,0
"E06BN",361,457,"1200x900",1000,0,600,400,"False",97,630,556,-74,74,1
"E06BN",362,341,"1200x900",800,1,600,400,"False",735,632,570,-62,62,1
"E06BN",363,336,"1200x900",800,1,600,400,"False",251,587,661,74,74,0
"E06BN",364,194,"1200x900",600,2,600,400,"False",896,236,426,190,190,0
"E06BN",365,160,"1200x900",600,2,600,400,"True",863,606,630,24,24,0
"E06BN",366,246,"1200x900",800,0,600,400,"False",196,418,503,85,85,1
"E06BN",367,322,"1200x900",800,1,600,400,"False",703,206,369,163,163,1
"E06BN",368,366,"1200x900",800,2,600,400,"False",931,464,376,-88,88,0
"E06BN",369,33,"1200x900",600,0,600,400,"True",198,533,541,8,8,1
"E06BN",370,93,"1200x900",600,1,600,400,"False",139,540,630,90,90,0
"E06BN",371,153,"1200x900",600,2,600,400,"False",1037,601,758,157,157,0
"E06BN",372,121,"1200x900",600,1,600,400,"False",884,364,526,162,162,0
"E06BN",373,380,"1200x900",800,2,600,400,"False",942,228,165,-63,63,0
"E06BN",374,241,"1200x900",800,0,600,400,"False",129,227,359,132,132,1
"E06BN",375,624,"1200x900",1000,2,600,400,"False",693,501,396,-105,105,0
"E06BN",376,154,"1200x900",600,2,600,400,"True",941,454,548,94,94,0
"E06BN",377,71,"1200x900",600,0,600,400,"True",219,248,244,-4,4,0
"E06BN",378,269,"1200x900",800,0,600,400,"True",160,295,350,55,55,1
"E06BN",379,152,"1200x900",600,2,600,400,"False",971,399,328,-71,71,0
"E06BN",380,500,"1200x900",1000,0,600,400,"False",105,700,559,-141,141,1
"E06BN",382,428,"1200x900",800,2,600,400,"False",732,665,498,-167,167,0
"E06BN",383,607,"1200x900",1000,2,600,400,"True",900,573,505,-68,68,1
"E06BN",384,479,"1200x900",1000,0,600,400,"True",74,705,644,-61,61,1
"E06BN",385,196,"1200x900",600,2,600,400,"False",1030,397,498,101,101,0
"E06BN",386,603,"1200x900",1000,2,600,400,"True",693,280,359,79,79,0
"E06BN",387,10,"1200x900",600,0,600,400,"True",400,499,498,-1,1,1
"E06BN",388,187,"1200x900",600,2,600,400,"False",857,639,448,-191,191,0
"E06BN",389,207,"1200x900",600,2,600,400,"False",838,235,457,222,222,0
"E06BN",390,473,"1200x900",1000,0,600,400,"True",75,323,325,2,2,1
"E06BN",391,643,"1200x900",1000,2,600,400,"True",740,325,294,-31,31,0
"E06BN",392,348,"1200x900",800,1,600,400,"False",764,294,217,-77,77,0
"E06BN",393,216,"1200x900",600,2,600,400,"False",1029,286,223,-63,63,0
"E06BN",394,178,"1200x900",600,2,600,400,"False",1041,510,655,145,145,0
"E06BN",395,541,"1200x900",1000,1,600,400,"True",339,478,488,10,10,0
"E06BN",396,592,"1200x900",1000,2,600,400,"False",492,392,540,148,148,0
"E06BN",397,497,"1200x900",1000,0,600,400,"True",106,696,651,-45,45,1
"E06BN",398,1,"1200x900",600,0,600,400,"False",136,502,611,109,109,0
"E06BN",399,418,"1200x900",800,2,600,400,"True",754,507,587,80,80,0
"E06BN",400,214,"1200x900",600,2,600,400,"False",1046,305,544,239,239,0
"E06BN",401,585,"1200x900",1000,2,600,400,"True",698,688,638,-50,50,1
"E06BN",402,172,"1200x900",600,2,600,400,"True",912,444,431,-13,13,0
"E06BN",403,253,"1200x900",800,0,600,400,"True",177,424,438,14,14,1
"E06BN",404,67,"1200x900",600,0,600,400,"True",289,308,273,-35,35,1
"E06BN",405,569,"1200x900",1000,1,600,400,"False",494,720,565,-155,155,0
"E06BN",406,429,"1200x900",800,2,600,400,"True",682,692,627,-65,65,0
"E06BN",407,294,"1200x900",800,1,600,400,"False",262,287,624,337,337,0
"E06BN",408,373,"1200x900",800,2,600,400,"False",694,326,570,244,244,0
"E06BN",409,87,"1200x900",600,1,600,400,"False",231,604,410,-194,194,0
"E06BN",410,644,"1200x900",1000,2,600,400,"False",495,486,588,102,102,0
"E06BN",411,236,"1200x900",800,0,600,400,"True",162,350,378,28,28,1
"E06BN",412,36,"1200x900",600,0,600,400,"True",128,346,302,-44,44,1
"E06BN",413,536,"1200x900",1000,1,600,400,"False",580,213,286,73,73,0
"E06BN",414,640,"1200x900",1000,2,600,400,"False",361,334,260,-74,74,0
"E06BN",415,119,"1200x900",600,1,600,400,"True",168,563,535,-28,28,0
"E06BN",416,546,"1200x900",1000,1,600,400,"False",305,374,532,158,158,0
"E06BN",417,233,"1200x900",800,0,600,400,"False",164,700,622,-78,78,1
"E06BN",418,167,"1200x900",600,2,600,400,"False",956,241,464,223,223,0
"E06BN",419,199,"1200x900",600,2,600,400,"False",992,467,384,-83,83,0
"E06BN",420,466,"1200x900",1000,0,600,400,"False",82,205,310,105,105,1
"E06BN",421,359,"1200x900",800,1,600,400,"False",653,241,431,190,190,0
"E06BN",422,389,"1200x900",800,2,600,400,"False",843,530,392,-138,138,0
"E06BN",423,99,"1200x900",600,1,600,400,"True",811,407,472,65,65,0
"E06BN",424,125,"1200x900",600,1,600,400,"True",750,531,541,10,10,0
"E06BN",425,377,"1200x900",800,2,600,400,"True",683,388,454,66,66,0
"E06BN",426,626,"1200x900",1000,2,600,400,"True",329,449,486,37,37,0
"E06BN",427,209,"1200x900",600,2,600,400,"False",937,637,543,-94,94,0
"E06BN",428,571,"1200x900",1000,1,600,400,"False",239,522,628,106,106,1
"E06BN",429,7,"1200x900",600,0,600,400,"True",431,654,610,-44,44,1
"E06BN",430,85,"1200x900",600,1,600,400,"False",434,347,717,370,370,0
"E06BN",431,303,"1200x900",800,1,600,400,"True",241,431,401,-30,30,0
"E06BN",432,637,"1200x900",1000,2,600,400,"False",750,460,586,126,126,0
"E06BN",433,84,"1200x900",600,1,600,400,"False",144,184,114,-70,70,0
"E06BN",434,11,"1200x900",600,0,600,400,"False",372,670,599,-71,71,1
"E06BN",435,31,"1200x900",600,0,600,400,"False",365,338,501,163,163,1
"E06BN",436,501,"1200x900",1000,0,600,400,"True",96,323,301,-22,22,1
"E06BN",437,427,"1200x900",800,2,600,400,"True",812,380,368,-12,12,0
"E06BN",438,438,"1200x900",1000,0,600,400,"False",77,713,573,-140,140,1
"E06BN",439,131,"1200x900",600,1,600,400,"False",531,367,660,293,293,0
"E06BN",440,142,"1200x900",600,1,600,400,"True",286,474,486,12,12,0
"E06BN",442,387,"1200x900",800,2,600,400,"False",990,444,311,-133,133,0
"E06BN",443,514,"1200x900",1000,1,600,400,"True",539,690,653,-37,37,0
"E06BN",444,452,"1200x900",1000,0,600,400,"False",97,273,367,94,94,1
"E06BN",445,44,"1200x900",600,0,600,400,"False",305,554,645,91,91,1
"E06BN",446,484,"1200x900",1000,0,600,400,"False",100,223,362,139,139,1
"E06BN",447,262,"1200x900",800,0,600,400,"False",196,481,569,88,88,1
"E06BN",448,122,"1200x900",600,1,600,400,"True",817,709,678,-31,31,0
"E06BN",449,57,"1200x900",600,0,600,400,"True",354,508,494,-14,14,1
"E06BN",450,488,"1200x900",1000,0,600,400,"True",129,687,648,-39,39,1
"E06BN",451,539,"1200x900",1000,1,600,400,"True",510,383,427,44,44,0
"E06BN",452,533,"1200x900",1000,1,600,400,"False",355,483,345,-138,138,0
"E06BN",453,636,"1200x900",1000,2,600,400,"True",575,583,535,-48,48,0
"E06BN",454,628,"1200x900",1000,2,600,400,"False",768,410,510,100,100,0
"E06BN",455,406,"1200x900",800,2,600,400,"False",971,233,587,354,354,0
"E06BN",456,248,"1200x900",800,0,600,400,"False",94,240,341,101,101,1
"E06BN",457,268,"1200x900",800,0,600,400,"True",148,400,404,4,4,1
"E06BN",458,515,"1200x900",1000,1,600,400,"True",307,217,284,67,67,0
"E06BN",459,517,"1200x900",1000,1,600,400,"False",548,182,286,104,104,0
"E06BN",460,308,"1200x900",800,1,600,400,"False",437,425,695,270,270,0
"E06BN",461,495,"1200x900",1000,0,600,400,"False",93,692,579,-113,113,1
"E06BN",462,645,"1200x900",1000,2,600,400,"False",619,396,546,150,150,0
"E06BN",463,363,"1200x900",800,2,600,400,"False",800,218,515,297,297,0
"E06BN",464,38,"1200x900",600,0,600,400,"False",120,628,547,-81,81,1
"E06BN",465,583,"1200x900",1000,2,600,400,"False",949,284,407,123,123,1
"E06BN",466,213,"1200x900",600,2,600,400,"True",822,275,260,-15,15,0
"E06BN",467,615,"1200x900",1000,2,600,400,"True",736,634,567,-67,67,0
"E06BN",468,447,"1200x900",1000,0,600,400,"True",71,339,361,22,22,1
"E06BN",469,306,"1200x900",800,1,600,400,"False",164,524,720,196,196,0
"E06BN",470,310,"1200x900",800,1,600,400,"True",559,592,617,25,25,0
"E06BN",471,313,"1200x900",800,1,600,400,"True",588,421,425,4,4,0
"E06BN",472,524,"1200x900",1000,1,600,400,"False",534,470,716,246,246,0
"E06BN",473,494,"1200x900",1000,0,600,400,"False",127,692,605,-87,87,1
"E06BN",474,35,"1200x900",600,0,600,400,"True",366,555,607,52,52,1
"E06BN",476,250,"1200x900",800,0,600,400,"False",290,248,381,133,133,1
"E06BN",477,256,"1200x900",800,0,600,400,"True",192,656,608,-48,48,1
"E06BN",478,358,"1200x900",800,1,600,400,"False",263,635,580,-55,55,0
"E06BN",479,632,"1200x900",1000,2,600,400,"False",984,227,694,467,467,0
"E06BN",480,489,"1200x900",1000,0,600,400,"False",88,604,685,81,81,1
"E06BN",481,555,"1200x900",1000,1,600,400,"False",444,556,392,-164,164,0
"E06BN",482,108,"1200x900",600,1,600,400,"False",830,239,403,164,164,0
"E06BN",483,114,"1200x900",600,1,600,400,"False",183,697,803,106,106,0
"E06BN",484,356,"1200x900",800,1,600,400,"False",123,484,606,122,122,0
"E06BN",485,591,"1200x900",1000,2,600,400,"False",698,336,592,256,256,0
"E06BN",486,191,"1200x900",600,2,600,400,"True",962,396,443,47,47,0
"E06BN",487,633,"1200x900",1000,2,600,400,"False",564,253,487,234,234,0
"E06BN",488,211,"1200x900",600,2,600,400,"False",986,407,273,-134,134,0
"E06BN",489,596,"1200x900",1000,2,600,400,"True",706,513,558,45,45,0
"E06BN",490,619,"1200x900",1000,2,600,400,"False",803,247,544,297,297,0
"E06BN",491,175,"1200x900",600,2,600,400,"True",1028,432,495,63,63,0
"E06BN",492,140,"1200x900",600,1,600,400,"True",700,523,522,-1,1,0
"E06BN",493,581,"1200x900",1000,2,600,400,"False",310,357,520,163,163,0
"E06BN",494,378,"1200x900",800,2,600,400,"False",1018,708,517,-191,191,0
"E06BN",495,188,"1200x900",600,2,600,400,"False",900,195,516,321,321,0
"E06BN",496,335,"1200x900",800,1,600,400,"True",124,360,381,21,21,0
"E06BN",498,339,"1200x900",800,1,600,400,"True",273,545,483,-62,62,1
"E06BN",499,28,"1200x900",600,0,600,400,"True",336,410,472,62,62,1
"E06BN",500,449,"1200x900",1000,0,600,400,"False",105,683,547,-136,136,1
"E06BN",501,184,"1200x900",600,2,600,400,"False",1067,441,723,282,282,0
"E06BN",502,458,"1200x900",1000,0,600,400,"True",78,624,609,-15,15,1
"E06BN",504,503,"1200x900",1000,0,600,400,"False",86,279,429,150,150,1
"E06BN",505,558,"1200x900",1000,1,600,400,"False",72,464,619,155,155,1
"E06BN",506,284,"1200x900",800,0,600,400,"True",135,293,300,7,7,1
"E06BN",507,315,"1200x900",800,1,600,400,"False",105,211,301,90,90,0
"E06BN",508,89,"1200x900",600,1,600,400,"False",917,366,564,198,198,1
"E06BN",509,547,"1200x900",1000,1,600,400,"False",369,384,590,206,206,1
"E06BN",510,507,"1200x900",1000,1,600,400,"False",608,583,458,-125,125,1
"E06BN",511,204,"1200x900",600,2,600,400,"True",1053,432,463,31,31,0
"E06BN",512,434,"1200x900",1000,0,600,400,"False",89,657,556,-101,101,1
"E06BN",513,129,"1200x900",600,1,600,400,"False",859,482,324,-158,158,1
"E06BN",514,422,"1200x900",800,2,600,400,"True",712,558,505,-53,53,0
"E06BN",515,293,"1200x900",800,1,600,400,"False",561,396,490,94,94,0
"E06BN",516,182,"1200x900",600,2,600,400,"False",933,389,286,-103,103,0
"E06BN",517,170,"1200x900",600,2,600,400,"True",996,468,431,-37,37,0
"E06BN",518,618,"1200x900",1000,2,600,400,"False",276,671,436,-235,235,0
"E06BN",519,611,"1200x900",1000,2,600,400,"False",414,511,611,100,100,0
"E06BN",520,511,"1200x900",1000,1,600,400,"False",408,390,667,277,277,1
"E06BN",521,158,"1200x900",600,2,600,400,"True",939,300,354,54,54,0
"E06BN",522,641,"1200x900",1000,2,600,400,"False",897,272,575,303,303,0
"E06BN",523,265,"1200x900",800,0,600,400,"True",229,353,328,-25,25,1
"E06BN",524,110,"1200x900",600,1,600,400,"True",776,550,521,-29,29,1
"E06BN",525,212,"1200x900",600,2,600,400,"False",841,206,520,314,314,0
"E06BN",526,42,"1200x900",600,0,600,400,"True",233,479,511,32,32,0
"E06BN",528,264,"1200x900",800,0,600,400,"False",198,660,593,-67,67,1
"E06BN",529,228,"1200x900",800,0,600,400,"True",174,687,697,10,10,1
"E06BN",530,177,"1200x900",600,2,600,400,"False",912,236,370,134,134,0
"E06BN",531,635,"1200x900",1000,2,600,400,"False",833,402,285,-117,117,0
"E06BN",532,588,"1200x900",1000,2,600,400,"False",585,350,289,-61,61,0
"E06BN",533,564,"1200x900",1000,1,600,400,"False",215,264,447,183,183,0
"E06BN",534,27,"1200x900",600,0,600,400,"True",373,309,364,55,55,1
"E06BN",535,20,"1200x900",600,0,600,400,"True",204,545,527,-18,18,1
"E06BN",536,642,"1200x900",1000,2,600,400,"False",776,316,484,168,168,0
"E06BN",537,616,"1200x900",1000,2,600,400,"True",854,357,360,3,3,1
"E06BN",538,225,"1200x900",800,0,600,400,"True",178,423,427,4,4,1
"E06BN",539,486,"1200x900",1000,0,600,400,"False",102,676,521,-155,155,1
"E06BN",540,316,"1200x900",800,1,600,400,"False",362,319,592,273,273,0
"E06BN",541,576,"1200x900",1000,1,600,400,"False",376,713,613,-100,100,0
"E06BN",542,78,"1200x900",600,1,600,400,"False",885,684,779,95,95,0
"E06BN",543,647,"1200x900",1000,2,600,400,"True",560,637,660,23,23,0
"E06BN",544,319,"1200x900",800,1,600,400,"True",494,587,615,28,28,1
"E06BN",545,118,"1200x900",600,1,600,400,"True",190,588,591,3,3,0
"E06BN",546,258,"1200x900",800,0,600,400,"True",126,664,622,-42,42,1
"E06BN",547,475,"1200x900",1000,0,600,400,"True",101,715,653,-62,62,1
"E06BN",548,287,"1200x900",800,0,600,400,"False",120,567,660,93,93,1
"E06BN",549,345,"1200x900",800,1,600,400,"False",841,566,659,93,93,1
"E06BN",550,527,"1200x900",1000,1,600,400,"True",565,601,626,25,25,0
"E06BN",551,590,"1200x900",1000,2,600,400,"False",636,278,442,164,164,0
"E06BN",552,487,"1200x900",1000,0,600,400,"False",78,670,532,-138,138,1
"E06BN",553,120,"1200x900",600,1,600,400,"False",690,655,381,-274,274,0
"E06BN",554,600,"1200x900",1000,2,600,400,"False",765,207,617,410,410,0
"E06BN",555,549,"1200x900",1000,1,600,400,"True",657,366,366,0,0,0
"E06BN",556,509,"1200x900",1000,1,600,400,"False",509,434,335,-99,99,0
"E06BN",557,43,"1200x900",600,0,600,400,"True",277,446,473,27,27,1
"E06BN",558,126,"1200x900",600,1,600,400,"False",849,354,479,125,125,0
"E06BN",559,595,"1200x900",1000,2,600,400,"False",687,640,401,-239,239,0
"E06BN",560,318,"1200x900",800,1,600,400,"False",788,534,772,238,238,0
"E06BN",561,450,"1200x900",1000,0,600,400,"False",130,204,473,269,269,1
"E06BN",562,579,"1200x900",1000,2,600,400,"False",803,394,572,178,178,0
"E06BN",563,328,"1200x900",800,1,600,400,"False",104,649,513,-136,136,0
"E06BN",564,96,"1200x900",600,1,600,400,"False",433,458,645,187,187,0
"E06BN",565,531,"1200x900",1000,1,600,400,"False",233,362,649,287,287,0
"E06BN",566,613,"1200x900",1000,2,600,400,"True",690,374,299,-75,75,0
"E06BN",567,244,"1200x900",800,0,600,400,"False",194,203,289,86,86,1
"E06BN",569,230,"1200x900",800,0,600,400,"False",99,678,565,-113,113,1
"E06BN",570,65,"1200x900",600,0,600,400,"True",442,645,648,3,3,1
"E06BN",571,444,"1200x900",1000,0,600,400,"True",101,714,662,-52,52,1
"E06BN",572,275,"1200x900",800,0,600,400,"False",120,594,708,114,114,0
"E06BN",573,104,"1200x900",600,1,600,400,"False",448,584,767,183,183,0
"E06BN",574,367,"1200x900",800,2,600,400,"False",613,464,652,188,188,0
"E06BN",575,584,"1200x900",1000,2,600,400,"False",731,413,349,-64,64,0
"E06BN",576,8,"1200x900",600,0,600,400,"False",156,679,602,-77,77,0
"E06BN",577,346,"1200x900",800,1,600,400,"False",269,635,781,146,146,0
"E06BN",578,72,"1200x900",600,0,600,400,"True",158,537,554,17,17,0
"E06BN",580,570,"1200x900",1000,1,600,400,"False",315,352,519,167,167,0
"E06BN",581,77,"1200x900",600,1,600,400,"False",780,525,433,-92,92,0
"E06BN",582,350,"1200x900",800,1,600,400,"False",182,566,338,-228,228,0
"E06BN",583,197,"1200x900",600,2,600,400,"False",903,212,363,151,151,0
"E06BN",584,280,"1200x900",800,0,600,400,"True",104,302,364,62,62,1
"E06BN",585,622,"1200x900",1000,2,600,400,"False",307,683,524,-159,159,0
"E06BN",586,146,"1200x900",600,2,600,400,"True",989,492,522,30,30,0
"E06BN",587,542,"1200x900",1000,1,600,400,"False",304,401,164,-237,237,0
"E06BN",588,445,"1200x900",1000,0,600,400,"True",78,302,280,-22,22,1
"E06BN",589,448,"1200x900",1000,0,600,400,"True",107,641,591,-50,50,1
"E06BN",590,102,"1200x900",600,1,600,400,"False",861,603,713,110,110,0
"E06BN",591,548,"1200x900",1000,1,600,400,"False",103,278,540,262,262,0
"E06BN",592,388,"1200x900",800,2,600,400,"False",930,320,625,305,305,0
"E06BN",593,208,"1200x900",600,2,600,400,"False",946,399,648,249,249,0
"E06BN",594,138,"1200x900",600,1,600,400,"False",844,580,720,140,140,1
"E06BN",595,297,"1200x900",800,1,600,400,"False",625,244,469,225,225,0
"E06BN",597,376,"1200x900",800,2,600,400,"True",788,275,332,57,57,0
"E06BN",598,98,"1200x900",600,1,600,400,"False",625,530,414,-116,116,0
"E06BN",599,202,"1200x900",600,2,600,400,"True",966,460,415,-45,45,0
"E06BN",601,252,"1200x900",800,0,600,400,"False",224,673,505,-168,168,1
"E06BN",602,396,"1200x900",800,2,600,400,"False",678,663,573,-90,90,0
"E06BN",603,407,"1200x900",800,2,600,400,"True",989,340,329,-11,11,0
"E06BN",604,467,"1200x900",1000,0,600,400,"False",74,712,553,-159,159,1
"E06BN",605,543,"1200x900",1000,1,600,400,"False",88,202,552,350,350,0
"E06BN",606,562,"1200x900",1000,1,600,400,"True",347,540,497,-43,43,0
"E06BN",607,23,"1200x900",600,0,600,400,"True",308,463,464,1,1,1
"E06BN",608,610,"1200x900",1000,2,600,400,"False",702,293,412,119,119,0
"E06BN",609,469,"1200x900",1000,0,600,400,"True",73,227,264,37,37,1
"E06BN",610,317,"1200x900",800,1,600,400,"False",185,564,815,251,251,0
"E06BN",611,171,"1200x900",600,2,600,400,"False",909,200,351,151,151,0
"E06BN",612,530,"1200x900",1000,1,600,400,"False",584,405,174,-231,231,1
"E06BN",613,259,"1200x900",800,0,600,400,"True",156,180,167,-13,13,1
"E06BN",614,534,"1200x900",1000,1,600,400,"False",328,504,804,300,300,1
"E06BN",615,512,"1200x900",1000,1,600,400,"False",139,261,494,233,233,0
"E06BN",616,559,"1200x900",1000,1,600,400,"False",641,244,368,124,124,0
"E06BN",617,240,"1200x900",800,0,600,400,"False",330,656,592,-64,64,1
"E06BN",618,30,"1200x900",600,0,600,400,"False",107,353,452,99,99,0
"E06BN",619,266,"1200x900",800,0,600,400,"True",126,303,336,33,33,1
"E06BN",620,18,"1200x900",600,0,600,400,"True",400,318,332,14,14,1
"E06BN",621,51,"1200x900",600,0,600,400,"False",272,181,254,73,73,1
"E06BN",622,442,"1200x900",1000,0,600,400,"True",87,183,238,55,55,1
"E06BN",623,582,"1200x900",1000,2,600,400,"True",554,347,303,-44,44,0
"E06BN",624,538,"1200x900",1000,1,600,400,"False",308,457,296,-161,161,1
"E06BN",625,292,"1200x900",800,1,600,400,"False",88,565,702,137,137,0
"E06BN",626,94,"1200x900",600,1,600,400,"True",729,482,522,40,40,0
"E06BN",627,58,"1200x900",600,0,600,400,"True",353,655,632,-23,23,1
"E06BN",628,572,"1200x900",1000,1,600,400,"False",302,260,326,66,66,0
"E06BN",629,323,"1200x900",800,1,600,400,"False",388,348,707,359,359,0
"E06BN",630,279,"1200x900",800,0,600,400,"False",252,202,370,168,168,1
"E06BN",631,183,"1200x900",600,2,600,400,"True",927,289,276,-13,13,0
"E06BN",632,106,"1200x900",600,1,600,400,"False",803,659,499,-160,160,1
"E06BN",635,402,"1200x900",800,2,600,400,"False",878,234,459,225,225,0
"E06BN",636,205,"1200x900",600,2,600,400,"False",1021,504,564,60,60,0
"E06BN",637,551,"1200x900",1000,1,600,400,"True",146,445,442,-3,3,1
"E06BN",638,139,"1200x900",600,1,600,400,"False",192,695,480,-215,215,0
"E06BN",639,525,"1200x900",1000,1,600,400,"False",123,690,489,-201,201,0
"E06BN",641,413,"1200x900",800,2,600,400,"True",849,506,475,-31,31,0
"E06BN",642,463,"1200x900",1000,0,600,400,"True",115,693,650,-43,43,1
"E06BN",643,109,"1200x900",600,1,600,400,"False",691,589,465,-124,124,0
"E06BN",644,459,"1200x900",1000,0,600,400,"True",70,645,681,36,36,1
"E06BN",645,247,"1200x900",800,0,600,400,"False",160,424,287,-137,137,1
"E06BN",646,302,"1200x900",800,1,600,400,"False",479,467,543,76,76,1
"E06BN",647,19,"1200x900",600,0,600,400,"True",286,686,662,-24,24,0
"E06BN",648,646,"1200x900",1000,2,600,400,"True",829,227,316,89,89,1
"E07LD",1,140,"1200x900",600,1,600,400,"True",700,523,513,-10,10,0
"E07LD",2,320,"1200x900",800,1,600,400,"False",644,376,512,136,136,0
"E07LD",3,367,"1200x900",800,2,600,400,"True",613,464,452,-12,12,0
"E07LD",4,442,"1200x900",1000,0,600,400,"False",87,183,391,208,208,1
"E07LD",5,435,"1200x900",1000,0,600,400,"False",119,200,309,109,109,1
"E07LD",6,16,"1200x900",600,0,600,400,"False",297,514,422,-92,92,1
"E07LD",7,94,"1200x900",600,1,600,400,"True",729,482,421,-61,61,0
"E07LD",8,346,"1200x900",800,1,600,400,"False",269,635,240,-395,395,0
"E07LD",9,189,"1200x900",600,2,600,400,"False",881,397,224,-173,173,0
"E07LD",10,268,"1200x900",800,0,600,400,"False",148,400,326,-74,74,1
"E07LD",11,330,"1200x900",800,1,600,400,"False",759,301,128,-173,173,1
"E07LD",12,92,"1200x900",600,1,600,400,"False",624,605,779,174,174,0
"E07LD",13,498,"1200x900",1000,0,600,400,"False",100,260,432,172,172,1
"E07LD",14,229,"1200x900",800,0,600,400,"True",117,697,640,-57,57,1
"E07LD",15,553,"1200x900",1000,1,600,400,"False",116,712,395,-317,317,0
"E07LD",16,366,"1200x900",800,2,600,400,"False",931,464,56,-408,408,0
"E07LD",17,468,"1200x900",1000,0,600,400,"False",121,219,358,139,139,1
"E07LD",18,358,"1200x900",800,1,600,400,"False",263,635,580,-55,55,0
"E07LD",19,425,"1200x900",800,2,600,400,"False",621,438,345,-93,93,0
"E07LD",20,647,"1200x900",1000,2,600,400,"True",560,637,629,-8,8,0
"E07LD",21,516,"1200x900",1000,1,600,400,"True",440,559,628,69,69,0
"E07LD",23,156,"1200x900",600,2,600,400,"True",913,197,268,71,71,0
"E07LD",24,593,"1200x900",1000,2,600,400,"False",246,719,269,-450,450,0
"E07LD",25,184,"1200x900",600,2,600,400,"False",1067,441,828,387,387,0
"E07LD",26,102,"1200x900",600,1,600,400,"False",861,603,504,-99,99,0
"E07LD",27,9,"1200x900",600,0,600,400,"True",509,654,705,51,51,1
"E07LD",28,444,"1200x900",1000,0,600,400,"True",101,714,754,40,40,1
"E07LD",30,572,"1200x900",1000,1,600,400,"False",302,260,178,-82,82,0
"E07LD",31,171,"1200x900",600,2,600,400,"True",909,200,177,-23,23,0
"E07LD",32,536,"1200x900",1000,1,600,400,"False",580,213,333,120,120,0
"E07LD",33,247,"1200x900",800,0,600,400,"False",160,424,209,-215,215,1
"E07LD",34,612,"1200x900",1000,2,600,400,"False",706,198,664,466,466,0
"E07LD",35,238,"1200x900",800,0,600,400,"False",162,283,177,-106,106,1
"E07LD",36,491,"1200x900",1000,0,600,400,"True",108,198,164,-34,34,1
"E07LD",37,385,"1200x900",800,2,600,400,"False",740,456,169,-287,287,0
"E07LD",38,159,"1200x900",600,2,600,400,"True",992,309,228,-81,81,0
"E07LD",39,550,"1200x900",1000,1,600,400,"False",301,459,642,183,183,0
"E07LD",40,244,"1200x900",800,0,600,400,"False",194,203,274,71,71,1
"E07LD",41,349,"1200x900",800,1,600,400,"True",402,665,717,52,52,0
"E07LD",42,193,"1200x900",600,2,600,400,"False",874,588,233,-355,355,0
"E07LD",43,410,"1200x900",800,2,600,400,"False",916,477,304,-173,173,0
"E07LD",44,343,"1200x900",800,1,600,400,"False",407,557,158,-399,399,0
"E07LD",45,509,"1200x900",1000,1,600,400,"True",509,434,372,-62,62,0
"E07LD",46,1,"1200x900",600,0,600,400,"True",136,502,507,5,5,0
"E07LD",47,84,"1200x900",600,1,600,400,"True",144,184,168,-16,16,0
"E07LD",48,124,"1200x900",600,1,600,400,"False",345,467,590,123,123,0
"E07LD",49,70,"1200x900",600,0,600,400,"True",309,703,719,16,16,1
"E07LD",50,467,"1200x900",1000,0,600,400,"True",74,712,718,6,6,1
"E07LD",51,131,"1200x900",600,1,600,400,"True",531,367,331,-36,36,0
"E07LD",52,103,"1200x900",600,1,600,400,"False",528,320,648,328,328,1
"E07LD",53,183,"1200x900",600,2,600,400,"False",927,289,82,-207,207,0
"E07LD",54,443,"1200x900",1000,0,600,400,"True",99,651,705,54,54,1
"E07LD",55,197,"1200x900",600,2,600,400,"False",903,212,104,-108,108,0
"E07LD",56,456,"1200x900",1000,0,600,400,"True",91,257,219,-38,38,1
"E07LD",57,312,"1200x900",800,1,600,400,"False",238,683,531,-152,152,0
"E07LD",58,556,"1200x900",1000,1,600,400,"False",415,420,533,113,113,0
"E07LD",59,166,"1200x900",600,2,600,400,"False",896,274,111,-163,163,0
"E07LD",60,551,"1200x900",1000,1,600,400,"False",146,445,557,112,112,1
"E07LD",61,120,"1200x900",600,1,600,400,"False",690,655,383,-272,272,0
"E07LD",62,329,"1200x900",800,1,600,400,"False",517,239,550,311,311,0
"E07LD",63,289,"1200x900",800,1,600,400,"False",421,703,210,-493,493,1
"E07LD",64,417,"1200x900",800,2,600,400,"False",750,280,558,278,278,0
"E07LD",65,429,"1200x900",800,2,600,400,"False",682,692,352,-340,340,0
"E07LD",66,485,"1200x900",1000,0,600,400,"True",121,694,721,27,27,1
"E07LD",67,402,"1200x900",800,2,600,400,"True",878,234,257,23,23,0
"E07LD",68,178,"1200x900",600,2,600,400,"False",1041,510,363,-147,147,0
"E07LD",69,292,"1200x900",800,1,600,400,"False",88,565,444,-121,121,0
"E07LD",70,630,"1200x900",1000,2,600,400,"False",754,559,187,-372,372,0
"E07LD",71,127,"1200x900",600,1,600,400,"False",309,691,223,-468,468,0
"E07LD",72,181,"1200x900",600,2,600,400,"False",1018,223,372,149,149,0
"E07LD",73,296,"1200x900",800,1,600,400,"False",89,279,616,337,337,0
"E07LD",74,373,"1200x900",800,2,600,400,"False",694,326,592,266,266,0
"E07LD",75,414,"1200x900",800,2,600,400,"False",831,592,401,-191,191,0
"E07LD",76,180,"1200x900",600,2,600,400,"False",929,270,420,150,150,0
"E07LD",77,286,"1200x900",800,0,600,400,"False",105,378,174,-204,204,1
"E07LD",78,157,"1200x900",600,2,600,400,"True",1016,323,274,-49,49,0
"E07LD",79,623,"1200x900",1000,2,600,400,"False",636,527,646,119,119,0
"E07LD",80,537,"1200x900",1000,1,600,400,"False",621,412,246,-166,166,1
"E07LD",81,216,"1200x900",600,2,600,400,"True",1029,286,332,46,46,0
"E07LD",82,168,"1200x900",600,2,600,400,"False",1001,439,333,-106,106,0
"E07LD",83,582,"1200x900",1000,2,600,400,"False",554,347,567,220,220,0
"E07LD",84,524,"1200x900",1000,1,600,400,"False",534,470,160,-310,310,0
"E07LD",85,518,"1200x900",1000,1,600,400,"False",583,717,441,-276,276,0
"E07LD",86,644,"1200x900",1000,2,600,400,"False",495,486,185,-301,301,0
"E07LD",87,512,"1200x900",1000,1,600,400,"True",139,261,180,-81,81,0
"E07LD",88,245,"1200x900",800,0,600,400,"True",296,235,182,-53,53,1
"E07LD",89,142,"1200x900",600,1,600,400,"True",286,474,439,-35,35,0
"E07LD",90,208,"1200x900",600,2,600,400,"False",946,399,518,119,119,0
"E07LD",91,529,"1200x900",1000,1,600,400,"False",267,412,549,137,137,1
"E07LD",92,399,"1200x900",800,2,600,400,"False",603,602,447,-155,155,0
"E07LD",93,317,"1200x900",800,1,600,400,"False",185,564,364,-200,200,0
"E07LD",94,314,"1200x900",800,1,600,400,"False",277,616,179,-437,437,1
"E07LD",95,270,"1200x900",800,0,600,400,"False",192,418,524,106,106,1
"E07LD",96,258,"1200x900",800,0,600,400,"False",126,664,151,-513,513,1
"E07LD",97,251,"1200x900",800,0,600,400,"False",88,352,277,-75,75,1
"E07LD",98,483,"1200x900",1000,0,600,400,"False",93,191,322,131,131,1
"E07LD",99,310,"1200x900",800,1,600,400,"False",559,592,525,-67,67,0
"E07LD",101,15,"1200x900",600,0,600,400,"True",473,352,302,-50,50,1
"E07LD",102,318,"1200x900",800,1,600,400,"False",788,534,672,138,138,0
"E07LD",103,89,"1200x900",600,1,600,400,"True",917,366,393,27,27,1
"E07LD",104,190,"1200x900",600,2,600,400,"False",977,238,135,-103,103,0
"E07LD",105,626,"1200x900",1000,2,600,400,"False",329,449,755,306,306,0
"E07LD",106,598,"1200x900",1000,2,600,400,"True",706,559,530,-29,29,0
"E07LD",107,614,"1200x900",1000,2,600,400,"False",823,563,311,-252,252,0
"E07LD",108,279,"1200x900",800,0,600,400,"True",252,202,220,18,18,1
"E07LD",109,319,"1200x900",800,1,600,400,"False",494,587,706,119,119,1
"E07LD",110,47,"1200x900",600,0,600,400,"False",303,499,653,154,154,1
"E07LD",112,4,"1200x900",600,0,600,400,"True",602,200,256,56,56,1
"E07LD",113,605,"1200x900",1000,2,600,400,"True",493,665,592,-73,73,0
"E07LD",114,390,"1200x900",800,2,600,400,"False",982,674,761,87,87,1
"E07LD",115,603,"1200x900",1000,2,600,400,"True",693,280,255,-25,25,0
"E07LD",116,522,"1200x900",1000,1,600,400,"False",223,379,702,323,323,0
"E07LD",117,510,"1200x900",1000,1,600,400,"False",486,338,77,-261,261,1
"E07LD",118,350,"1200x900",800,1,600,400,"True",182,566,551,-15,15,0
"E07LD",119,154,"1200x900",600,2,600,400,"False",941,454,230,-224,224,0
"E07LD",120,477,"1200x900",1000,0,600,400,"False",88,640,371,-269,269,1
"E07LD",121,269,"1200x900",800,0,600,400,"False",160,295,373,78,78,1
"E07LD",122,235,"1200x900",800,0,600,400,"True",146,646,646,0,0,1
"E07LD",123,141,"1200x900",600,1,600,400,"False",671,582,652,70,70,0
"E07LD",124,226,"1200x900",800,0,600,400,"False",187,229,648,419,419,1
"E07LD",125,496,"1200x900",1000,0,600,400,"True",70,639,660,21,21,1
"E07LD",126,422,"1200x900",800,2,600,400,"False",712,558,461,-97,97,0
"E07LD",127,611,"1200x900",1000,2,600,400,"False",414,511,747,236,236,0
"E07LD",128,570,"1200x900",1000,1,600,400,"False",315,352,545,193,193,0
"E07LD",129,530,"1200x900",1000,1,600,400,"False",584,405,197,-208,208,1
"E07LD",130,236,"1200x900",800,0,600,400,"True",162,350,336,-14,14,1
"E07LD",131,386,"1200x900",800,2,600,400,"False",774,301,404,103,103,0
"E07LD",132,147,"1200x900",600,2,600,400,"False",942,418,314,-104,104,0
"E07LD",133,6,"1200x900",600,0,600,400,"True",217,689,697,8,8,1
"E07LD",134,640,"1200x900",1000,2,600,400,"False",361,334,519,185,185,0
"E07LD",135,196,"1200x900",600,2,600,400,"True",1030,397,498,101,101,0
"E07LD",136,49,"1200x900",600,0,600,400,"True",109,380,325,-55,55,0
"E07LD",137,69,"1200x900",600,0,600,400,"True",322,268,233,-35,35,0
"E07LD",138,44,"1200x900",600,0,600,400,"False",305,554,681,127,127,1
"E07LD",139,331,"1200x900",800,1,600,400,"True",240,620,601,-19,19,0
"E07LD",140,597,"1200x900",1000,2,600,400,"False",352,239,429,190,190,0
"E07LD",141,207,"1200x900",600,2,600,400,"False",838,235,353,118,118,0
"E07LD",142,571,"1200x900",1000,1,600,400,"False",239,522,264,-258,258,1
"E07LD",143,232,"1200x900",800,0,600,400,"False",84,511,597,86,86,1
"E07LD",144,194,"1200x900",600,2,600,400,"True",896,236,274,38,38,0
"E07LD",145,98,"1200x900",600,1,600,400,"False",625,530,389,-141,141,0
"E07LD",146,290,"1200x900",800,1,600,400,"False",789,603,521,-82,82,0
"E07LD",147,23,"1200x900",600,0,600,400,"True",308,463,392,-71,71,1
"E07LD",148,569,"1200x900",1000,1,600,400,"False",494,720,557,-163,163,0
"E07LD",149,508,"1200x900",1000,1,600,400,"True",596,485,469,-16,16,0
"E07LD",150,167,"1200x900",600,2,600,400,"False",956,241,442,201,201,0
"E07LD",151,2,"1200x900",600,0,600,400,"False",159,323,212,-111,111,0
"E07LD",152,322,"1200x900",800,1,600,400,"False",703,206,463,257,257,1
"E07LD",153,53,"1200x900",600,0,600,400,"True",177,189,167,-22,22,0
"E07LD",154,311,"1200x900",800,1,600,400,"True",710,261,223,-38,38,0
"E07LD",155,341,"1200x900",800,1,600,400,"False",735,632,453,-179,179,1
"E07LD",156,389,"1200x900",800,2,600,400,"False",843,530,316,-214,214,0
"E07LD",157,404,"1200x900",800,2,600,400,"False",842,396,590,194,194,0
"E07LD",158,440,"1200x900",1000,0,600,400,"True",71,237,217,-20,20,1
"E07LD",159,13,"1200x900",600,0,600,400,"False",296,211,286,75,75,1
"E07LD",160,599,"1200x900",1000,2,600,400,"False",316,570,382,-188,188,0
"E07LD",161,476,"1200x900",1000,0,600,400,"False",76,359,284,-75,75,1
"E07LD",162,506,"1200x900",1000,1,600,400,"False",559,567,334,-233,233,1
"E07LD",163,118,"1200x900",600,1,600,400,"False",190,588,491,-97,97,0
"E07LD",164,395,"1200x900",800,2,600,400,"True",743,334,382,48,48,0
"E07LD",165,521,"1200x900",1000,1,600,400,"True",111,303,365,62,62,1
"E07LD",166,480,"1200x900",1000,0,600,400,"False",100,231,337,106,106,1
"E07LD",167,527,"1200x900",1000,1,600,400,"False",565,601,411,-190,190,0
"E07LD",168,380,"1200x900",800,2,600,400,"False",942,228,406,178,178,0
"E07LD",169,109,"1200x900",600,1,600,400,"False",691,589,295,-294,294,0
"E07LD",170,348,"1200x900",800,1,600,400,"False",764,294,375,81,81,0
"E07LD",171,255,"1200x900",800,0,600,400,"True",93,709,700,-9,9,1
"E07LD",172,361,"1200x900",800,2,600,400,"False",931,328,215,-113,113,0
"E07LD",173,631,"1200x900",1000,2,600,400,"False",699,479,543,64,64,0
"E07LD",174,446,"1200x900",1000,0,600,400,"False",72,298,417,119,119,1
"E07LD",175,85,"1200x900",600,1,600,400,"False",434,347,584,237,237,0
"E07LD",176,441,"1200x900",1000,0,600,400,"True",85,684,649,-35,35,1
"E07LD",177,110,"1200x900",600,1,600,400,"False",776,550,307,-243,243,1
"E07LD",178,243,"1200x900",800,0,600,400,"False",114,332,402,70,70,1
"E07LD",179,617,"1200x900",1000,2,600,400,"False",294,180,796,616,616,0
"E07LD",180,475,"1200x900",1000,0,600,400,"False",101,715,650,-65,65,1
"E07LD",181,415,"1200x900",800,2,600,400,"False",823,684,459,-225,225,0
"E07LD",182,624,"1200x900",1000,2,600,400,"True",693,501,473,-28,28,0
"E07LD",183,228,"1200x900",800,0,600,400,"True",174,687,757,70,70,1
"E07LD",184,618,"1200x900",1000,2,600,400,"False",276,671,385,-286,286,0
"E07LD",186,212,"1200x900",600,2,600,400,"False",841,206,396,190,190,0
"E07LD",187,505,"1200x900",1000,1,600,400,"False",191,484,596,112,112,1
"E07LD",188,100,"1200x900",600,1,600,400,"False",453,511,430,-81,81,0
"E07LD",189,637,"1200x900",1000,2,600,400,"False",750,460,277,-183,183,0
"E07LD",190,336,"1200x900",800,1,600,400,"True",251,587,537,-50,50,0
"E07LD",191,355,"1200x900",800,1,600,400,"False",77,386,570,184,184,0
"E07LD",192,210,"1200x900",600,2,600,400,"True",835,506,466,-40,40,0
"E07LD",193,262,"1200x900",800,0,600,400,"True",196,481,526,45,45,1
"E07LD",194,473,"1200x900",1000,0,600,400,"False",75,323,400,77,77,1
"E07LD",195,137,"1200x900",600,1,600,400,"False",789,577,483,-94,94,0
"E07LD",196,648,"1200x900",1000,2,600,400,"False",557,394,692,298,298,0
"E07LD",197,326,"1200x900",800,1,600,400,"False",103,482,322,-160,160,0
"E07LD",198,32,"1200x900",600,0,600,400,"False",152,563,761,198,198,1
"E07LD",199,83,"1200x900",600,1,600,400,"False",763,568,426,-142,142,1
"E07LD",200,396,"1200x900",800,2,600,400,"False",678,663,385,-278,278,0
"E07LD",201,629,"1200x900",1000,2,600,400,"False",681,257,664,407,407,0
"E07LD",202,333,"1200x900",800,1,600,400,"False",521,548,662,114,114,0
"E07LD",203,540,"1200x900",1000,1,600,400,"False",389,568,450,-118,118,1
"E07LD",204,298,"1200x900",800,1,600,400,"False",311,457,617,160,160,0
"E07LD",205,607,"1200x900",1000,2,600,400,"True",900,573,541,-32,32,1
"E07LD",206,133,"1200x900",600,1,600,400,"True",345,551,544,-7,7,0
"E07LD",209,363,"1200x900",800,2,600,400,"False",800,218,671,453,453,0
"E07LD",210,233,"1200x900",800,0,600,400,"False",164,700,179,-521,521,1
"E07LD",211,400,"1200x900",800,2,600,400,"False",733,297,621,324,324,0
"E07LD",213,567,"1200x900",1000,1,600,400,"False",655,297,239,-58,58,1
"E07LD",218,240,"1200x900",800,0,600,400,"True",330,656,632,-24,24,1
"E07LD",219,223,"1200x900",800,0,600,400,"True",179,191,208,17,17,1
"E07LD",220,428,"1200x900",800,2,600,400,"False",732,665,583,-82,82,0
"E07LD",221,639,"1200x900",1000,2,600,400,"False",504,456,559,103,103,0
"E07LD",222,172,"1200x900",600,2,600,400,"False",912,444,227,-217,217,0
"E07LD",223,80,"1200x900",600,1,600,400,"False",616,423,577,154,154,1
"E07LD",224,185,"1200x900",600,2,600,400,"False",907,212,438,226,226,0
"E07LD",226,354,"1200x900",800,1,600,400,"False",118,236,627,391,391,0
"E07LD",227,471,"1200x900",1000,0,600,400,"False",122,200,322,122,122,1
"E07LD",228,204,"1200x900",600,2,600,400,"False",1053,432,305,-127,127,0
"E07LD",229,393,"1200x900",800,2,600,400,"False",657,620,359,-261,261,0
"E07LD",230,3,"1200x900",600,0,600,400,"False",298,443,629,186,186,1
"E07LD",231,37,"1200x900",600,0,600,400,"True",258,403,417,14,14,1
"E07LD",232,295,"1200x900",800,1,600,400,"False",471,334,274,-60,60,0
"E07LD",233,374,"1200x900",800,2,600,400,"False",755,450,583,133,133,0
"E07LD",234,420,"1200x900",800,2,600,400,"False",519,223,558,335,335,0
"E07LD",235,52,"1200x900",600,0,600,400,"False",171,188,256,68,68,0
"E07LD",236,26,"1200x900",600,0,600,400,"True",70,712,732,20,20,0
"E07LD",237,271,"1200x900",800,0,600,400,"False",74,360,555,195,195,1
"E07LD",238,601,"1200x900",1000,2,600,400,"False",735,697,388,-309,309,0
"E07LD",239,126,"1200x900",600,1,600,400,"True",849,354,289,-65,65,0
"E07LD",240,575,"1200x900",1000,1,600,400,"False",272,693,417,-276,276,0
"E07LD",242,418,"1200x900",800,2,600,400,"False",754,507,361,-146,146,0
"E07LD",243,619,"1200x900",1000,2,600,400,"False",803,247,487,240,240,0
"E07LD",244,11,"1200x900",600,0,600,400,"False",372,670,757,87,87,1
"E07LD",245,338,"1200x900",800,1,600,400,"False",813,253,363,110,110,1
"E07LD",246,481,"1200x900",1000,0,600,400,"False",80,185,282,97,97,1
"E07LD",247,153,"1200x900",600,2,600,400,"True",1037,601,505,-96,96,0
"E07LD",248,272,"1200x900",800,0,600,400,"True",200,181,158,-23,23,1
"E07LD",249,222,"1200x900",800,0,600,400,"True",152,206,157,-49,49,1
"E07LD",250,170,"1200x900",600,2,600,400,"True",996,468,457,-11,11,0
"E07LD",251,433,"1200x900",1000,0,600,400,"False",76,222,358,136,136,1
"E07LD",252,359,"1200x900",800,1,600,400,"False",653,241,457,216,216,0
"E07LD",253,360,"1200x900",800,1,600,400,"False",203,608,211,-397,397,0
"E07LD",254,152,"1200x900",600,2,600,400,"True",971,399,379,-20,20,0
"E07LD",255,45,"1200x900",600,0,600,400,"False",487,678,793,115,115,1
"E07LD",256,10,"1200x900",600,0,600,400,"False",400,499,582,83,83,1
"E07LD",257,462,"1200x900",1000,0,600,400,"True",102,672,701,29,29,1
"E07LD",258,219,"1200x900",800,0,600,400,"True",202,502,515,13,13,1
"E07LD",259,217,"1200x900",800,0,600,400,"True",85,573,618,45,45,1
"E07LD",260,146,"1200x900",600,2,600,400,"False",989,492,342,-150,150,0
"E07LD",261,501,"1200x900",1000,0,600,400,"True",96,323,385,62,62,1
"E07LD",262,409,"1200x900",800,2,600,400,"False",501,659,492,-167,167,0
"E07LD",263,213,"1200x900",600,2,600,400,"False",822,275,216,-59,59,0
"E07LD",265,225,"1200x900",800,0,600,400,"True",178,423,362,-61,61,1
"E07LD",266,327,"1200x900",800,1,600,400,"True",152,339,425,86,86,0
"E07LD",267,192,"1200x900",600,2,600,400,"False",1064,320,392,72,72,0
"E07LD",268,77,"1200x900",600,1,600,400,"True",780,525,453,-72,72,0
"E07LD",269,256,"1200x900",800,0,600,400,"True",192,656,609,-47,47,1
"E07LD",270,464,"1200x900",1000,0,600,400,"False",82,222,323,101,101,1
"E07LD",271,257,"1200x900",800,0,600,400,"True",97,219,240,21,21,1
"E07LD",272,573,"1200x900",1000,1,600,400,"False",486,615,514,-101,101,0
"E07LD",273,96,"1200x900",600,1,600,400,"True",433,458,390,-68,68,0
"E07LD",274,411,"1200x900",800,2,600,400,"False",805,361,481,120,120,0
"E07LD",275,604,"1200x900",1000,2,600,400,"False",459,593,681,88,88,0
"E07LD",276,99,"1200x900",600,1,600,400,"False",811,407,480,73,73,0
"E07LD",277,288,"1200x900",800,0,600,400,"False",180,547,397,-150,150,1
"E07LD",278,119,"1200x900",600,1,600,400,"False",168,563,372,-191,191,0
"E07LD",279,74,"1200x900",600,1,600,400,"False",115,358,728,370,370,0
"E07LD",280,517,"1200x900",1000,1,600,400,"False",548,182,293,111,111,0
"E07LD",281,276,"1200x900",800,0,600,400,"True",281,217,239,22,22,1
"E07LD",282,155,"1200x900",600,2,600,400,"False",940,269,400,131,131,0
"E07LD",283,241,"1200x900",800,0,600,400,"True",129,227,225,-2,2,1
"E07LD",284,12,"1200x900",600,0,600,400,"True",365,336,310,-26,26,1
"E07LD",285,565,"1200x900",1000,1,600,400,"False",451,562,309,-253,253,0
"E07LD",286,265,"1200x900",800,0,600,400,"False",229,353,266,-87,87,1
"E07LD",287,252,"1200x900",800,0,600,400,"True",224,673,749,76,76,1
"E07LD",288,43,"1200x900",600,0,600,400,"False",277,446,737,291,291,1
"E07LD",289,590,"1200x900",1000,2,600,400,"False",636,278,517,239,239,0
"E07LD",290,397,"1200x900",800,2,600,400,"False",817,692,472,-220,220,0
"E07LD",291,557,"1200x900",1000,1,600,400,"True",677,505,490,-15,15,1
"E07LD",292,507,"1200x900",1000,1,600,400,"False",608,583,743,160,160,1
"E07LD",293,643,"1200x900",1000,2,600,400,"False",740,325,439,114,114,0
"E07LD",294,635,"1200x900",1000,2,600,400,"True",833,402,352,-50,50,0
"E07LD",295,95,"1200x900",600,1,600,400,"True",749,425,365,-60,60,1
"E07LD",296,203,"1200x900",600,2,600,400,"False",938,603,446,-157,157,0
"E07LD",297,50,"1200x900",600,0,600,400,"True",75,582,611,29,29,0
"E07LD",298,525,"1200x900",1000,1,600,400,"True",123,690,641,-49,49,0
"E07LD",299,394,"1200x900",800,2,600,400,"True",847,292,287,-5,5,0
"E07LD",300,549,"1200x900",1000,1,600,400,"True",657,366,376,10,10,0
"E07LD",301,88,"1200x900",600,1,600,400,"True",186,554,540,-14,14,0
"E07LD",302,588,"1200x900",1000,2,600,400,"True",585,350,325,-25,25,0
"E07LD",303,379,"1200x900",800,2,600,400,"False",994,325,541,216,216,0
"E07LD",304,546,"1200x900",1000,1,600,400,"False",305,374,452,78,78,0
"E07LD",305,376,"1200x900",800,2,600,400,"False",788,275,386,111,111,0
"E07LD",306,432,"1200x900",800,2,600,400,"False",792,380,277,-103,103,0
"E07LD",307,439,"1200x900",1000,0,600,400,"False",110,229,307,78,78,1
"E07LD",308,339,"1200x900",800,1,600,400,"False",273,545,438,-107,107,1
"E07LD",309,561,"1200x900",1000,1,600,400,"False",231,406,658,252,252,0
"E07LD",310,221,"1200x900",800,0,600,400,"False",132,520,654,134,134,1
"E07LD",311,27,"1200x900",600,0,600,400,"True",373,309,329,20,20,1
"E07LD",312,580,"1200x900",1000,2,600,400,"False",651,267,598,331,331,0
"E07LD",313,627,"1200x900",1000,2,600,400,"True",760,510,434,-76,76,0
"E07LD",314,31,"1200x900",600,0,600,400,"True",365,338,329,-9,9,1
"E07LD",315,578,"1200x900",1000,2,600,400,"False",966,276,669,393,393,0
"E07LD",316,108,"1200x900",600,1,600,400,"False",830,239,425,186,186,0
"E07LD",317,519,"1200x900",1000,1,600,400,"True",319,565,522,-43,43,1
"E07LD",318,382,"1200x900",800,2,600,400,"True",870,523,548,25,25,0
"E07LD",319,470,"1200x900",1000,0,600,400,"True",91,666,703,37,37,1
"E07LD",320,35,"1200x900",600,0,600,400,"True",366,555,582,27,27,1
"E07LD",321,493,"1200x900",1000,0,600,400,"False",80,582,755,173,173,1
"E07LD",322,489,"1200x900",1000,0,600,400,"False",88,604,731,127,127,1
"E07LD",323,139,"1200x900",600,1,600,400,"False",192,695,271,-424,424,0
"E07LD",324,347,"1200x900",800,1,600,400,"True",757,295,226,-69,69,1
"E07LD",325,57,"1200x900",600,0,600,400,"True",354,508,539,31,31,1
"E07LD",326,497,"1200x900",1000,0,600,400,"True",106,696,652,-44,44,1
"E07LD",327,56,"1200x900",600,0,600,400,"True",148,491,458,-33,33,0
"E07LD",328,283,"1200x900",800,0,600,400,"True",90,264,292,28,28,1
"E07LD",329,107,"1200x900",600,1,600,400,"False",878,678,478,-200,200,0
"E07LD",330,46,"1200x900",600,0,600,400,"True",193,355,411,56,56,1
"E07LD",331,412,"1200x900",800,2,600,400,"True",842,280,322,42,42,0
"E07LD",332,55,"1200x900",600,0,600,400,"True",211,305,334,29,29,1
"E07LD",333,315,"1200x900",800,1,600,400,"True",105,211,293,82,82,0
"E07LD",334,589,"1200x900",1000,2,600,400,"True",856,418,373,-45,45,0
"E07LD",335,282,"1200x900",800,0,600,400,"True",109,246,254,8,8,1
"E07LD",336,7,"1200x900",600,0,600,400,"True",431,654,628,-26,26,1
"E07LD",337,609,"1200x900",1000,2,600,400,"False",697,627,482,-145,145,0
"E07LD",338,405,"1200x900",800,2,600,400,"False",790,307,569,262,262,0
"E07LD",339,278,"1200x900",800,0,600,400,"True",251,711,656,-55,55,1
"E07LD",340,494,"1200x900",1000,0,600,400,"True",127,692,716,24,24,1
"E07LD",341,135,"1200x900",600,1,600,400,"False",759,569,405,-164,164,0
"E07LD",342,20,"1200x900",600,0,600,400,"False",204,545,720,175,175,1
"E07LD",343,613,"1200x900",1000,2,600,400,"False",690,374,493,119,119,0
"E07LD",344,165,"1200x900",600,2,600,400,"False",912,554,414,-140,140,0
"E07LD",345,628,"1200x900",1000,2,600,400,"False",768,410,617,207,207,0
"E07LD",346,340,"1200x900",800,1,600,400,"False",226,240,323,83,83,0
"E07LD",347,345,"1200x900",800,1,600,400,"True",841,566,601,35,35,1
"E07LD",348,495,"1200x900",1000,0,600,400,"True",93,692,707,15,15,1
"E07LD",349,566,"1200x900",1000,1,600,400,"True",378,472,514,42,42,1
"E07LD",350,246,"1200x900",800,0,600,400,"True",196,418,407,-11,11,1
"E07LD",351,161,"1200x900",600,2,600,400,"True",939,553,490,-63,63,0
"E07LD",352,372,"1200x900",800,2,600,400,"False",833,620,341,-279,279,0
"E07LD",353,293,"1200x900",800,1,600,400,"True",561,396,373,-23,23,0
"E07LD",354,564,"1200x900",1000,1,600,400,"True",215,264,311,47,47,0
"E07LD",355,177,"1200x900",600,2,600,400,"False",912,236,376,140,140,0
"E07LD",356,620,"1200x900",1000,2,600,400,"False",832,649,519,-130,130,0
"E07LD",357,132,"1200x900",600,1,600,400,"False",333,185,409,224,224,0
"E07LD",358,294,"1200x900",800,1,600,400,"True",262,287,229,-58,58,0
"E07LD",359,547,"1200x900",1000,1,600,400,"False",369,384,528,144,144,1
"E07LD",360,267,"1200x900",800,0,600,400,"False",145,665,741,76,76,1
"E07LD",361,515,"1200x900",1000,1,600,400,"False",307,217,393,176,176,0
"E07LD",362,158,"1200x900",600,2,600,400,"True",939,300,300,0,0,0
"E07LD",363,323,"1200x900",800,1,600,400,"False",388,348,574,226,226,0
"E07LD",364,370,"1200x900",800,2,600,400,"True",874,336,320,-16,16,0
"E07LD",365,201,"1200x900",600,2,600,400,"False",1005,462,396,-66,66,0
"E07LD",366,263,"1200x900",800,0,600,400,"True",82,396,352,-44,44,1
"E07LD",367,378,"1200x900",800,2,600,400,"False",1018,708,416,-292,292,0
"E07LD",368,325,"1200x900",800,1,600,400,"True",105,394,434,40,40,0
"E07LD",369,79,"1200x900",600,1,600,400,"True",731,289,344,55,55,0
"E07LD",370,125,"1200x900",600,1,600,400,"False",750,531,375,-156,156,0
"E07LD",371,482,"1200x900",1000,0,600,400,"True",79,686,647,-39,39,1
"E07LD",372,621,"1200x900",1000,2,600,400,"False",540,478,627,149,149,0
"E07LD",373,68,"1200x900",600,0,600,400,"False",165,367,468,101,101,0
"E07LD",374,18,"1200x900",600,0,600,400,"True",400,318,312,-6,6,1
"E07LD",375,577,"1200x900",1000,2,600,400,"True",455,420,419,-1,1,0
"E07LD",376,592,"1200x900",1000,2,600,400,"False",492,392,523,131,131,0
"E07LD",377,130,"1200x900",600,1,600,400,"True",741,428,485,57,57,0
"E07LD",378,484,"1200x900",1000,0,600,400,"False",100,223,322,99,99,1
"E07LD",379,300,"1200x900",800,1,600,400,"False",620,693,557,-136,136,0
"E07LD",380,492,"1200x900",1000,0,600,400,"True",76,692,695,3,3,1
"E07LD",381,342,"1200x900",800,1,600,400,"True",677,204,246,42,42,0
"E07LD",382,306,"1200x900",800,1,600,400,"True",164,524,523,-1,1,0
"E07LD",383,474,"1200x900",1000,0,600,400,"True",85,339,402,63,63,1
"E07LD",384,176,"1200x900",600,2,600,400,"True",1033,281,281,0,0,0
"E07LD",385,231,"1200x900",800,0,600,400,"False",251,718,609,-109,109,1
"E07LD",386,62,"1200x900",600,0,600,400,"True",345,346,363,17,17,1
"E07LD",387,371,"1200x900",800,2,600,400,"True",730,560,522,-38,38,0
"E07LD",388,427,"1200x900",800,2,600,400,"True",812,380,414,34,34,0
"E07LD",389,445,"1200x900",1000,0,600,400,"True",78,302,323,21,21,1
"E07LD",390,538,"1200x900",1000,1,600,400,"False",308,457,298,-159,159,1
"E07LD",391,86,"1200x900",600,1,600,400,"True",692,388,335,-53,53,1
"E07LD",392,636,"1200x900",1000,2,600,400,"False",575,583,238,-345,345,0
"E07LD",393,239,"1200x900",800,0,600,400,"True",114,231,248,17,17,1
"E07LD",394,287,"1200x900",800,0,600,400,"True",120,567,592,25,25,1
"E07LD",395,461,"1200x900",1000,0,600,400,"True",95,711,675,-36,36,1
"E07LD",396,266,"1200x900",800,0,600,400,"True",126,303,322,19,19,1
"E07LD",397,264,"1200x900",800,0,600,400,"False",198,660,570,-90,90,1
"E07LD",398,560,"1200x900",1000,1,600,400,"True",516,693,703,10,10,0
"E07LD",399,625,"1200x900",1000,2,600,400,"False",279,228,601,373,373,0
"E07LD",400,275,"1200x900",800,0,600,400,"False",120,594,770,176,176,0
"E07LD",401,215,"1200x900",600,2,600,400,"True",939,596,582,-14,14,0
"E07LD",402,451,"1200x900",1000,0,600,400,"True",110,702,774,72,72,1
"E07LD",403,356,"1200x900",800,1,600,400,"True",123,484,417,-67,67,0
"E07LD",404,586,"1200x900",1000,2,600,400,"False",802,262,388,126,126,0
"E07LD",405,91,"1200x900",600,1,600,400,"False",417,630,446,-184,184,1
"E07LD",406,205,"1200x900",600,2,600,400,"True",1021,504,479,-25,25,0
"E07LD",407,65,"1200x900",600,0,600,400,"True",442,645,609,-36,36,1
"E07LD",408,123,"1200x900",600,1,600,400,"False",761,365,305,-60,60,1
"E07LD",409,533,"1200x900",1000,1,600,400,"False",355,483,379,-104,104,0
"E07LD",410,622,"1200x900",1000,2,600,400,"False",307,683,448,-235,235,0
"E07LD",411,579,"1200x900",1000,2,600,400,"False",803,394,636,242,242,0
"E07LD",412,24,"1200x900",600,0,600,400,"True",430,538,582,44,44,1
"E07LD",414,646,"1200x900",1000,2,600,400,"False",829,227,375,148,148,1
"E07LD",415,304,"1200x900",800,1,600,400,"True",667,605,574,-31,31,0
"E07LD",416,25,"1200x900",600,0,600,400,"False",263,403,473,70,70,1
"E07LD",417,552,"1200x900",1000,1,600,400,"False",255,412,760,348,348,0
"E07LD",418,67,"1200x900",600,0,600,400,"False",289,308,439,131,131,1
"E07LD",419,426,"1200x900",800,2,600,400,"False",830,263,481,218,218,0
"E07LD",420,122,"1200x900",600,1,600,400,"False",817,709,369,-340,340,0
"E07LD",421,535,"1200x900",1000,1,600,400,"False",372,410,496,86,86,0
"E07LD",422,186,"1200x900",600,2,600,400,"False",997,197,388,191,191,0
"E07LD",423,33,"1200x900",600,0,600,400,"False",198,533,420,-113,113,1
"E07LD",424,334,"1200x900",800,1,600,400,"False",481,665,560,-105,105,0
"E07LD",425,526,"1200x900",1000,1,600,400,"True",497,710,735,25,25,0
"E07LD",426,111,"1200x900",600,1,600,400,"True",922,552,607,55,55,1
"E07LD",427,454,"1200x900",1000,0,600,400,"True",78,687,717,30,30,1
"E07LD",428,585,"1200x900",1000,2,600,400,"True",698,688,656,-32,32,1
"E07LD",429,114,"1200x900",600,1,600,400,"False",183,697,500,-197,197,0
"E07LD",430,449,"1200x900",1000,0,600,400,"True",105,683,752,69,69,1
"E07LD",431,602,"1200x900",1000,2,600,400,"True",865,452,401,-51,51,0
"E07LD",432,97,"1200x900",600,1,600,400,"False",760,643,501,-142,142,1
"E07LD",433,116,"1200x900",600,1,600,400,"False",767,289,561,272,272,0
"E07LD",434,8,"1200x900",600,0,600,400,"True",156,679,638,-41,41,0
"E07LD",435,174,"1200x900",600,2,600,400,"False",998,457,629,172,172,0
"E07LD",436,191,"1200x900",600,2,600,400,"True",962,396,398,2,2,0
"E07LD",437,150,"1200x900",600,2,600,400,"True",897,345,428,83,83,0
"E07LD",438,616,"1200x900",1000,2,600,400,"False",854,357,750,393,393,1
"E07LD",439,490,"1200x900",1000,0,600,400,"False",114,183,497,314,314,1
"E07LD",440,261,"1200x900",800,0,600,400,"True",86,713,715,2,2,1
"E07LD",441,328,"1200x900",800,1,600,400,"False",104,649,431,-218,218,0
"E07LD",442,632,"1200x900",1000,2,600,400,"True",984,227,250,23,23,0
"E07LD",443,76,"1200x900",600,1,600,400,"False",647,614,503,-111,111,0
"E07LD",444,299,"1200x900",800,1,600,400,"False",779,274,551,277,277,0
"E07LD",445,401,"1200x900",800,2,600,400,"False",821,260,436,176,176,0
"E07LD",446,72,"1200x900",600,0,600,400,"False",158,537,457,-80,80,0
"E07LD",447,71,"1200x900",600,0,600,400,"True",219,248,259,11,11,0
"E07LD",448,398,"1200x900",800,2,600,400,"False",944,698,587,-111,111,0
"E07LD",449,242,"1200x900",800,0,600,400,"False",117,448,568,120,120,1
"E07LD",450,149,"1200x900",600,2,600,400,"False",890,289,616,327,327,0
"E07LD",451,237,"1200x900",800,0,600,400,"True",204,481,503,22,22,1
"E07LD",452,148,"1200x900",600,2,600,400,"True",907,330,402,72,72,0
"E07LD",453,143,"1200x900",600,1,600,400,"False",479,284,547,263,263,1
"E07LD",454,175,"1200x900",600,2,600,400,"False",1028,432,297,-135,135,0
"E07LD",455,5,"1200x900",600,0,600,400,"False",228,587,514,-73,73,0
"E07LD",456,115,"1200x900",600,1,600,400,"True",545,307,277,-30,30,0
"E07LD",457,392,"1200x900",800,2,600,400,"False",1031,618,409,-209,209,0
"E07LD",458,21,"1200x900",600,0,600,400,"True",314,383,337,-46,46,1
"E07LD",460,450,"1200x900",1000,0,600,400,"True",130,204,195,-9,9,1
"E07LD",461,48,"1200x900",600,0,600,400,"True",323,645,639,-6,6,1
"E07LD",462,303,"1200x900",800,1,600,400,"True",241,431,438,7,7,0
"E07LD",463,487,"1200x900",1000,0,600,400,"True",78,670,638,-32,32,1
"E07LD",464,324,"1200x900",800,1,600,400,"False",719,712,306,-406,406,1
"E07LD",465,90,"1200x900",600,1,600,400,"False",560,474,392,-82,82,0
"E07LD",466,22,"1200x900",600,0,600,400,"True",398,591,572,-19,19,1
"E07LD",467,307,"1200x900",800,1,600,400,"False",716,247,362,115,115,0
"E07LD",468,431,"1200x900",800,2,600,400,"False",694,382,555,173,173,0
"E07LD",469,563,"1200x900",1000,1,600,400,"False",201,696,486,-210,210,0
"E07LD",470,101,"1200x900",600,1,600,400,"False",541,656,744,88,88,0
"E07LD",471,36,"1200x900",600,0,600,400,"True",128,346,387,41,41,1
"E07LD",472,437,"1200x900",1000,0,600,400,"True",74,667,639,-28,28,1
"E07LD",473,606,"1200x900",1000,2,600,400,"True",653,627,557,-70,70,0
"E07LD",474,117,"1200x900",600,1,600,400,"True",711,456,481,25,25,0
"E07LD",475,472,"1200x900",1000,0,600,400,"True",77,685,670,-15,15,1
"E07LD",476,182,"1200x900",600,2,600,400,"True",933,389,342,-47,47,0
"E07LD",477,19,"1200x900",600,0,600,400,"True",286,686,673,-13,13,0
"E07LD",478,61,"1200x900",600,0,600,400,"True",272,670,670,0,0,1
"E07LD",479,645,"1200x900",1000,2,600,400,"True",619,396,472,76,76,0
"E07LD",480,335,"1200x900",800,1,600,400,"True",124,360,283,-77,77,0
"E07LD",481,633,"1200x900",1000,2,600,400,"True",564,253,230,-23,23,0
"E07LD",482,469,"1200x900",1000,0,600,400,"False",73,227,327,100,100,1
"E07LD",483,594,"1200x900",1000,2,600,400,"False",537,637,251,-386,386,0
"E07LD",484,421,"1200x900",800,2,600,400,"False",898,394,540,146,146,0
"E07LD",485,600,"1200x900",1000,2,600,400,"False",765,207,296,89,89,0
"E07LD",486,453,"1200x900",1000,0,600,400,"False",71,393,283,-110,110,1
"E07LD",487,583,"1200x900",1000,2,600,400,"False",949,284,178,-106,106,1
"E07LD",488,545,"1200x900",1000,1,600,400,"False",358,562,432,-130,130,0
"E07LD",489,105,"1200x900",600,1,600,400,"False",527,440,557,117,117,0
"E07LD",490,291,"1200x900",800,1,600,400,"True",522,694,636,-58,58,0
"E07LD",491,301,"1200x900",800,1,600,400,"True",162,574,585,11,11,0
"E07LD",492,305,"1200x900",800,1,600,400,"True",471,716,745,29,29,0
"E07LD",493,388,"1200x900",800,2,600,400,"False",930,320,516,196,196,0
"E07LD",494,457,"1200x900",1000,0,600,400,"False",97,630,790,160,160,1
"E07LD",495,542,"1200x900",1000,1,600,400,"True",304,401,475,74,74,0
"E07LD",496,284,"1200x900",800,0,600,400,"False",135,293,207,-86,86,1
"E07LD",497,277,"1200x900",800,0,600,400,"False",140,310,208,-102,102,1
"E07LD",498,202,"1200x900",600,2,600,400,"True",966,460,530,70,70,0
"E07LD",499,438,"1200x900",1000,0,600,400,"True",77,713,738,25,25,1
"E07LD",500,458,"1200x900",1000,0,600,400,"False",78,624,736,112,112,1
"E07LD",501,41,"1200x900",600,0,600,400,"True",370,452,470,18,18,1
"E07LD",502,308,"1200x900",800,1,600,400,"False",437,425,627,202,202,0
"E07LD",503,14,"1200x900",600,0,600,400,"True",399,224,191,-33,33,1
"E07LD",504,403,"1200x900",800,2,600,400,"False",625,704,378,-326,326,0
"E07LD",505,413,"1200x900",800,2,600,400,"False",849,506,419,-87,87,0
"E07LD",506,514,"1200x900",1000,1,600,400,"True",539,690,655,-35,35,0
"E07LD",507,273,"1200x900",800,0,600,400,"False",180,309,375,66,66,1
"E07LD",508,368,"1200x900",800,2,600,400,"True",778,515,544,29,29,0
"E07LD",509,584,"1200x900",1000,2,600,400,"True",731,413,485,72,72,0
"E07LD",511,30,"1200x900",600,0,600,400,"True",107,353,353,0,0,0
"E07LD",512,93,"1200x900",600,1,600,400,"False",139,540,452,-88,88,0
"E07LD",513,610,"1200x900",1000,2,600,400,"True",702,293,379,86,86,0
"E07LD",514,574,"1200x900",1000,1,600,400,"True",614,194,201,7,7,0
"E07LD",515,455,"1200x900",1000,0,600,400,"False",107,718,583,-135,135,1
"E07LD",516,337,"1200x900",800,1,600,400,"True",299,622,540,-82,82,0
"E07LD",517,528,"1200x900",1000,1,600,400,"False",839,227,351,124,124,1
"E07LD",518,134,"1200x900",600,1,600,400,"False",300,188,114,-74,74,0
"E07LD",519,113,"1200x900",600,1,600,400,"False",897,657,342,-315,315,0
"E07LD",520,555,"1200x900",1000,1,600,400,"True",444,556,536,-20,20,0
"E07LD",521,615,"1200x900",1000,2,600,400,"True",736,634,591,-43,43,0
"E07LD",522,58,"1200x900",600,0,600,400,"True",353,655,699,44,44,1
"E07LD",523,430,"1200x900",800,2,600,400,"False",922,254,362,108,108,0
"E07LD",524,64,"1200x900",600,0,600,400,"True",102,339,324,-15,15,0
"E07LD",525,548,"1200x900",1000,1,600,400,"False",103,278,391,113,113,0
"E07LD",526,136,"1200x900",600,1,600,400,"False",264,205,509,304,304,0
"E07LD",527,581,"1200x900",1000,2,600,400,"False",310,357,469,112,112,0
"E07LD",528,163,"1200x900",600,2,600,400,"False",1046,665,446,-219,219,0
"E07LD",529,199,"1200x900",600,2,600,400,"True",992,467,483,16,16,0
"E07LD",530,66,"1200x900",600,0,600,400,"True",155,673,636,-37,37,0
"E07LD",531,523,"1200x900",1000,1,600,400,"False",339,318,455,137,137,0
"E07LD",532,249,"1200x900",800,0,600,400,"False",126,306,425,119,119,1
"E07LD",533,479,"1200x900",1000,0,600,400,"False",74,705,618,-87,87,1
"E07LD",534,280,"1200x900",800,0,600,400,"False",104,302,437,135,135,1
"E07LD",535,259,"1200x900",800,0,600,400,"False",156,180,258,78,78,1
"E07LD",536,419,"1200x900",800,2,600,400,"True",769,351,388,37,37,0
"E07LD",537,227,"1200x900",800,0,600,400,"True",196,551,565,14,14,1
"E07LD",538,424,"1200x900",800,2,600,400,"False",903,545,377,-168,168,0
"E07LD",539,503,"1200x900",1000,0,600,400,"True",86,279,317,38,38,1
"E07LD",540,391,"1200x900",800,2,600,400,"True",895,521,563,42,42,0
"E07LD",541,138,"1200x900",600,1,600,400,"False",844,580,646,66,66,1
"E07LD",542,362,"1200x900",800,2,600,400,"False",819,338,416,78,78,0
"E07LD",543,87,"1200x900",600,1,600,400,"False",231,604,484,-120,120,0
"E07LD",544,463,"1200x900",1000,0,600,400,"True",115,693,756,63,63,1
"E07LD",545,187,"1200x900",600,2,600,400,"False",857,639,533,-106,106,0
"E07LD",546,104,"1200x900",600,1,600,400,"False",448,584,659,75,75,0
"E07LD",547,500,"1200x900",1000,0,600,400,"False",105,700,778,78,78,1
"E07LD",548,466,"1200x900",1000,0,600,400,"False",82,205,283,78,78,1
"E07LD",549,587,"1200x900",1000,2,600,400,"False",741,686,445,-241,241,0
"E07LD",550,34,"1200x900",600,0,600,400,"True",361,242,260,18,18,1
"E07LD",551,558,"1200x900",1000,1,600,400,"False",72,464,545,81,81,1
"E07LD",552,309,"1200x900",800,1,600,400,"False",186,225,470,245,245,0
"E07LD",554,562,"1200x900",1000,1,600,400,"False",347,540,419,-121,121,0
"E07LD",555,541,"1200x900",1000,1,600,400,"True",339,478,491,13,13,0
"E07LD",556,447,"1200x900",1000,0,600,400,"False",71,339,421,82,82,1
"E07LD",557,169,"1200x900",600,2,600,400,"True",924,290,318,28,28,0
"E07LD",558,250,"1200x900",800,0,600,400,"False",290,248,325,77,77,1
"E07LD",559,106,"1200x900",600,1,600,400,"True",803,659,695,36,36,1
"E07LD",560,224,"1200x900",800,0,600,400,"False",161,474,572,98,98,1
"E07LD",561,129,"1200x900",600,1,600,400,"False",859,482,380,-102,102,1
"E07LD",562,465,"1200x900",1000,0,600,400,"True",85,203,249,46,46,1
"E07LD",563,297,"1200x900",800,1,600,400,"True",625,244,287,43,43,0
"E07LD",564,40,"1200x900",600,0,600,400,"True",143,513,507,-6,6,0
"E07LD",565,254,"1200x900",800,0,600,400,"False",136,583,676,93,93,1
"E07LD",566,121,"1200x900",600,1,600,400,"True",884,364,417,53,53,0
"E07LD",567,195,"1200x900",600,2,600,400,"False",942,249,357,108,108,0
"E07LD",568,344,"1200x900",800,1,600,400,"False",589,408,308,-100,100,0
"E07LD",569,316,"1200x900",800,1,600,400,"False",362,319,591,272,272,0
"E07LD",570,38,"1200x900",600,0,600,400,"True",120,628,687,59,59,1
"E07LD",571,460,"1200x900",1000,0,600,400,"False",155,189,346,157,157,1
"E07LD",572,539,"1200x900",1000,1,600,400,"True",510,383,342,-41,41,0
"E07LD",573,554,"1200x900",1000,1,600,400,"False",79,309,166,-143,143,1
"E07LD",574,332,"1200x900",800,1,600,400,"False",260,699,583,-116,116,0
"E07LD",575,313,"1200x900",800,1,600,400,"True",588,421,453,32,32,0
"E07LD",576,452,"1200x900",1000,0,600,400,"True",97,273,325,52,52,1
"E07LD",577,531,"1200x900",1000,1,600,400,"False",233,362,477,115,115,0
"E07LD",578,151,"1200x900",600,2,600,400,"True",828,680,616,-64,64,0
"E07LD",579,352,"1200x900",800,1,600,400,"False",235,717,559,-158,158,0
"E07LD",580,364,"1200x900",800,2,600,400,"False",1018,204,677,473,473,0
"E07LD",581,543,"1200x900",1000,1,600,400,"False",88,202,549,347,347,0
"E07LD",582,78,"1200x900",600,1,600,400,"True",885,684,657,-27,27,0
"E07LD",583,144,"1200x900",600,1,600,400,"False",718,371,505,134,134,0
"E07LD",584,642,"1200x900",1000,2,600,400,"True",776,316,303,-13,13,0
"E07LD",585,73,"1200x900",600,1,600,400,"True",94,665,675,10,10,0
"E07LD",586,416,"1200x900",800,2,600,400,"False",748,617,450,-167,167,0
"E07LD",587,302,"1200x900",800,1,600,400,"False",479,467,295,-172,172,1
"E07LD",588,17,"1200x900",600,0,600,400,"True",402,496,550,54,54,1
"E07LD",589,478,"1200x900",1000,0,600,400,"True",79,672,624,-48,48,1
"E07LD",590,488,"1200x900",1000,0,600,400,"True",129,687,654,-33,33,1
"E07LD",591,260,"1200x900",800,0,600,400,"False",103,525,716,191,191,1
"E07LD",592,504,"1200x900",1000,0,600,400,"False",107,699,616,-83,83,1
"E07LD",594,351,"1200x900",800,1,600,400,"True",122,581,548,-33,33,0
"E07LD",595,383,"1200x900",800,2,600,400,"True",855,407,369,-38,38,0
"E07LD",596,162,"1200x900",600,2,600,400,"False",849,279,442,163,163,0
"E07LD",597,423,"1200x900",800,2,600,400,"True",1051,710,620,-90,90,1
"E07LD",598,198,"1200x900",600,2,600,400,"True",976,500,525,25,25,0
"E07LD",599,234,"1200x900",800,0,600,400,"True",72,344,372,28,28,1
"E07LD",600,381,"1200x900",800,2,600,400,"True",705,408,475,67,67,0
"E07LD",601,634,"1200x900",1000,2,600,400,"False",735,313,395,82,82,0
"E07LD",602,568,"1200x900",1000,1,600,400,"False",286,475,603,128,128,1
"E07LD",603,128,"1200x900",600,1,600,400,"False",661,258,432,174,174,1
"E07LD",604,253,"1200x900",800,0,600,400,"True",177,424,426,2,2,1
"E07LD",605,353,"1200x900",800,1,600,400,"False",90,476,630,154,154,0
"E07LD",606,377,"1200x900",800,2,600,400,"False",683,388,484,96,96,0
"E07LD",607,164,"1200x900",600,2,600,400,"False",1051,268,419,151,151,0
"E07LD",608,576,"1200x900",1000,1,600,400,"False",376,713,559,-154,154,0
"E07LD",609,82,"1200x900",600,1,600,400,"False",108,213,475,262,262,0
"E07LD",610,596,"1200x900",1000,2,600,400,"True",706,513,494,-19,19,0
"E07LD",611,285,"1200x900",800,0,600,400,"False",237,396,496,100,100,1
"E07LD",612,459,"1200x900",1000,0,600,400,"True",70,645,636,-9,9,1
"E07LD",613,42,"1200x900",600,0,600,400,"True",233,479,433,-46,46,0
"E07LD",614,281,"1200x900",800,0,600,400,"False",112,611,539,-72,72,1
"E07LD",615,608,"1200x900",1000,2,600,400,"False",742,250,380,130,130,0
"E07LD",616,145,"1200x900",600,2,600,400,"False",1004,630,514,-116,116,0
"E07LD",617,200,"1200x900",600,2,600,400,"False",897,302,419,117,117,0
"E07LD",618,499,"1200x900",1000,0,600,400,"False",93,271,369,98,98,1
"E07LD",619,502,"1200x900",1000,0,600,400,"True",111,639,684,45,45,1
"E07LD",620,532,"1200x900",1000,1,600,400,"False",215,207,318,111,111,0
"E07LD",621,369,"1200x900",800,2,600,400,"True",903,594,495,-99,99,0
"E07LD",622,520,"1200x900",1000,1,600,400,"False",564,260,387,127,127,0
"E07LD",623,511,"1200x900",1000,1,600,400,"False",408,390,631,241,241,1
"E07LD",624,434,"1200x900",1000,0,600,400,"False",89,657,562,-95,95,1
"E07LD",625,436,"1200x900",1000,0,600,400,"True",82,617,653,36,36,1
"E07LD",626,211,"1200x900",600,2,600,400,"False",986,407,337,-70,70,0
"E07LD",627,406,"1200x900",800,2,600,400,"False",971,233,598,365,365,0
"E07LD",628,188,"1200x900",600,2,600,400,"False",900,195,455,260,260,0
"E07LD",629,112,"1200x900",600,1,600,400,"False",681,490,360,-130,130,0
"E07LD",630,638,"1200x900",1000,2,600,400,"True",385,198,277,79,79,0
"E07LD",631,591,"1200x900",1000,2,600,400,"False",698,336,587,251,251,0
"E07LD",632,559,"1200x900",1000,1,600,400,"False",641,244,335,91,91,0
"E07LD",633,60,"1200x900",600,0,600,400,"False",365,213,122,-91,91,1
"E07LD",634,214,"1200x900",600,2,600,400,"True",1046,305,339,34,34,0
"E07LD",635,513,"1200x900",1000,1,600,400,"False",235,602,260,-342,342,0
"E07LD",636,173,"1200x900",600,2,600,400,"False",948,693,380,-313,313,0
"E07LD",637,534,"1200x900",1000,1,600,400,"False",328,504,612,108,108,1
"E07LD",638,160,"1200x900",600,2,600,400,"False",863,606,417,-189,189,0
"E07LD",639,54,"1200x900",600,0,600,400,"False",474,564,658,94,94,1
"E07LD",640,357,"1200x900",800,1,600,400,"True",109,594,601,7,7,0
"E07LD",641,75,"1200x900",600,1,600,400,"True",635,558,512,-46,46,0
"E07LD",642,384,"1200x900",800,2,600,400,"False",821,707,421,-286,286,0
"E07LD",643,230,"1200x900",800,0,600,400,"True",99,678,697,19,19,1
"E07LD",644,81,"1200x900",600,1,600,400,"False",696,225,347,122,122,0
"E07LD",645,387,"1200x900",800,2,600,400,"False",990,444,292,-152,152,0
"E07LD",646,29,"1200x900",600,0,600,400,"True",385,533,497,-36,36,1
"E07LD",647,408,"1200x900",800,2,600,400,"False",758,567,396,-171,171,0
"E07LD",648,595,"1200x900",1000,2,600,400,"False",687,640,530,-110,110,0
"E07SM",1,528,"1200x900",1000,1,600,400,"False",839,227,764,537,537,1
"E07SM",2,31,"1200x900",600,0,600,400,"True",365,338,333,-5,5,1
"E07SM",3,344,"1200x900",800,1,600,400,"False",589,408,563,155,155,0
"E07SM",4,453,"1200x900",1000,0,600,400,"False",71,393,561,168,168,1
"E07SM",5,577,"1200x900",1000,2,600,400,"True",455,420,386,-34,34,0
"E07SM",6,373,"1200x900",800,2,600,400,"True",694,326,362,36,36,0
"E07SM",7,83,"1200x900",600,1,600,400,"False",763,568,351,-217,217,1
"E07SM",8,161,"1200x900",600,2,600,400,"False",939,553,314,-239,239,0
"E07SM",9,598,"1200x900",1000,2,600,400,"False",706,559,757,198,198,0
"E07SM",10,374,"1200x900",800,2,600,400,"False",755,450,548,98,98,0
"E07SM",11,147,"1200x900",600,2,600,400,"True",942,418,385,-33,33,0
"E07SM",12,473,"1200x900",1000,0,600,400,"False",75,323,414,91,91,1
"E07SM",13,128,"1200x900",600,1,600,400,"False",661,258,96,-162,162,1
"E07SM",14,75,"1200x900",600,1,600,400,"True",635,558,577,19,19,0
"E07SM",15,501,"1200x900",1000,0,600,400,"False",96,323,489,166,166,1
"E07SM",16,480,"1200x900",1000,0,600,400,"False",100,231,438,207,207,1
"E07SM",17,159,"1200x900",600,2,600,400,"False",992,309,187,-122,122,0
"E07SM",18,448,"1200x900",1000,0,600,400,"False",107,641,432,-209,209,1
"E07SM",19,300,"1200x900",800,1,600,400,"False",620,693,447,-246,246,0
"E07SM",20,144,"1200x900",600,1,600,400,"True",718,371,360,-11,11,0
"E07SM",21,74,"1200x900",600,1,600,400,"True",115,358,412,54,54,0
"E07SM",22,431,"1200x900",800,2,600,400,"False",694,382,444,62,62,0
"E07SM",23,223,"1200x900",800,0,600,400,"True",179,191,139,-52,52,1
"E07SM",24,338,"1200x900",800,1,600,400,"False",813,253,646,393,393,1
"E07SM",25,572,"1200x900",1000,1,600,400,"True",302,260,294,34,34,0
"E07SM",26,445,"1200x900",1000,0,600,400,"False",78,302,425,123,123,1
"E07SM",27,316,"1200x900",800,1,600,400,"True",362,319,336,17,17,0
"E07SM",28,470,"1200x900",1000,0,600,400,"False",91,666,556,-110,110,1
"E07SM",29,17,"1200x900",600,0,600,400,"False",402,496,415,-81,81,1
"E07SM",30,417,"1200x900",800,2,600,400,"False",750,280,580,300,300,0
"E07SM",31,210,"1200x900",600,2,600,400,"False",835,506,361,-145,145,0
"E07SM",32,381,"1200x900",800,2,600,400,"False",705,408,500,92,92,0
"E07SM",33,507,"1200x900",1000,1,600,400,"False",608,583,343,-240,240,1
"E07SM",34,456,"1200x900",1000,0,600,400,"False",91,257,408,151,151,1
"E07SM",35,256,"1200x900",800,0,600,400,"False",192,656,336,-320,320,1
"E07SM",36,41,"1200x900",600,0,600,400,"False",370,452,381,-71,71,1
"E07SM",37,241,"1200x900",800,0,600,400,"False",129,227,353,126,126,1
"E07SM",38,471,"1200x900",1000,0,600,400,"True",122,200,241,41,41,1
"E07SM",39,234,"1200x900",800,0,600,400,"False",72,344,220,-124,124,1
"E07SM",40,237,"1200x900",800,0,600,400,"True",204,481,484,3,3,1
"E07SM",41,235,"1200x900",800,0,600,400,"True",146,646,672,26,26,1
"E07SM",42,173,"1200x900",600,2,600,400,"True",948,693,741,48,48,0
"E07SM",43,550,"1200x900",1000,1,600,400,"False",301,459,615,156,156,0
"E07SM",44,454,"1200x900",1000,0,600,400,"False",78,687,765,78,78,1
"E07SM",45,540,"1200x900",1000,1,600,400,"False",389,568,469,-99,99,1
"E07SM",46,514,"1200x900",1000,1,600,400,"True",539,690,729,39,39,0
"E07SM",47,521,"1200x900",1000,1,600,400,"False",111,303,113,-190,190,1
"E07SM",48,6,"1200x900",600,0,600,400,"False",217,689,557,-132,132,1
"E07SM",49,49,"1200x900",600,0,600,400,"True",109,380,426,46,46,0
"E07SM",50,204,"1200x900",600,2,600,400,"False",1053,432,201,-231,231,0
"E07SM",51,176,"1200x900",600,2,600,400,"True",1033,281,339,58,58,0
"E07SM",52,332,"1200x900",800,1,600,400,"False",260,699,762,63,63,0
"E07SM",53,112,"1200x900",600,1,600,400,"False",681,490,276,-214,214,0
"E07SM",54,134,"1200x900",600,1,600,400,"True",300,188,215,27,27,0
"E07SM",55,394,"1200x900",800,2,600,400,"True",847,292,217,-75,75,0
"E07SM",56,379,"1200x900",800,2,600,400,"False",994,325,456,131,131,0
"E07SM",57,458,"1200x900",1000,0,600,400,"False",78,624,530,-94,94,1
"E07SM",58,334,"1200x900",800,1,600,400,"True",481,665,714,49,49,0
"E07SM",59,274,"1200x900",800,0,600,400,"True",146,497,553,56,56,1
"E07SM",60,389,"1200x900",800,2,600,400,"False",843,530,364,-166,166,0
"E07SM",61,7,"1200x900",600,0,600,400,"False",431,654,571,-83,83,1
"E07SM",62,588,"1200x900",1000,2,600,400,"False",585,350,194,-156,156,0
"E07SM",63,503,"1200x900",1000,0,600,400,"True",86,279,340,61,61,1
"E07SM",64,628,"1200x900",1000,2,600,400,"True",768,410,363,-47,47,0
"E07SM",65,252,"1200x900",800,0,600,400,"False",224,673,459,-214,214,1
"E07SM",66,198,"1200x900",600,2,600,400,"False",976,500,559,59,59,0
"E07SM",67,280,"1200x900",800,0,600,400,"False",104,302,387,85,85,1
"E07SM",68,266,"1200x900",800,0,600,400,"False",126,303,378,75,75,1
"E07SM",69,382,"1200x900",800,2,600,400,"False",870,523,408,-115,115,0
"E07SM",70,191,"1200x900",600,2,600,400,"False",962,396,252,-144,144,0
"E07SM",71,449,"1200x900",1000,0,600,400,"False",105,683,582,-101,101,1
"E07SM",72,451,"1200x900",1000,0,600,400,"False",110,702,471,-231,231,1
"E07SM",73,287,"1200x900",800,0,600,400,"True",120,567,574,7,7,1
"E07SM",74,608,"1200x900",1000,2,600,400,"False",742,250,598,348,348,0
"E07SM",75,535,"1200x900",1000,1,600,400,"False",372,410,153,-257,257,0
"E07SM",76,508,"1200x900",1000,1,600,400,"True",596,485,439,-46,46,0
"E07SM",77,135,"1200x900",600,1,600,400,"True",759,569,550,-19,19,0
"E07SM",78,472,"1200x900",1000,0,600,400,"False",77,685,487,-198,198,1
"E07SM",79,2,"1200x900",600,0,600,400,"False",159,323,420,97,97,0
"E07SM",80,12,"1200x900",600,0,600,400,"True",365,336,350,14,14,1
"E07SM",81,376,"1200x900",800,2,600,400,"True",788,275,281,6,6,0
"E07SM",82,111,"1200x900",600,1,600,400,"True",922,552,535,-17,17,1
"E07SM",83,548,"1200x900",1000,1,600,400,"False",103,278,419,141,141,0
"E07SM",84,34,"1200x900",600,0,600,400,"True",361,242,198,-44,44,1
"E07SM",85,20,"1200x900",600,0,600,400,"False",204,545,408,-137,137,1
"E07SM",86,27,"1200x900",600,0,600,400,"True",373,309,276,-33,33,1
"E07SM",87,447,"1200x900",1000,0,600,400,"False",71,339,404,65,65,1
"E07SM",88,299,"1200x900",800,1,600,400,"False",779,274,632,358,358,0
"E07SM",89,103,"1200x900",600,1,600,400,"False",528,320,422,102,102,1
"E07SM",90,236,"1200x900",800,0,600,400,"False",162,350,279,-71,71,1
"E07SM",91,437,"1200x900",1000,0,600,400,"False",74,667,463,-204,204,1
"E07SM",92,321,"1200x900",800,1,600,400,"True",601,190,227,37,37,0
"E07SM",93,366,"1200x900",800,2,600,400,"False",931,464,376,-88,88,0
"E07SM",94,278,"1200x900",800,0,600,400,"False",251,711,564,-147,147,1
"E07SM",95,238,"1200x900",800,0,600,400,"False",162,283,395,112,112,1
"E07SM",96,591,"1200x900",1000,2,600,400,"True",698,336,374,38,38,0
"E07SM",97,126,"1200x900",600,1,600,400,"True",849,354,335,-19,19,0
"E07SM",98,258,"1200x900",800,0,600,400,"False",126,664,397,-267,267,1
"E07SM",99,584,"1200x900",1000,2,600,400,"False",731,413,518,105,105,0
"E07SM",100,585,"1200x900",1000,2,600,400,"False",698,688,507,-181,181,1
"E07SM",101,462,"1200x900",1000,0,600,400,"False",102,672,520,-152,152,1
"E07SM",102,189,"1200x900",600,2,600,400,"True",881,397,465,68,68,0
"E07SM",103,571,"1200x900",1000,1,600,400,"False",239,522,710,188,188,1
"E07SM",104,215,"1200x900",600,2,600,400,"False",939,596,766,170,170,0
"E07SM",105,183,"1200x900",600,2,600,400,"False",927,289,414,125,125,0
"E07SM",106,216,"1200x900",600,2,600,400,"False",1029,286,196,-90,90,0
"E07SM",107,117,"1200x900",600,1,600,400,"False",711,456,54,-402,402,0
"E07SM",108,368,"1200x900",800,2,600,400,"False",778,515,373,-142,142,0
"E07SM",109,369,"1200x900",800,2,600,400,"False",903,594,657,63,63,0
"E07SM",110,224,"1200x900",800,0,600,400,"False",161,474,565,91,91,1
"E07SM",111,428,"1200x900",800,2,600,400,"False",732,665,513,-152,152,0
"E07SM",112,222,"1200x900",800,0,600,400,"False",152,206,362,156,156,1
"E07SM",113,33,"1200x900",600,0,600,400,"True",198,533,531,-2,2,1
"E07SM",114,627,"1200x900",1000,2,600,400,"False",760,510,324,-186,186,0
"E07SM",115,91,"1200x900",600,1,600,400,"True",417,630,601,-29,29,1
"E07SM",116,22,"1200x900",600,0,600,400,"True",398,591,575,-16,16,1
"E07SM",117,181,"1200x900",600,2,600,400,"True",1018,223,308,85,85,0
"E07SM",118,343,"1200x900",800,1,600,400,"False",407,557,432,-125,125,0
"E07SM",119,479,"1200x900",1000,0,600,400,"False",74,705,496,-209,209,1
"E07SM",120,347,"1200x900",800,1,600,400,"False",757,295,594,299,299,1
"E07SM",121,148,"1200x900",600,2,600,400,"True",907,330,382,52,52,0
"E07SM",122,570,"1200x900",1000,1,600,400,"True",315,352,350,-2,2,0
"E07SM",123,304,"1200x900",800,1,600,400,"False",667,605,254,-351,351,0
"E07SM",124,494,"1200x900",1000,0,600,400,"False",127,692,441,-251,251,1
"E07SM",125,426,"1200x900",800,2,600,400,"False",830,263,150,-113,113,0
"E07SM",126,647,"1200x900",1000,2,600,400,"False",560,637,309,-328,328,0
"E07SM",127,80,"1200x900",600,1,600,400,"True",616,423,439,16,16,1
"E07SM",128,444,"1200x900",1000,0,600,400,"False",101,714,442,-272,272,1
"E07SM",129,603,"1200x900",1000,2,600,400,"False",693,280,138,-142,142,0
"E07SM",130,605,"1200x900",1000,2,600,400,"False",493,665,142,-523,523,0
"E07SM",131,429,"1200x900",800,2,600,400,"False",682,692,834,142,142,0
"E07SM",132,151,"1200x900",600,2,600,400,"True",828,680,682,2,2,0
"E07SM",133,434,"1200x900",1000,0,600,400,"False",89,657,514,-143,143,1
"E07SM",134,446,"1200x900",1000,0,600,400,"False",72,298,435,137,137,1
"E07SM",135,89,"1200x900",600,1,600,400,"False",917,366,520,154,154,1
"E07SM",136,187,"1200x900",600,2,600,400,"False",857,639,505,-134,134,0
"E07SM",137,468,"1200x900",1000,0,600,400,"False",121,219,470,251,251,1
"E07SM",138,175,"1200x900",600,2,600,400,"True",1028,432,393,-39,39,0
"E07SM",139,545,"1200x900",1000,1,600,400,"False",358,562,493,-69,69,0
"E07SM",140,56,"1200x900",600,0,600,400,"True",148,491,537,46,46,0
"E07SM",141,277,"1200x900",800,0,600,400,"False",140,310,494,184,184,1
"E07SM",142,557,"1200x900",1000,1,600,400,"True",677,505,502,-3,3,1
"E07SM",143,51,"1200x900",600,0,600,400,"True",272,181,198,17,17,1
"E07SM",144,177,"1200x900",600,2,600,400,"False",912,236,153,-83,83,0
"E07SM",145,28,"1200x900",600,0,600,400,"False",336,410,318,-92,92,1
"E07SM",146,555,"1200x900",1000,1,600,400,"False",444,556,666,110,110,0
"E07SM",147,415,"1200x900",800,2,600,400,"True",823,684,648,-36,36,0
"E07SM",148,92,"1200x900",600,1,600,400,"False",624,605,710,105,105,0
"E07SM",149,57,"1200x900",600,0,600,400,"True",354,508,534,26,26,1
"E07SM",150,388,"1200x900",800,2,600,400,"False",930,320,508,188,188,0
"E07SM",151,281,"1200x900",800,0,600,400,"True",112,611,592,-19,19,1
"E07SM",152,496,"1200x900",1000,0,600,400,"False",70,639,501,-138,138,1
"E07SM",153,385,"1200x900",800,2,600,400,"False",740,456,556,100,100,0
"E07SM",154,101,"1200x900",600,1,600,400,"True",541,656,632,-24,24,0
"E07SM",155,602,"1200x900",1000,2,600,400,"True",865,452,493,41,41,0
"E07SM",156,214,"1200x900",600,2,600,400,"True",1046,305,403,98,98,0
"E07SM",157,621,"1200x900",1000,2,600,400,"False",540,478,327,-151,151,0
"E07SM",158,264,"1200x900",800,0,600,400,"False",198,660,553,-107,107,1
"E07SM",159,510,"1200x900",1000,1,600,400,"False",486,338,203,-135,135,1
"E07SM",160,77,"1200x900",600,1,600,400,"True",780,525,484,-41,41,0
"E07SM",161,172,"1200x900",600,2,600,400,"False",912,444,337,-107,107,0
"E07SM",162,209,"1200x900",600,2,600,400,"True",937,637,564,-73,73,0
"E07SM",163,562,"1200x900",1000,1,600,400,"True",347,540,591,51,51,0
"E07SM",164,154,"1200x900",600,2,600,400,"False",941,454,352,-102,102,0
"E07SM",165,486,"1200x900",1000,0,600,400,"False",102,676,501,-175,175,1
"E07SM",166,8,"1200x900",600,0,600,400,"True",156,679,696,17,17,0
"E07SM",167,262,"1200x900",800,0,600,400,"True",196,481,457,-24,24,1
"E07SM",168,54,"1200x900",600,0,600,400,"False",474,564,445,-119,119,1
"E07SM",169,371,"1200x900",800,2,600,400,"True",730,560,537,-23,23,0
"E07SM",170,76,"1200x900",600,1,600,400,"True",647,614,612,-2,2,0
"E07SM",171,513,"1200x900",1000,1,600,400,"False",235,602,522,-80,80,0
"E07SM",172,635,"1200x900",1000,2,600,400,"False",833,402,131,-271,271,0
"E07SM",173,539,"1200x900",1000,1,600,400,"True",510,383,348,-35,35,0
"E07SM",174,433,"1200x900",1000,0,600,400,"True",76,222,273,51,51,1
"E07SM",175,537,"1200x900",1000,1,600,400,"False",621,412,640,228,228,1
"E07SM",176,1,"1200x900",600,0,600,400,"True",136,502,466,-36,36,0
"E07SM",177,167,"1200x900",600,2,600,400,"True",956,241,253,12,12,0
"E07SM",178,143,"1200x900",600,1,600,400,"False",479,284,377,93,93,1
"E07SM",179,359,"1200x900",800,1,600,400,"True",653,241,182,-59,59,0
"E07SM",180,4,"1200x900",600,0,600,400,"False",602,200,352,152,152,1
"E07SM",181,474,"1200x900",1000,0,600,400,"False",85,339,440,101,101,1
"E07SM",182,73,"1200x900",600,1,600,400,"False",94,665,465,-200,200,0
"E07SM",183,596,"1200x900",1000,2,600,400,"False",706,513,672,159,159,0
"E07SM",184,587,"1200x900",1000,2,600,400,"False",741,686,119,-567,567,0
"E07SM",185,418,"1200x900",800,2,600,400,"False",754,507,169,-338,338,0
"E07SM",186,575,"1200x900",1000,1,600,400,"False",272,693,560,-133,133,0
"E07SM",187,427,"1200x900",800,2,600,400,"False",812,380,287,-93,93,0
"E07SM",188,240,"1200x900",800,0,600,400,"False",330,656,452,-204,204,1
"E07SM",189,469,"1200x900",1000,0,600,400,"False",73,227,349,122,122,1
"E07SM",190,245,"1200x900",800,0,600,400,"False",296,235,449,214,214,1
"E07SM",191,71,"1200x900",600,0,600,400,"False",219,248,354,106,106,0
"E07SM",192,644,"1200x900",1000,2,600,400,"False",495,486,386,-100,100,0
"E07SM",193,3,"1200x900",600,0,600,400,"True",298,443,465,22,22,1
"E07SM",194,384,"1200x900",800,2,600,400,"False",821,707,560,-147,147,0
"E07SM",195,363,"1200x900",800,2,600,400,"False",800,218,418,200,200,0
"E07SM",196,170,"1200x900",600,2,600,400,"False",996,468,138,-330,330,0
"E07SM",197,414,"1200x900",800,2,600,400,"False",831,592,479,-113,113,0
"E07SM",198,586,"1200x900",1000,2,600,400,"False",802,262,577,315,315,0
"E07SM",199,125,"1200x900",600,1,600,400,"True",750,531,469,-62,62,0
"E07SM",200,392,"1200x900",800,2,600,400,"True",1031,618,627,9,9,0
"E07SM",201,524,"1200x900",1000,1,600,400,"True",534,470,520,50,50,0
"E07SM",202,595,"1200x900",1000,2,600,400,"False",687,640,144,-496,496,0
"E07SM",203,530,"1200x900",1000,1,600,400,"False",584,405,230,-175,175,1
"E07SM",204,477,"1200x900",1000,0,600,400,"False",88,640,397,-243,243,1
"E07SM",205,408,"1200x900",800,2,600,400,"False",758,567,628,61,61,0
"E07SM",206,546,"1200x900",1000,1,600,400,"True",305,374,355,-19,19,0
"E07SM",207,409,"1200x900",800,2,600,400,"False",501,659,466,-193,193,0
"E07SM",208,254,"1200x900",800,0,600,400,"False",136,583,501,-82,82,1
"E07SM",209,634,"1200x900",1000,2,600,400,"False",735,313,528,215,215,0
"E07SM",210,554,"1200x900",1000,1,600,400,"False",79,309,77,-232,232,1
"E07SM",211,229,"1200x900",800,0,600,400,"True",117,697,635,-62,62,1
"E07SM",212,244,"1200x900",800,0,600,400,"True",194,203,176,-27,27,1
"E07SM",213,406,"1200x900",800,2,600,400,"False",971,233,488,255,255,0
"E07SM",214,565,"1200x900",1000,1,600,400,"True",451,562,544,-18,18,0
"E07SM",215,438,"1200x900",1000,0,600,400,"False",77,713,491,-222,222,1
"E07SM",216,102,"1200x900",600,1,600,400,"True",861,603,552,-51,51,0
"E07SM",217,569,"1200x900",1000,1,600,400,"False",494,720,263,-457,457,0
"E07SM",218,336,"1200x900",800,1,600,400,"True",251,587,553,-34,34,0
"E07SM",219,309,"1200x900",800,1,600,400,"False",186,225,444,219,219,0
"E07SM",220,412,"1200x900",800,2,600,400,"False",842,280,206,-74,74,0
"E07SM",221,105,"1200x900",600,1,600,400,"False",527,440,620,180,180,0
"E07SM",222,250,"1200x900",800,0,600,400,"False",290,248,311,63,63,1
"E07SM",223,646,"1200x900",1000,2,600,400,"True",829,227,205,-22,22,1
"E07SM",224,478,"1200x900",1000,0,600,400,"False",79,672,465,-207,207,1
"E07SM",225,60,"1200x900",600,0,600,400,"False",365,213,318,105,105,1
"E07SM",226,282,"1200x900",800,0,600,400,"True",109,246,253,7,7,1
"E07SM",227,378,"1200x900",800,2,600,400,"False",1018,708,145,-563,563,0
"E07SM",228,493,"1200x900",1000,0,600,400,"False",80,582,394,-188,188,1
"E07SM",229,421,"1200x900",800,2,600,400,"False",898,394,136,-258,258,0
"E07SM",230,251,"1200x900",800,0,600,400,"False",88,352,458,106,106,1
"E07SM",231,350,"1200x900",800,1,600,400,"False",182,566,371,-195,195,0
"E07SM",232,36,"1200x900",600,0,600,400,"True",128,346,293,-53,53,1
"E07SM",233,295,"1200x900",800,1,600,400,"True",471,334,337,3,3,0
"E07SM",234,476,"1200x900",1000,0,600,400,"False",76,359,444,85,85,1
"E07SM",235,455,"1200x900",1000,0,600,400,"False",107,718,461,-257,257,1
"E07SM",236,463,"1200x900",1000,0,600,400,"False",115,693,538,-155,155,1
"E07SM",237,345,"1200x900",800,1,600,400,"False",841,566,659,93,93,1
"E07SM",238,636,"1200x900",1000,2,600,400,"False",575,583,477,-106,106,0
"E07SM",239,194,"1200x900",600,2,600,400,"False",896,236,337,101,101,0
"E07SM",240,81,"1200x900",600,1,600,400,"False",696,225,298,73,73,0
"E07SM",241,249,"1200x900",800,0,600,400,"True",126,306,343,37,37,1
"E07SM",242,255,"1200x900",800,0,600,400,"False",93,709,538,-171,171,1
"E07SM",243,68,"1200x900",600,0,600,400,"True",165,367,440,73,73,0
"E07SM",244,182,"1200x900",600,2,600,400,"False",933,389,149,-240,240,0
"E07SM",245,367,"1200x900",800,2,600,400,"True",613,464,470,6,6,0
"E07SM",246,467,"1200x900",1000,0,600,400,"False",74,712,500,-212,212,1
"E07SM",247,171,"1200x900",600,2,600,400,"True",909,200,287,87,87,0
"E07SM",248,610,"1200x900",1000,2,600,400,"False",702,293,123,-170,170,0
"E07SM",249,522,"1200x900",1000,1,600,400,"False",223,379,456,77,77,0
"E07SM",250,99,"1200x900",600,1,600,400,"True",811,407,390,-17,17,0
"E07SM",251,576,"1200x900",1000,1,600,400,"True",376,713,694,-19,19,0
"E07SM",252,544,"1200x900",1000,1,600,400,"False",602,620,411,-209,209,0
"E07SM",253,460,"1200x900",1000,0,600,400,"False",155,189,420,231,231,1
"E07SM",254,391,"1200x900",800,2,600,400,"False",895,521,275,-246,246,0
"E07SM",255,624,"1200x900",1000,2,600,400,"False",693,501,181,-320,320,0
"E07SM",256,169,"1200x900",600,2,600,400,"False",924,290,145,-145,145,0
"E07SM",257,94,"1200x900",600,1,600,400,"False",729,482,559,77,77,0
"E07SM",258,648,"1200x900",1000,2,600,400,"False",557,394,165,-229,229,0
"E07SM",259,330,"1200x900",800,1,600,400,"False",759,301,189,-112,112,1
"E07SM",260,594,"1200x900",1000,2,600,400,"False",537,637,507,-130,130,0
"E07SM",261,202,"1200x900",600,2,600,400,"False",966,460,325,-135,135,0
"E07SM",262,643,"1200x900",1000,2,600,400,"True",740,325,330,5,5,0
"E07SM",263,325,"1200x900",800,1,600,400,"False",105,394,263,-131,131,0
"E07SM",264,62,"1200x900",600,0,600,400,"True",345,346,366,20,20,1
"E07SM",265,360,"1200x900",800,1,600,400,"True",203,608,610,2,2,0
"E07SM",266,564,"1200x900",1000,1,600,400,"True",215,264,310,46,46,0
"E07SM",267,606,"1200x900",1000,2,600,400,"True",653,627,655,28,28,0
"E07SM",268,393,"1200x900",800,2,600,400,"False",657,620,538,-82,82,0
"E07SM",269,308,"1200x900",800,1,600,400,"False",437,425,520,95,95,0
"E07SM",270,265,"1200x900",800,0,600,400,"False",229,353,571,218,218,1
"E07SM",271,326,"1200x900",800,1,600,400,"False",103,482,396,-86,86,0
"E07SM",272,405,"1200x900",800,2,600,400,"False",790,307,500,193,193,0
"E07SM",273,259,"1200x900",800,0,600,400,"False",156,180,358,178,178,1
"E07SM",274,272,"1200x900",800,0,600,400,"False",200,181,311,130,130,1
"E07SM",275,13,"1200x900",600,0,600,400,"False",296,211,290,79,79,1
"E07SM",276,131,"1200x900",600,1,600,400,"True",531,367,275,-92,92,0
"E07SM",277,339,"1200x900",800,1,600,400,"False",273,545,303,-242,242,1
"E07SM",278,82,"1200x900",600,1,600,400,"False",108,213,410,197,197,0
"E07SM",279,261,"1200x900",800,0,600,400,"True",86,713,728,15,15,1
"E07SM",280,140,"1200x900",600,1,600,400,"True",700,523,557,34,34,0
"E07SM",281,380,"1200x900",800,2,600,400,"False",942,228,357,129,129,0
"E07SM",282,165,"1200x900",600,2,600,400,"True",912,554,481,-73,73,0
"E07SM",283,211,"1200x900",600,2,600,400,"True",986,407,447,40,40,0
"E07SM",284,257,"1200x900",800,0,600,400,"False",97,219,462,243,243,1
"E07SM",285,440,"1200x900",1000,0,600,400,"False",71,237,413,176,176,1
"E07SM",286,10,"1200x900",600,0,600,400,"True",400,499,458,-41,41,1
"E07SM",287,155,"1200x900",600,2,600,400,"True",940,269,350,81,81,0
"E07SM",288,383,"1200x900",800,2,600,400,"False",855,407,602,195,195,0
"E07SM",289,104,"1200x900",600,1,600,400,"False",448,584,656,72,72,0
"E07SM",290,84,"1200x900",600,1,600,400,"False",144,184,281,97,97,0
"E07SM",291,11,"1200x900",600,0,600,400,"True",372,670,666,-4,4,1
"E07SM",292,139,"1200x900",600,1,600,400,"False",192,695,525,-170,170,0
"E07SM",293,637,"1200x900",1000,2,600,400,"True",750,460,508,48,48,0
"E07SM",294,107,"1200x900",600,1,600,400,"True",878,678,667,-11,11,0
"E07SM",295,239,"1200x900",800,0,600,400,"False",114,231,422,191,191,1
"E07SM",296,542,"1200x900",1000,1,600,400,"False",304,401,218,-183,183,0
"E07SM",297,53,"1200x900",600,0,600,400,"False",177,189,286,97,97,0
"E07SM",298,21,"1200x900",600,0,600,400,"True",314,383,364,-19,19,1
"E07SM",299,616,"1200x900",1000,2,600,400,"False",854,357,257,-100,100,1
"E07SM",300,410,"1200x900",800,2,600,400,"False",916,477,197,-280,280,0
"E07SM",301,581,"1200x900",1000,2,600,400,"False",310,357,120,-237,237,0
"E07SM",302,413,"1200x900",800,2,600,400,"True",849,506,479,-27,27,0
"E07SM",303,59,"1200x900",600,0,600,400,"True",391,692,685,-7,7,1
"E07SM",304,484,"1200x900",1000,0,600,400,"False",100,223,478,255,255,1
"E07SM",305,44,"1200x900",600,0,600,400,"True",305,554,505,-49,49,1
"E07SM",306,631,"1200x900",1000,2,600,400,"False",699,479,637,158,158,0
"E07SM",307,490,"1200x900",1000,0,600,400,"False",114,183,476,293,293,1
"E07SM",308,620,"1200x900",1000,2,600,400,"False",832,649,492,-157,157,0
"E07SM",309,195,"1200x900",600,2,600,400,"False",942,249,190,-59,59,0
"E07SM",310,64,"1200x900",600,0,600,400,"True",102,339,362,23,23,0
"E07SM",311,301,"1200x900",800,1,600,400,"False",162,574,483,-91,91,0
"E07SM",312,230,"1200x900",800,0,600,400,"False",99,678,581,-97,97,1
"E07SM",313,592,"1200x900",1000,2,600,400,"False",492,392,640,248,248,0
"E07SM",314,320,"1200x900",800,1,600,400,"False",644,376,505,129,129,0
"E07SM",315,464,"1200x900",1000,0,600,400,"False",82,222,401,179,179,1
"E07SM",316,407,"1200x900",800,2,600,400,"False",989,340,157,-183,183,0
"E07SM",317,357,"1200x900",800,1,600,400,"False",109,594,476,-118,118,0
"E07SM",318,543,"1200x900",1000,1,600,400,"False",88,202,440,238,238,0
"E07SM",319,178,"1200x900",600,2,600,400,"False",1041,510,652,142,142,0
"E07SM",320,398,"1200x900",800,2,600,400,"False",944,698,473,-225,225,0
"E07SM",321,200,"1200x900",600,2,600,400,"False",897,302,433,131,131,0
"E07SM",322,38,"1200x900",600,0,600,400,"False",120,628,525,-103,103,1
"E07SM",323,130,"1200x900",600,1,600,400,"True",741,428,416,-12,12,0
"E07SM",324,465,"1200x900",1000,0,600,400,"False",85,203,429,226,226,1
"E07SM",325,98,"1200x900",600,1,600,400,"True",625,530,497,-33,33,0
"E07SM",326,228,"1200x900",800,0,600,400,"True",174,687,620,-67,67,1
"E07SM",327,52,"1200x900",600,0,600,400,"True",171,188,245,57,57,0
"E07SM",328,312,"1200x900",800,1,600,400,"True",238,683,604,-79,79,0
"E07SM",329,443,"1200x900",1000,0,600,400,"False",99,651,450,-201,201,1
"E07SM",330,523,"1200x900",1000,1,600,400,"False",339,318,401,83,83,0
"E07SM",331,499,"1200x900",1000,0,600,400,"False",93,271,356,85,85,1
"E07SM",332,397,"1200x900",800,2,600,400,"False",817,692,541,-151,151,0
"E07SM",333,419,"1200x900",800,2,600,400,"True",769,351,362,11,11,0
"E07SM",334,362,"1200x900",800,2,600,400,"False",819,338,466,128,128,0
"E07SM",335,399,"1200x900",800,2,600,400,"False",603,602,414,-188,188,0
"E07SM",336,475,"1200x900",1000,0,600,400,"False",101,715,517,-198,198,1
"E07SM",337,355,"1200x900",800,1,600,400,"False",77,386,452,66,66,0
"E07SM",338,441,"1200x900",1000,0,600,400,"False",85,684,541,-143,143,1
"E07SM",339,78,"1200x900",600,1,600,400,"False",885,684,742,58,58,0
"E07SM",340,116,"1200x900",600,1,600,400,"False",767,289,148,-141,141,0
"E07SM",341,273,"1200x900",800,0,600,400,"False",180,309,372,63,63,1
"E07SM",342,63,"1200x900",600,0,600,400,"True",311,188,229,41,41,1
"E07SM",343,520,"1200x900",1000,1,600,400,"False",564,260,366,106,106,0
"E07SM",344,435,"1200x900",1000,0,600,400,"False",119,200,375,175,175,1
"E07SM",345,335,"1200x900",800,1,600,400,"True",124,360,370,10,10,0
"E07SM",346,233,"1200x900",800,0,600,400,"True",164,700,750,50,50,1
"E07SM",347,288,"1200x900",800,0,600,400,"True",180,547,534,-13,13,1
"E07SM",348,61,"1200x900",600,0,600,400,"False",272,670,550,-120,120,1
"E07SM",349,55,"1200x900",600,0,600,400,"True",211,305,321,16,16,1
"E07SM",350,500,"1200x900",1000,0,600,400,"False",105,700,450,-250,250,1
"E07SM",351,395,"1200x900",800,2,600,400,"False",743,334,541,207,207,0
"E07SM",352,333,"1200x900",800,1,600,400,"True",521,548,535,-13,13,0
"E07SM",353,168,"1200x900",600,2,600,400,"False",1001,439,206,-233,233,0
"E07SM",354,203,"1200x900",600,2,600,400,"False",938,603,476,-127,127,0
"E07SM",355,85,"1200x900",600,1,600,400,"False",434,347,616,269,269,0
"E07SM",356,536,"1200x900",1000,1,600,400,"True",580,213,259,46,46,0
"E07SM",357,629,"1200x900",1000,2,600,400,"False",681,257,489,232,232,0
"E07SM",358,23,"1200x900",600,0,600,400,"True",308,463,476,13,13,1
"E07SM",359,504,"1200x900",1000,0,600,400,"False",107,699,570,-129,129,1
"E07SM",360,340,"1200x900",800,1,600,400,"False",226,240,398,158,158,0
"E07SM",361,450,"1200x900",1000,0,600,400,"False",130,204,406,202,202,1
"E07SM",362,618,"1200x900",1000,2,600,400,"False",276,671,517,-154,154,0
"E07SM",363,190,"1200x900",600,2,600,400,"True",977,238,330,92,92,0
"E07SM",364,342,"1200x900",800,1,600,400,"False",677,204,372,168,168,0
"E07SM",365,270,"1200x900",800,0,600,400,"True",192,418,422,4,4,1
"E07SM",366,9,"1200x900",600,0,600,400,"False",509,654,423,-231,231,1
"E07SM",367,517,"1200x900",1000,1,600,400,"True",548,182,247,65,65,0
"E07SM",368,600,"1200x900",1000,2,600,400,"False",765,207,458,251,251,0
"E07SM",369,341,"1200x900",800,1,600,400,"False",735,632,365,-267,267,1
"E07SM",370,201,"1200x900",600,2,600,400,"False",1005,462,239,-223,223,0
"E07SM",371,582,"1200x900",1000,2,600,400,"True",554,347,293,-54,54,0
"E07SM",372,15,"1200x900",600,0,600,400,"True",473,352,410,58,58,1
"E07SM",373,184,"1200x900",600,2,600,400,"False",1067,441,688,247,247,0
"E07SM",374,123,"1200x900",600,1,600,400,"True",761,365,387,22,22,1
"E07SM",375,516,"1200x900",1000,1,600,400,"False",440,559,440,-119,119,0
"E07SM",376,72,"1200x900",600,0,600,400,"True",158,537,531,-6,6,0
"E07SM",377,124,"1200x900",600,1,600,400,"False",345,467,402,-65,65,0
"E07SM",378,396,"1200x900",800,2,600,400,"False",678,663,497,-166,166,0
"E07SM",379,212,"1200x900",600,2,600,400,"False",841,206,286,80,80,0
"E07SM",380,315,"1200x900",800,1,600,400,"False",105,211,110,-101,101,0
"E07SM",381,285,"1200x900",800,0,600,400,"False",237,396,496,100,100,1
"E07SM",382,289,"1200x900",800,1,600,400,"True",421,703,620,-83,83,1
"E07SM",383,218,"1200x900",800,0,600,400,"False",106,397,582,185,185,1
"E07SM",384,639,"1200x900",1000,2,600,400,"False",504,456,682,226,226,0
"E07SM",385,206,"1200x900",600,2,600,400,"False",975,223,642,419,419,0
"E07SM",386,145,"1200x900",600,2,600,400,"True",1004,630,686,56,56,0
"E07SM",387,509,"1200x900",1000,1,600,400,"False",509,434,522,88,88,0
"E07SM",388,227,"1200x900",800,0,600,400,"True",196,551,609,58,58,1
"E07SM",389,601,"1200x900",1000,2,600,400,"False",735,697,348,-349,349,0
"E07SM",390,129,"1200x900",600,1,600,400,"False",859,482,210,-272,272,1
"E07SM",391,221,"1200x900",800,0,600,400,"False",132,520,373,-147,147,1
"E07SM",392,622,"1200x900",1000,2,600,400,"False",307,683,584,-99,99,0
"E07SM",393,361,"1200x900",800,2,600,400,"True",931,328,340,12,12,0
"E07SM",394,95,"1200x900",600,1,600,400,"False",749,425,630,205,205,1
"E07SM",395,100,"1200x900",600,1,600,400,"True",453,511,593,82,82,0
"E07SM",396,318,"1200x900",800,1,600,400,"False",788,534,687,153,153,0
"E07SM",397,425,"1200x900",800,2,600,400,"True",621,438,513,75,75,0
"E07SM",398,502,"1200x900",1000,0,600,400,"False",111,639,527,-112,112,1
"E07SM",399,619,"1200x900",1000,2,600,400,"False",803,247,723,476,476,0
"E07SM",400,442,"1200x900",1000,0,600,400,"False",87,183,491,308,308,1
"E07SM",401,364,"1200x900",800,2,600,400,"False",1018,204,470,266,266,0
"E07SM",402,604,"1200x900",1000,2,600,400,"True",459,593,543,-50,50,0
"E07SM",403,137,"1200x900",600,1,600,400,"True",789,577,536,-41,41,0
"E07SM",404,46,"1200x900",600,0,600,400,"True",193,355,414,59,59,1
"E07SM",405,298,"1200x900",800,1,600,400,"True",311,457,402,-55,55,0
"E07SM",406,423,"1200x900",800,2,600,400,"True",1051,710,608,-102,102,1
"E07SM",407,488,"1200x900",1000,0,600,400,"False",129,687,504,-183,183,1
"E07SM",408,609,"1200x900",1000,2,600,400,"True",697,627,561,-66,66,0
"E07SM",409,630,"1200x900",1000,2,600,400,"True",754,559,536,-23,23,0
"E07SM",410,109,"1200x900",600,1,600,400,"True",691,589,623,34,34,0
"E07SM",411,141,"1200x900",600,1,600,400,"False",671,582,453,-129,129,0
"E07SM",412,487,"1200x900",1000,0,600,400,"False",78,670,543,-127,127,1
"E07SM",413,242,"1200x900",800,0,600,400,"True",117,448,470,22,22,1
"E07SM",414,260,"1200x900",800,0,600,400,"False",103,525,393,-132,132,1
"E07SM",415,583,"1200x900",1000,2,600,400,"True",949,284,267,-17,17,1
"E07SM",416,180,"1200x900",600,2,600,400,"False",929,270,185,-85,85,0
"E07SM",417,213,"1200x900",600,2,600,400,"True",822,275,222,-53,53,0
"E07SM",418,515,"1200x900",1000,1,600,400,"False",307,217,316,99,99,0
"E07SM",419,220,"1200x900",800,0,600,400,"False",108,699,581,-118,118,1
"E07SM",420,353,"1200x900",800,1,600,400,"False",90,476,640,164,164,0
"E07SM",421,193,"1200x900",600,2,600,400,"False",874,588,711,123,123,0
"E07SM",422,558,"1200x900",1000,1,600,400,"False",72,464,664,200,200,1
"E07SM",423,430,"1200x900",800,2,600,400,"True",922,254,292,38,38,0
"E07SM",424,160,"1200x900",600,2,600,400,"True",863,606,588,-18,18,0
"E07SM",425,424,"1200x900",800,2,600,400,"False",903,545,420,-125,125,0
"E07SM",426,197,"1200x900",600,2,600,400,"False",903,212,436,224,224,0
"E07SM",427,246,"1200x900",800,0,600,400,"True",196,418,450,32,32,1
"E07SM",428,519,"1200x900",1000,1,600,400,"True",319,565,612,47,47,1
"E07SM",429,313,"1200x900",800,1,600,400,"True",588,421,449,28,28,0
"E07SM",430,331,"1200x900",800,1,600,400,"False",240,620,683,63,63,0
"E07SM",431,267,"1200x900",800,0,600,400,"True",145,665,656,-9,9,1
"E07SM",432,574,"1200x900",1000,1,600,400,"False",614,194,591,397,397,0
"E07SM",433,561,"1200x900",1000,1,600,400,"False",231,406,507,101,101,0
"E07SM",434,5,"1200x900",600,0,600,400,"True",228,587,529,-58,58,0
"E07SM",435,589,"1200x900",1000,2,600,400,"False",856,418,597,179,179,0
"E07SM",436,402,"1200x900",800,2,600,400,"False",878,234,342,108,108,0
"E07SM",437,386,"1200x900",800,2,600,400,"True",774,301,290,-11,11,0
"E07SM",438,292,"1200x900",800,1,600,400,"False",88,565,644,79,79,0
"E07SM",439,199,"1200x900",600,2,600,400,"False",992,467,156,-311,311,0
"E07SM",440,166,"1200x900",600,2,600,400,"True",896,274,259,-15,15,0
"E07SM",441,114,"1200x900",600,1,600,400,"False",183,697,544,-153,153,0
"E07SM",442,459,"1200x900",1000,0,600,400,"False",70,645,575,-70,70,1
"E07SM",443,286,"1200x900",800,0,600,400,"False",105,378,479,101,101,1
"E07SM",444,67,"1200x900",600,0,600,400,"False",289,308,403,95,95,1
"E07SM",445,66,"1200x900",600,0,600,400,"True",155,673,734,61,61,0
"E07SM",446,566,"1200x900",1000,1,600,400,"False",378,472,185,-287,287,1
"E07SM",447,404,"1200x900",800,2,600,400,"False",842,396,267,-129,129,0
"E07SM",448,623,"1200x900",1000,2,600,400,"False",636,527,201,-326,326,0
"E07SM",449,547,"1200x900",1000,1,600,400,"False",369,384,462,78,78,1
"E07SM",450,263,"1200x900",800,0,600,400,"False",82,396,516,120,120,1
"E07SM",451,400,"1200x900",800,2,600,400,"True",733,297,333,36,36,0
"E07SM",452,466,"1200x900",1000,0,600,400,"False",82,205,291,86,86,1
"E07SM",453,188,"1200x900",600,2,600,400,"True",900,195,230,35,35,0
"E07SM",454,149,"1200x900",600,2,600,400,"False",890,289,185,-104,104,0
"E07SM",455,96,"1200x900",600,1,600,400,"True",433,458,544,86,86,0
"E07SM",456,568,"1200x900",1000,1,600,400,"True",286,475,454,-21,21,1
"E07SM",457,483,"1200x900",1000,0,600,400,"False",93,191,407,216,216,1
"E07SM",458,387,"1200x900",800,2,600,400,"False",990,444,230,-214,214,0
"E07SM",459,351,"1200x900",800,1,600,400,"True",122,581,540,-41,41,0
"E07SM",460,311,"1200x900",800,1,600,400,"False",710,261,489,228,228,0
"E07SM",461,208,"1200x900",600,2,600,400,"True",946,399,377,-22,22,0
"E07SM",462,42,"1200x900",600,0,600,400,"True",233,479,451,-28,28,0
"E07SM",463,284,"1200x900",800,0,600,400,"True",135,293,313,20,20,1
"E07SM",464,58,"1200x900",600,0,600,400,"False",353,655,503,-152,152,1
"E07SM",465,346,"1200x900",800,1,600,400,"True",269,635,644,9,9,0
"E07SM",466,403,"1200x900",800,2,600,400,"False",625,704,483,-221,221,0
"E07SM",467,420,"1200x900",800,2,600,400,"False",519,223,409,186,186,0
"E07SM",468,372,"1200x900",800,2,600,400,"False",833,620,444,-176,176,0
"E07SM",469,192,"1200x900",600,2,600,400,"False",1064,320,563,243,243,0
"E07SM",470,354,"1200x900",800,1,600,400,"False",118,236,400,164,164,0
"E07SM",471,492,"1200x900",1000,0,600,400,"False",76,692,541,-151,151,1
"E07SM",472,106,"1200x900",600,1,600,400,"False",803,659,389,-270,270,1
"E07SM",473,573,"1200x900",1000,1,600,400,"True",486,615,551,-64,64,0
"E07SM",474,549,"1200x900",1000,1,600,400,"False",657,366,445,79,79,0
"E07SM",475,352,"1200x900",800,1,600,400,"False",235,717,620,-97,97,0
"E07SM",476,121,"1200x900",600,1,600,400,"True",884,364,378,14,14,0
"E07SM",477,217,"1200x900",800,0,600,400,"True",85,573,529,-44,44,1
"E07SM",478,322,"1200x900",800,1,600,400,"False",703,206,426,220,220,1
"E07SM",479,497,"1200x900",1000,0,600,400,"False",106,696,498,-198,198,1
"E07SM",480,495,"1200x900",1000,0,600,400,"True",93,692,632,-60,60,1
"E07SM",481,534,"1200x900",1000,1,600,400,"True",328,504,532,28,28,1
"E07SM",482,108,"1200x900",600,1,600,400,"False",830,239,333,94,94,0
"E07SM",483,127,"1200x900",600,1,600,400,"False",309,691,474,-217,217,0
"E07SM",484,511,"1200x900",1000,1,600,400,"True",408,390,369,-21,21,1
"E07SM",485,40,"1200x900",600,0,600,400,"True",143,513,572,59,59,0
"E07SM",486,642,"1200x900",1000,2,600,400,"False",776,316,428,112,112,0
"E07SM",487,377,"1200x900",800,2,600,400,"False",683,388,294,-94,94,0
"E07SM",488,174,"1200x900",600,2,600,400,"False",998,457,118,-339,339,0
"E07SM",489,560,"1200x900",1000,1,600,400,"False",516,693,543,-150,150,0
"E07SM",490,498,"1200x900",1000,0,600,400,"False",100,260,372,112,112,1
"E07SM",491,538,"1200x900",1000,1,600,400,"False",308,457,265,-192,192,1
"E07SM",492,16,"1200x900",600,0,600,400,"False",297,514,585,71,71,1
"E07SM",493,559,"1200x900",1000,1,600,400,"True",641,244,246,2,2,0
"E07SM",494,253,"1200x900",800,0,600,400,"False",177,424,501,77,77,1
"E07SM",495,411,"1200x900",800,2,600,400,"False",805,361,248,-113,113,0
"E07SM",496,296,"1200x900",800,1,600,400,"True",89,279,252,-27,27,0
"E07SM",497,328,"1200x900",800,1,600,400,"False",104,649,420,-229,229,0
"E07SM",498,283,"1200x900",800,0,600,400,"True",90,264,315,51,51,1
"E07SM",499,45,"1200x900",600,0,600,400,"False",487,678,502,-176,176,1
"E07SM",500,365,"1200x900",800,2,600,400,"False",1055,305,528,223,223,0
"E07SM",501,70,"1200x900",600,0,600,400,"True",309,703,740,37,37,1
"E07SM",502,279,"1200x900",800,0,600,400,"False",252,202,485,283,283,1
"E07SM",503,268,"1200x900",800,0,600,400,"True",148,400,366,-34,34,1
"E07SM",504,158,"1200x900",600,2,600,400,"False",939,300,224,-76,76,0
"E07SM",505,50,"1200x900",600,0,600,400,"False",75,582,477,-105,105,0
"E07SM",506,275,"1200x900",800,0,600,400,"False",120,594,440,-154,154,0
"E07SM",507,115,"1200x900",600,1,600,400,"False",545,307,421,114,114,0
"E07SM",508,205,"1200x900",600,2,600,400,"False",1021,504,563,59,59,0
"E07SM",509,307,"1200x900",800,1,600,400,"False",716,247,320,73,73,0
"E07SM",510,432,"1200x900",800,2,600,400,"False",792,380,209,-171,171,0
"E07SM",511,390,"1200x900",800,2,600,400,"True",982,674,656,-18,18,1
"E07SM",512,452,"1200x900",1000,0,600,400,"False",97,273,474,201,201,1
"E07SM",513,375,"1200x900",800,2,600,400,"True",716,384,330,-54,54,0
"E07SM",514,310,"1200x900",800,1,600,400,"False",559,592,522,-70,70,0
"E07SM",515,633,"1200x900",1000,2,600,400,"False",564,253,515,262,262,0
"E07SM",516,297,"1200x900",800,1,600,400,"True",625,244,265,21,21,0
"E07SM",517,531,"1200x900",1000,1,600,400,"True",233,362,332,-30,30,0
"E07SM",518,416,"1200x900",800,2,600,400,"False",748,617,190,-427,427,0
"E07SM",519,69,"1200x900",600,0,600,400,"True",322,268,285,17,17,0
"E07SM",520,317,"1200x900",800,1,600,400,"True",185,564,462,-102,102,0
"E07SM",521,303,"1200x900",800,1,600,400,"True",241,431,400,-31,31,0
"E07SM",522,641,"1200x900",1000,2,600,400,"False",897,272,747,475,475,0
"E07SM",523,86,"1200x900",600,1,600,400,"True",692,388,443,55,55,1
"E07SM",524,156,"1200x900",600,2,600,400,"True",913,197,242,45,45,0
"E07SM",525,219,"1200x900",800,0,600,400,"True",202,502,512,10,10,1
"E07SM",526,119,"1200x900",600,1,600,400,"False",168,563,461,-102,102,0
"E07SM",527,306,"1200x900",800,1,600,400,"True",164,524,561,37,37,0
"E07SM",528,186,"1200x900",600,2,600,400,"True",997,197,217,20,20,0
"E07SM",529,196,"1200x900",600,2,600,400,"False",1030,397,136,-261,261,0
"E07SM",530,551,"1200x900",1000,1,600,400,"True",146,445,481,36,36,1
"E07SM",531,518,"1200x900",1000,1,600,400,"False",583,717,264,-453,453,0
"E07SM",532,505,"1200x900",1000,1,600,400,"True",191,484,444,-40,40,1
"E07SM",533,32,"1200x900",600,0,600,400,"True",152,563,524,-39,39,1
"E07SM",534,37,"1200x900",600,0,600,400,"True",258,403,400,-3,3,1
"E07SM",535,525,"1200x900",1000,1,600,400,"False",123,690,459,-231,231,0
"E07SM",536,614,"1200x900",1000,2,600,400,"False",823,563,362,-201,201,0
"E07SM",537,349,"1200x900",800,1,600,400,"False",402,665,264,-401,401,0
"E07SM",538,556,"1200x900",1000,1,600,400,"False",415,420,601,181,181,0
"E07SM",539,39,"1200x900",600,0,600,400,"True",210,609,638,29,29,0
"E07SM",540,97,"1200x900",600,1,600,400,"True",760,643,617,-26,26,1
"E07SM",541,231,"1200x900",800,0,600,400,"False",251,718,649,-69,69,1
"E07SM",542,79,"1200x900",600,1,600,400,"False",731,289,522,233,233,0
"E07SM",543,271,"1200x900",800,0,600,400,"True",74,360,366,6,6,1
"E07SM",544,122,"1200x900",600,1,600,400,"False",817,709,500,-209,209,0
"E07SM",545,24,"1200x900",600,0,600,400,"False",430,538,460,-78,78,1
"E07SM",546,133,"1200x900",600,1,600,400,"True",345,551,525,-26,26,0
"E07SM",547,35,"1200x900",600,0,600,400,"True",366,555,568,13,13,1
"E07SM",548,553,"1200x900",1000,1,600,400,"False",116,712,454,-258,258,0
"E07SM",549,25,"1200x900",600,0,600,400,"True",263,403,438,35,35,1
"E07SM",550,138,"1200x900",600,1,600,400,"False",844,580,705,125,125,1
"E07SM",551,48,"1200x900",600,0,600,400,"True",323,645,649,4,4,1
"E07SM",552,90,"1200x900",600,1,600,400,"False",560,474,367,-107,107,0
"E07SM",553,436,"1200x900",1000,0,600,400,"False",82,617,419,-198,198,1
"E07SM",554,136,"1200x900",600,1,600,400,"False",264,205,380,175,175,0
"E07SM",555,142,"1200x900",600,1,600,400,"False",286,474,567,93,93,0
"E07SM",556,529,"1200x900",1000,1,600,400,"True",267,412,364,-48,48,1
"E07SM",557,243,"1200x900",800,0,600,400,"True",114,332,386,54,54,1
"E07SM",558,512,"1200x900",1000,1,600,400,"False",139,261,452,191,191,0
"E07SM",559,337,"1200x900",800,1,600,400,"True",299,622,677,55,55,0
"E07SM",560,146,"1200x900",600,2,600,400,"False",989,492,425,-67,67,0
"E07SM",561,541,"1200x900",1000,1,600,400,"True",339,478,470,-8,8,0
"E07SM",562,14,"1200x900",600,0,600,400,"False",399,224,365,141,141,1
"E07SM",563,248,"1200x900",800,0,600,400,"False",94,240,324,84,84,1
"E07SM",564,348,"1200x900",800,1,600,400,"False",764,294,388,94,94,0
"E07SM",565,18,"1200x900",600,0,600,400,"True",400,318,360,42,42,1
"E07SM",566,613,"1200x900",1000,2,600,400,"False",690,374,595,221,221,0
"E07SM",567,552,"1200x900",1000,1,600,400,"False",255,412,515,103,103,0
"E07SM",568,26,"1200x900",600,0,600,400,"False",70,712,627,-85,85,0
"E07SM",569,132,"1200x900",600,1,600,400,"True",333,185,280,95,95,0
"E07SM",570,110,"1200x900",600,1,600,400,"False",776,550,749,199,199,1
"E07SM",571,247,"1200x900",800,0,600,400,"False",160,424,504,80,80,1
"E07SM",572,626,"1200x900",1000,2,600,400,"False",329,449,360,-89,89,0
"E07SM",573,290,"1200x900",800,1,600,400,"False",789,603,486,-117,117,0
"E07SM",574,314,"1200x900",800,1,600,400,"True",277,616,664,48,48,1
"E07SM",575,30,"1200x900",600,0,600,400,"False",107,353,436,83,83,0
"E07SM",576,607,"1200x900",1000,2,600,400,"False",900,573,675,102,102,1
"E07SM",577,625,"1200x900",1000,2,600,400,"False",279,228,544,316,316,0
"E07SM",578,401,"1200x900",800,2,600,400,"False",821,260,361,101,101,0
"E07SM",579,324,"1200x900",800,1,600,400,"False",719,712,415,-297,297,1
"E07SM",580,185,"1200x900",600,2,600,400,"False",907,212,407,195,195,0
"E07SM",581,164,"1200x900",600,2,600,400,"True",1051,268,357,89,89,0
"E07SM",582,599,"1200x900",1000,2,600,400,"False",316,570,731,161,161,0
"E07SM",583,640,"1200x900",1000,2,600,400,"False",361,334,247,-87,87,0
"E07SM",584,120,"1200x900",600,1,600,400,"True",690,655,712,57,57,0
"E07SM",585,88,"1200x900",600,1,600,400,"True",186,554,557,3,3,0
"E07SM",586,611,"1200x900",1000,2,600,400,"False",414,511,371,-140,140,0
"E07SM",587,579,"1200x900",1000,2,600,400,"False",803,394,790,396,396,0
"E07SM",588,93,"1200x900",600,1,600,400,"False",139,540,415,-125,125,0
"E07SM",589,150,"1200x900",600,2,600,400,"True",897,345,305,-40,40,0
"E07SM",590,232,"1200x900",800,0,600,400,"True",84,511,500,-11,11,1
"E07SM",591,305,"1200x900",800,1,600,400,"False",471,716,637,-79,79,0
"E07SM",592,323,"1200x900",800,1,600,400,"False",388,348,508,160,160,0
"E07SM",593,638,"1200x900",1000,2,600,400,"True",385,198,184,-14,14,0
"E07SM",594,593,"1200x900",1000,2,600,400,"False",246,719,639,-80,80,0
"E07SM",595,319,"1200x900",800,1,600,400,"True",494,587,583,-4,4,1
"E07SM",596,163,"1200x900",600,2,600,400,"True",1046,665,564,-101,101,0
"E07SM",597,358,"1200x900",800,1,600,400,"False",263,635,297,-338,338,0
"E07SM",598,457,"1200x900",1000,0,600,400,"True",97,630,643,13,13,1
"E07SM",599,157,"1200x900",600,2,600,400,"True",1016,323,377,54,54,0
"E07SM",600,276,"1200x900",800,0,600,400,"False",281,217,306,89,89,1
"E07SM",601,567,"1200x900",1000,1,600,400,"False",655,297,137,-160,160,1
"E07SM",602,532,"1200x900",1000,1,600,400,"True",215,207,273,66,66,0
"E07SM",603,527,"1200x900",1000,1,600,400,"False",565,601,753,152,152,0
"E07SM",604,162,"1200x900",600,2,600,400,"True",849,279,302,23,23,0
"E07SM",605,269,"1200x900",800,0,600,400,"True",160,295,314,19,19,1
"E07SM",606,491,"1200x900",1000,0,600,400,"False",108,198,287,89,89,1
"E07SM",607,533,"1200x900",1000,1,600,400,"True",355,483,474,-9,9,0
"E07SM",608,597,"1200x900",1000,2,600,400,"False",352,239,161,-78,78,0
"E07SM",609,578,"1200x900",1000,2,600,400,"False",966,276,508,232,232,0
"E07SM",610,481,"1200x900",1000,0,600,400,"True",80,185,233,48,48,1
"E07SM",611,612,"1200x900",1000,2,600,400,"True",706,198,186,-12,12,0
"E07SM",612,152,"1200x900",600,2,600,400,"False",971,399,165,-234,234,0
"E07SM",613,485,"1200x900",1000,0,600,400,"False",121,694,500,-194,194,1
"E07SM",614,153,"1200x900",600,2,600,400,"True",1037,601,594,-7,7,0
"E07SM",615,225,"1200x900",800,0,600,400,"True",178,423,382,-41,41,1
"E07SM",616,327,"1200x900",800,1,600,400,"False",152,339,452,113,113,0
"E07SM",617,65,"1200x900",600,0,600,400,"False",442,645,506,-139,139,1
"E07SM",618,356,"1200x900",800,1,600,400,"True",123,484,411,-73,73,0
"E07SM",619,47,"1200x900",600,0,600,400,"True",303,499,490,-9,9,1
"E07SM",620,294,"1200x900",800,1,600,400,"True",262,287,342,55,55,0
"E07SM",621,632,"1200x900",1000,2,600,400,"False",984,227,545,318,318,0
"E07SM",622,113,"1200x900",600,1,600,400,"False",897,657,560,-97,97,0
"E07SM",623,329,"1200x900",800,1,600,400,"True",517,239,251,12,12,0
"E07SM",624,590,"1200x900",1000,2,600,400,"False",636,278,108,-170,170,0
"E07SM",625,615,"1200x900",1000,2,600,400,"False",736,634,748,114,114,0
"E07SM",626,118,"1200x900",600,1,600,400,"True",190,588,649,61,61,0
"E07SM",627,179,"1200x900",600,2,600,400,"True",908,602,584,-18,18,0
"E07SM",628,482,"1200x900",1000,0,600,400,"True",79,686,653,-33,33,1
"E07SM",629,370,"1200x900",800,2,600,400,"False",874,336,197,-139,139,0
"E07SM",630,617,"1200x900",1000,2,600,400,"True",294,180,204,24,24,0
"E07SM",631,43,"1200x900",600,0,600,400,"False",277,446,292,-154,154,1
"E07SM",632,563,"1200x900",1000,1,600,400,"True",201,696,757,61,61,0
"E07SM",633,506,"1200x900",1000,1,600,400,"False",559,567,314,-253,253,1
"E07SM",634,291,"1200x900",800,1,600,400,"False",522,694,626,-68,68,0
"E07SM",635,526,"1200x900",1000,1,600,400,"True",497,710,682,-28,28,0
"E07SM",636,207,"1200x900",600,2,600,400,"True",838,235,278,43,43,0
"E07SM",637,461,"1200x900",1000,0,600,400,"False",95,711,529,-182,182,1
"E07SM",638,439,"1200x900",1000,0,600,400,"False",110,229,496,267,267,1
"E07SM",639,489,"1200x900",1000,0,600,400,"False",88,604,517,-87,87,1
"E07SM",640,29,"1200x900",600,0,600,400,"True",385,533,526,-7,7,1
"E07SM",641,645,"1200x900",1000,2,600,400,"True",619,396,363,-33,33,0
"E07SM",642,87,"1200x900",600,1,600,400,"True",231,604,597,-7,7,0
"E07SM",643,293,"1200x900",800,1,600,400,"True",561,396,426,30,30,0
"E07SM",644,226,"1200x900",800,0,600,400,"True",187,229,286,57,57,1
"E07SM",645,422,"1200x900",800,2,600,400,"False",712,558,747,189,189,0
"E07SM",646,19,"1200x900",600,0,600,400,"True",286,686,665,-21,21,0
"E07SM",647,580,"1200x900",1000,2,600,400,"True",651,267,329,62,62,0
"E07SM",648,302,"1200x900",800,1,600,400,"False",479,467,640,173,173,1
"E09HT",1,299,"1200x900",800,1,600,400,"False",779,274,850,576,576,0
"E09HT",2,356,"1200x900",800,1,600,400,"False",123,484,829,345,345,0
"E09HT",3,429,"1200x900",800,2,600,400,"False",682,692,496,-196,196,0
"E09HT",4,541,"1200x900",1000,1,600,400,"False",339,478,662,184,184,0
"E09HT",5,187,"1200x900",600,2,600,400,"False",857,639,421,-218,218,0
"E09HT",6,339,"1200x900",800,1,600,400,"False",273,545,699,154,154,1
"E09HT",7,374,"1200x900",800,2,600,400,"True",755,450,464,14,14,0
"E09HT",8,67,"1200x900",600,0,600,400,"False",289,308,437,129,129,1
"E09HT",9,181,"1200x900",600,2,600,400,"False",1018,223,118,-105,105,0
"E09HT",10,368,"1200x900",800,2,600,400,"False",778,515,377,-138,138,0
"E09HT",11,407,"1200x900",800,2,600,400,"True",989,340,289,-51,51,0
"E09HT",12,128,"1200x900",600,1,600,400,"False",661,258,119,-139,139,1
"E09HT",13,40,"1200x900",600,0,600,400,"True",143,513,529,16,16,0
"E09HT",14,260,"1200x900",800,0,600,400,"False",103,525,459,-66,66,1
"E09HT",15,48,"1200x900",600,0,600,400,"True",323,645,619,-26,26,1
"E09HT",16,392,"1200x900",800,2,600,400,"True",1031,618,668,50,50,0
"E09HT",17,463,"1200x900",1000,0,600,400,"False",115,693,559,-134,134,1
"E09HT",18,639,"1200x900",1000,2,600,400,"False",504,456,372,-84,84,0
"E09HT",19,398,"1200x900",800,2,600,400,"False",944,698,554,-144,144,0
"E09HT",20,550,"1200x900",1000,1,600,400,"False",301,459,812,353,353,0
"E09HT",21,469,"1200x900",1000,0,600,400,"True",73,227,251,24,24,1
"E09HT",22,55,"1200x900",600,0,600,400,"True",211,305,349,44,44,1
"E09HT",23,196,"1200x900",600,2,600,400,"True",1030,397,299,-98,98,0
"E09HT",24,583,"1200x900",1000,2,600,400,"True",949,284,304,20,20,1
"E09HT",26,362,"1200x900",800,2,600,400,"True",819,338,292,-46,46,0
"E09HT",28,242,"1200x900",800,0,600,400,"True",117,448,406,-42,42,1
"E09HT",29,191,"1200x900",600,2,600,400,"False",962,396,222,-174,174,0
"E09HT",30,537,"1200x900",1000,1,600,400,"False",621,412,700,288,288,1
"E09HT",31,289,"1200x900",800,1,600,400,"False",421,703,509,-194,194,1
"E09HT",32,586,"1200x900",1000,2,600,400,"False",802,262,366,104,104,0
"E09HT",33,460,"1200x900",1000,0,600,400,"True",155,189,178,-11,11,1
"E09HT",34,491,"1200x900",1000,0,600,400,"True",108,198,135,-63,63,1
"E09HT",35,130,"1200x900",600,1,600,400,"True",741,428,440,12,12,0
"E09HT",36,547,"1200x900",1000,1,600,400,"False",369,384,284,-100,100,1
"E09HT",37,400,"1200x900",800,2,600,400,"False",733,297,177,-120,120,0
"E09HT",38,620,"1200x900",1000,2,600,400,"False",832,649,277,-372,372,0
"E09HT",39,428,"1200x900",800,2,600,400,"False",732,665,494,-171,171,0
"E09HT",40,516,"1200x900",1000,1,600,400,"False",440,559,454,-105,105,0
"E09HT",41,376,"1200x900",800,2,600,400,"True",788,275,255,-20,20,0
"E09HT",42,138,"1200x900",600,1,600,400,"False",844,580,817,237,237,1
"E09HT",43,543,"1200x900",1000,1,600,400,"False",88,202,523,321,321,0
"E09HT",44,622,"1200x900",1000,2,600,400,"False",307,683,325,-358,358,0
"E09HT",45,283,"1200x900",800,0,600,400,"True",90,264,240,-24,24,1
"E09HT",46,631,"1200x900",1000,2,600,400,"True",699,479,492,13,13,0
"E09HT",47,570,"1200x900",1000,1,600,400,"True",315,352,394,42,42,0
"E09HT",48,417,"1200x900",800,2,600,400,"True",750,280,233,-47,47,0
"E09HT",49,241,"1200x900",800,0,600,400,"False",129,227,104,-123,123,1
"E09HT",50,410,"1200x900",800,2,600,400,"False",916,477,372,-105,105,0
"E09HT",51,313,"1200x900",800,1,600,400,"True",588,421,461,40,40,0
"E09HT",52,492,"1200x900",1000,0,600,400,"True",76,692,769,77,77,1
"E09HT",53,297,"1200x900",800,1,600,400,"False",625,244,567,323,323,0
"E09HT",54,184,"1200x900",600,2,600,400,"True",1067,441,407,-34,34,0
"E09HT",55,385,"1200x900",800,2,600,400,"False",740,456,323,-133,133,0
"E09HT",56,51,"1200x900",600,0,600,400,"True",272,181,247,66,66,1
"E09HT",57,215,"1200x900",600,2,600,400,"False",939,596,441,-155,155,0
"E09HT",58,490,"1200x900",1000,0,600,400,"True",114,183,235,52,52,1
"E09HT",59,202,"1200x900",600,2,600,400,"False",966,460,696,236,236,0
"E09HT",60,85,"1200x900",600,1,600,400,"True",434,347,355,8,8,0
"E09HT",61,6,"1200x900",600,0,600,400,"False",217,689,589,-100,100,1
"E09HT",62,190,"1200x900",600,2,600,400,"False",977,238,50,-188,188,0
"E09HT",63,382,"1200x900",800,2,600,400,"True",870,523,513,-10,10,0
"E09HT",64,527,"1200x900",1000,1,600,400,"False",565,601,291,-310,310,0
"E09HT",65,301,"1200x900",800,1,600,400,"False",162,574,227,-347,347,0
"E09HT",66,451,"1200x900",1000,0,600,400,"True",110,702,664,-38,38,1
"E09HT",67,556,"1200x900",1000,1,600,400,"False",415,420,560,140,140,0
"E09HT",68,300,"1200x900",800,1,600,400,"False",620,693,477,-216,216,0
"E09HT",69,493,"1200x900",1000,0,600,400,"False",80,582,689,107,107,1
"E09HT",70,412,"1200x900",800,2,600,400,"True",842,280,309,29,29,0
"E09HT",71,4,"1200x900",600,0,600,400,"True",602,200,155,-45,45,1
"E09HT",72,175,"1200x900",600,2,600,400,"False",1028,432,304,-128,128,0
"E09HT",73,361,"1200x900",800,2,600,400,"True",931,328,313,-15,15,0
"E09HT",74,379,"1200x900",800,2,600,400,"True",994,325,291,-34,34,0
"E09HT",75,507,"1200x900",1000,1,600,400,"True",608,583,648,65,65,1
"E09HT",76,167,"1200x900",600,2,600,400,"False",956,241,640,399,399,0
"E09HT",77,252,"1200x900",800,0,600,400,"True",224,673,663,-10,10,1
"E09HT",78,514,"1200x900",1000,1,600,400,"True",539,690,710,20,20,0
"E09HT",79,566,"1200x900",1000,1,600,400,"True",378,472,533,61,61,1
"E09HT",80,124,"1200x900",600,1,600,400,"True",345,467,435,-32,32,0
"E09HT",81,591,"1200x900",1000,2,600,400,"False",698,336,483,147,147,0
"E09HT",82,84,"1200x900",600,1,600,400,"True",144,184,226,42,42,0
"E09HT",83,282,"1200x900",800,0,600,400,"False",109,246,50,-196,196,1
"E09HT",84,327,"1200x900",800,1,600,400,"True",152,339,320,-19,19,0
"E09HT",85,45,"1200x900",600,0,600,400,"False",487,678,528,-150,150,1
"E09HT",86,119,"1200x900",600,1,600,400,"False",168,563,466,-97,97,0
"E09HT",87,37,"1200x900",600,0,600,400,"False",258,403,479,76,76,1
"E09HT",88,464,"1200x900",1000,0,600,400,"True",82,222,251,29,29,1
"E09HT",89,173,"1200x900",600,2,600,400,"False",948,693,464,-229,229,0
"E09HT",90,488,"1200x900",1000,0,600,400,"True",129,687,709,22,22,1
"E09HT",91,164,"1200x900",600,2,600,400,"True",1051,268,290,22,22,0
"E09HT",92,257,"1200x900",800,0,600,400,"True",97,219,221,2,2,1
"E09HT",93,634,"1200x900",1000,2,600,400,"False",735,313,224,-89,89,0
"E09HT",94,265,"1200x900",800,0,600,400,"True",229,353,302,-51,51,1
"E09HT",95,646,"1200x900",1000,2,600,400,"True",829,227,271,44,44,1
"E09HT",96,256,"1200x900",800,0,600,400,"False",192,656,759,103,103,1
"E09HT",97,32,"1200x900",600,0,600,400,"True",152,563,569,6,6,1
"E09HT",98,142,"1200x900",600,1,600,400,"True",286,474,522,48,48,0
"E09HT",99,89,"1200x900",600,1,600,400,"False",917,366,541,175,175,1
"E09HT",100,462,"1200x900",1000,0,600,400,"True",102,672,577,-95,95,1
"E09HT",101,200,"1200x900",600,2,600,400,"False",897,302,496,194,194,0
"E09HT",102,511,"1200x900",1000,1,600,400,"False",408,390,607,217,217,1
"E09HT",103,95,"1200x900",600,1,600,400,"True",749,425,439,14,14,1
"E09HT",104,246,"1200x900",800,0,600,400,"True",196,418,483,65,65,1
"E09HT",105,522,"1200x900",1000,1,600,400,"False",223,379,572,193,193,0
"E09HT",106,102,"1200x900",600,1,600,400,"False",861,603,517,-86,86,0
"E09HT",107,245,"1200x900",800,0,600,400,"False",296,235,332,97,97,1
"E09HT",108,11,"1200x900",600,0,600,400,"False",372,670,569,-101,101,1
"E09HT",109,261,"1200x900",800,0,600,400,"True",86,713,742,29,29,1
"E09HT",110,378,"1200x900",800,2,600,400,"False",1018,708,327,-381,381,0
"E09HT",111,341,"1200x900",800,1,600,400,"False",735,632,524,-108,108,1
"E09HT",112,553,"1200x900",1000,1,600,400,"False",116,712,451,-261,261,0
"E09HT",113,542,"1200x900",1000,1,600,400,"False",304,401,337,-64,64,0
"E09HT",114,530,"1200x900",1000,1,600,400,"False",584,405,111,-294,294,1
"E09HT",115,239,"1200x900",800,0,600,400,"False",114,231,114,-117,117,1
"E09HT",116,465,"1200x900",1000,0,600,400,"False",85,203,50,-153,153,1
"E09HT",117,2,"1200x900",600,0,600,400,"True",159,323,327,4,4,0
"E09HT",118,496,"1200x900",1000,0,600,400,"False",70,639,571,-68,68,1
"E09HT",119,23,"1200x900",600,0,600,400,"True",308,463,460,-3,3,1
"E09HT",120,466,"1200x900",1000,0,600,400,"True",82,205,266,61,61,1
"E09HT",121,381,"1200x900",800,2,600,400,"True",705,408,393,-15,15,0
"E09HT",122,540,"1200x900",1000,1,600,400,"False",389,568,356,-212,212,1
"E09HT",123,263,"1200x900",800,0,600,400,"True",82,396,327,-69,69,1
"E09HT",124,271,"1200x900",800,0,600,400,"True",74,360,357,-3,3,1
"E09HT",125,329,"1200x900",800,1,600,400,"True",517,239,295,56,56,0
"E09HT",126,621,"1200x900",1000,2,600,400,"False",540,478,330,-148,148,0
"E09HT",127,219,"1200x900",800,0,600,400,"False",202,502,321,-181,181,1
"E09HT",128,415,"1200x900",800,2,600,400,"False",823,684,380,-304,304,0
"E09HT",129,107,"1200x900",600,1,600,400,"True",878,678,618,-60,60,0
"E09HT",130,337,"1200x900",800,1,600,400,"False",299,622,728,106,106,0
"E09HT",131,328,"1200x900",800,1,600,400,"False",104,649,525,-124,124,0
"E09HT",132,247,"1200x900",800,0,600,400,"True",160,424,359,-65,65,1
"E09HT",133,477,"1200x900",1000,0,600,400,"False",88,640,489,-151,151,1
"E09HT",134,131,"1200x900",600,1,600,400,"True",531,367,393,26,26,0
"E09HT",135,152,"1200x900",600,2,600,400,"False",971,399,322,-77,77,0
"E09HT",136,445,"1200x900",1000,0,600,400,"False",78,302,372,70,70,1
"E09HT",137,369,"1200x900",800,2,600,400,"False",903,594,471,-123,123,0
"E09HT",138,254,"1200x900",800,0,600,400,"False",136,583,480,-103,103,1
"E09HT",139,198,"1200x900",600,2,600,400,"True",976,500,447,-53,53,0
"E09HT",140,435,"1200x900",1000,0,600,400,"False",119,200,288,88,88,1
"E09HT",141,97,"1200x900",600,1,600,400,"True",760,643,589,-54,54,1
"E09HT",142,319,"1200x900",800,1,600,400,"False",494,587,694,107,107,1
"E09HT",143,76,"1200x900",600,1,600,400,"True",647,614,532,-82,82,0
"E09HT",144,80,"1200x900",600,1,600,400,"False",616,423,671,248,248,1
"E09HT",145,163,"1200x900",600,2,600,400,"False",1046,665,476,-189,189,0
"E09HT",146,512,"1200x900",1000,1,600,400,"False",139,261,370,109,109,0
"E09HT",147,467,"1200x900",1000,0,600,400,"False",74,712,552,-160,160,1
"E09HT",148,123,"1200x900",600,1,600,400,"True",761,365,464,99,99,1
"E09HT",149,375,"1200x900",800,2,600,400,"False",716,384,315,-69,69,0
"E09HT",150,308,"1200x900",800,1,600,400,"True",437,425,384,-41,41,0
"E09HT",151,268,"1200x900",800,0,600,400,"True",148,400,363,-37,37,1
"E09HT",152,483,"1200x900",1000,0,600,400,"False",93,191,380,189,189,1
"E09HT",153,126,"1200x900",600,1,600,400,"True",849,354,363,9,9,0
"E09HT",154,218,"1200x900",800,0,600,400,"True",106,397,335,-62,62,1
"E09HT",155,525,"1200x900",1000,1,600,400,"False",123,690,379,-311,311,0
"E09HT",156,144,"1200x900",600,1,600,400,"True",718,371,405,34,34,0
"E09HT",157,555,"1200x900",1000,1,600,400,"False",444,556,341,-215,215,0
"E09HT",158,28,"1200x900",600,0,600,400,"True",336,410,459,49,49,1
"E09HT",161,150,"1200x900",600,2,600,400,"True",897,345,419,74,74,0
"E09HT",162,10,"1200x900",600,0,600,400,"True",400,499,489,-10,10,1
"E09HT",163,230,"1200x900",800,0,600,400,"False",99,678,582,-96,96,1
"E09HT",164,334,"1200x900",800,1,600,400,"False",481,665,500,-165,165,0
"E09HT",165,568,"1200x900",1000,1,600,400,"False",286,475,584,109,109,1
"E09HT",166,87,"1200x900",600,1,600,400,"False",231,604,503,-101,101,0
"E09HT",167,186,"1200x900",600,2,600,400,"False",997,197,431,234,234,0
"E09HT",168,457,"1200x900",1000,0,600,400,"False",97,630,544,-86,86,1
"E09HT",169,311,"1200x900",800,1,600,400,"False",710,261,422,161,161,0
"E09HT",170,258,"1200x900",800,0,600,400,"False",126,664,544,-120,120,1
"E09HT",171,596,"1200x900",1000,2,600,400,"True",706,513,492,-21,21,0
"E09HT",172,393,"1200x900",800,2,600,400,"False",657,620,446,-174,174,0
"E09HT",173,185,"1200x900",600,2,600,400,"False",907,212,318,106,106,0
"E09HT",175,606,"1200x900",1000,2,600,400,"False",653,627,307,-320,320,0
"E09HT",176,523,"1200x900",1000,1,600,400,"False",339,318,394,76,76,0
"E09HT",177,284,"1200x900",800,0,600,400,"True",135,293,339,46,46,1
"E09HT",178,323,"1200x900",800,1,600,400,"True",388,348,304,-44,44,0
"E09HT",179,240,"1200x900",800,0,600,400,"False",330,656,468,-188,188,1
"E09HT",180,475,"1200x900",1000,0,600,400,"False",101,715,600,-115,115,1
"E09HT",181,600,"1200x900",1000,2,600,400,"False",765,207,360,153,153,0
"E09HT",182,453,"1200x900",1000,0,600,400,"False",71,393,288,-105,105,1
"E09HT",184,213,"1200x900",600,2,600,400,"True",822,275,361,86,86,0
"E09HT",185,321,"1200x900",800,1,600,400,"False",601,190,294,104,104,0
"E09HT",186,331,"1200x900",800,1,600,400,"False",240,620,467,-153,153,0
"E09HT",188,535,"1200x900",1000,1,600,400,"True",372,410,473,63,63,0
"E09HT",190,136,"1200x900",600,1,600,400,"True",264,205,296,91,91,0
"E09HT",191,233,"1200x900",800,0,600,400,"True",164,700,756,56,56,1
"E09HT",192,389,"1200x900",800,2,600,400,"False",843,530,752,222,222,0
"E09HT",193,137,"1200x900",600,1,600,400,"True",789,577,576,-1,1,0
"E09HT",194,340,"1200x900",800,1,600,400,"False",226,240,606,366,366,0
"E09HT",195,276,"1200x900",800,0,600,400,"True",281,217,246,29,29,1
"E09HT",196,521,"1200x900",1000,1,600,400,"False",111,303,413,110,110,1
"E09HT",197,92,"1200x900",600,1,600,400,"False",624,605,393,-212,212,0
"E09HT",198,345,"1200x900",800,1,600,400,"False",841,566,410,-156,156,1
"E09HT",199,613,"1200x900",1000,2,600,400,"False",690,374,441,67,67,0
"E09HT",200,614,"1200x900",1000,2,600,400,"False",823,563,393,-170,170,0
"E09HT",201,168,"1200x900",600,2,600,400,"False",1001,439,356,-83,83,0
"E09HT",202,590,"1200x900",1000,2,600,400,"False",636,278,398,120,120,0
"E09HT",203,431,"1200x900",800,2,600,400,"True",694,382,402,20,20,0
"E09HT",204,281,"1200x900",800,0,600,400,"False",112,611,519,-92,92,1
"E09HT",205,344,"1200x900",800,1,600,400,"True",589,408,422,14,14,0
"E09HT",206,351,"1200x900",800,1,600,400,"False",122,581,425,-156,156,0
"E09HT",207,623,"1200x900",1000,2,600,400,"False",636,527,368,-159,159,0
"E09HT",208,349,"1200x900",800,1,600,400,"False",402,665,444,-221,221,0
"E09HT",209,88,"1200x900",600,1,600,400,"False",186,554,425,-129,129,0
"E09HT",210,61,"1200x900",600,0,600,400,"True",272,670,670,0,0,1
"E09HT",211,197,"1200x900",600,2,600,400,"False",903,212,671,459,459,0
"E09HT",212,364,"1200x900",800,2,600,400,"False",1018,204,490,286,286,0
"E09HT",213,304,"1200x900",800,1,600,400,"False",667,605,485,-120,120,0
"E09HT",214,153,"1200x900",600,2,600,400,"False",1037,601,336,-265,265,0
"E09HT",215,250,"1200x900",800,0,600,400,"True",290,248,266,18,18,1
"E09HT",216,59,"1200x900",600,0,600,400,"True",391,692,724,32,32,1
"E09HT",217,503,"1200x900",1000,0,600,400,"False",86,279,432,153,153,1
"E09HT",218,272,"1200x900",800,0,600,400,"True",200,181,191,10,10,1
"E09HT",219,12,"1200x900",600,0,600,400,"False",365,336,171,-165,165,1
"E09HT",220,587,"1200x900",1000,2,600,400,"False",741,686,506,-180,180,0
"E09HT",221,306,"1200x900",800,1,600,400,"True",164,524,410,-114,114,0
"E09HT",222,96,"1200x900",600,1,600,400,"True",433,458,393,-65,65,0
"E09HT",224,237,"1200x900",800,0,600,400,"True",204,481,523,42,42,1
"E09HT",225,430,"1200x900",800,2,600,400,"False",922,254,400,146,146,0
"E09HT",226,41,"1200x900",600,0,600,400,"True",370,452,417,-35,35,1
"E09HT",227,195,"1200x900",600,2,600,400,"False",942,249,395,146,146,0
"E09HT",228,22,"1200x900",600,0,600,400,"True",398,591,523,-68,68,1
"E09HT",229,275,"1200x900",800,0,600,400,"False",120,594,522,-72,72,0
"E09HT",230,539,"1200x900",1000,1,600,400,"True",510,383,452,69,69,0
"E09HT",231,223,"1200x900",800,0,600,400,"False",179,191,97,-94,94,1
"E09HT",232,572,"1200x900",1000,1,600,400,"True",302,260,282,22,22,0
"E09HT",233,221,"1200x900",800,0,600,400,"True",132,520,489,-31,31,1
"E09HT",234,225,"1200x900",800,0,600,400,"True",178,423,422,-1,1,1
"E09HT",235,387,"1200x900",800,2,600,400,"False",990,444,289,-155,155,0
"E09HT",236,278,"1200x900",800,0,600,400,"False",251,711,496,-215,215,1
"E09HT",237,616,"1200x900",1000,2,600,400,"False",854,357,505,148,148,1
"E09HT",238,426,"1200x900",800,2,600,400,"False",830,263,398,135,135,0
"E09HT",239,234,"1200x900",800,0,600,400,"True",72,344,312,-32,32,1
"E09HT",240,7,"1200x900",600,0,600,400,"False",431,654,495,-159,159,1
"E09HT",241,395,"1200x900",800,2,600,400,"True",743,334,358,24,24,0
"E09HT",242,612,"1200x900",1000,2,600,400,"False",706,198,333,135,135,0
"E09HT",243,262,"1200x900",800,0,600,400,"True",196,481,454,-27,27,1
"E09HT",244,557,"1200x900",1000,1,600,400,"False",677,505,620,115,115,1
"E09HT",245,302,"1200x900",800,1,600,400,"True",479,467,410,-57,57,1
"E09HT",247,1,"1200x900",600,0,600,400,"True",136,502,451,-51,51,0
"E09HT",248,9,"1200x900",600,0,600,400,"False",509,654,504,-150,150,1
"E09HT",250,56,"1200x900",600,0,600,400,"False",148,491,402,-89,89,0
"E09HT",251,236,"1200x900",800,0,600,400,"True",162,350,364,14,14,1
"E09HT",252,303,"1200x900",800,1,600,400,"True",241,431,462,31,31,0
"E09HT",253,135,"1200x900",600,1,600,400,"False",759,569,463,-106,106,0
"E09HT",254,499,"1200x900",1000,0,600,400,"False",93,271,390,119,119,1
"E09HT",256,105,"1200x900",600,1,600,400,"False",527,440,494,54,54,0
"E09HT",257,68,"1200x900",600,0,600,400,"True",165,367,352,-15,15,0
"E09HT",258,112,"1200x900",600,1,600,400,"False",681,490,350,-140,140,0
"E09HT",259,145,"1200x900",600,2,600,400,"False",1004,630,496,-134,134,0
"E09HT",260,485,"1200x900",1000,0,600,400,"False",121,694,574,-120,120,1
"E09HT",261,636,"1200x900",1000,2,600,400,"False",575,583,502,-81,81,0
"E09HT",262,442,"1200x900",1000,0,600,400,"False",87,183,340,157,157,1
"E09HT",263,63,"1200x900",600,0,600,400,"True",311,188,244,56,56,1
"E09HT",264,607,"1200x900",1000,2,600,400,"False",900,573,462,-111,111,1
"E09HT",265,470,"1200x900",1000,0,600,400,"False",91,666,563,-103,103,1
"E09HT",266,264,"1200x900",800,0,600,400,"True",198,660,634,-26,26,1
"E09HT",267,358,"1200x900",800,1,600,400,"False",263,635,331,-304,304,0
"E09HT",268,455,"1200x900",1000,0,600,400,"False",107,718,653,-65,65,1
"E09HT",269,25,"1200x900",600,0,600,400,"False",263,403,504,101,101,1
"E09HT",270,310,"1200x900",800,1,600,400,"False",559,592,450,-142,142,0
"E09HT",271,605,"1200x900",1000,2,600,400,"False",493,665,553,-112,112,0
"E09HT",272,355,"1200x900",800,1,600,400,"True",77,386,437,51,51,0
"E09HT",273,133,"1200x900",600,1,600,400,"False",345,551,342,-209,209,0
"E09HT",274,373,"1200x900",800,2,600,400,"True",694,326,350,24,24,0
"E09HT",275,149,"1200x900",600,2,600,400,"True",890,289,361,72,72,0
"E09HT",276,326,"1200x900",800,1,600,400,"False",103,482,306,-176,176,0
"E09HT",277,397,"1200x900",800,2,600,400,"False",817,692,513,-179,179,0
"E09HT",278,93,"1200x900",600,1,600,400,"False",139,540,456,-84,84,0
"E09HT",279,49,"1200x900",600,0,600,400,"True",109,380,366,-14,14,0
"E09HT",280,353,"1200x900",800,1,600,400,"False",90,476,364,-112,112,0
"E09HT",283,216,"1200x900",600,2,600,400,"True",1029,286,235,-51,51,0
"E09HT",284,486,"1200x900",1000,0,600,400,"False",102,676,409,-267,267,1
"E09HT",285,592,"1200x900",1000,2,600,400,"False",492,392,524,132,132,0
"E09HT",286,64,"1200x900",600,0,600,400,"True",102,339,268,-71,71,0
"E09HT",287,446,"1200x900",1000,0,600,400,"False",72,298,197,-101,101,1
"E09HT",288,99,"1200x900",600,1,600,400,"True",811,407,354,-53,53,0
"E09HT",289,626,"1200x900",1000,2,600,400,"True",329,449,393,-56,56,0
"E09HT",290,255,"1200x900",800,0,600,400,"False",93,709,593,-116,116,1
"E09HT",291,459,"1200x900",1000,0,600,400,"True",70,645,644,-1,1,1
"E09HT",292,158,"1200x900",600,2,600,400,"False",939,300,556,256,256,0
"E09HT",293,630,"1200x900",1000,2,600,400,"False",754,559,434,-125,125,0
"E09HT",294,232,"1200x900",800,0,600,400,"False",84,511,424,-87,87,1
"E09HT",295,505,"1200x900",1000,1,600,400,"True",191,484,490,6,6,1
"E09HT",296,402,"1200x900",800,2,600,400,"False",878,234,445,211,211,0
"E09HT",297,16,"1200x900",600,0,600,400,"False",297,514,388,-126,126,1
"E09HT",298,220,"1200x900",800,0,600,400,"False",108,699,609,-90,90,1
"E09HT",299,354,"1200x900",800,1,600,400,"False",118,236,510,274,274,0
"E09HT",300,318,"1200x900",800,1,600,400,"False",788,534,344,-190,190,0
"E09HT",301,118,"1200x900",600,1,600,400,"True",190,588,581,-7,7,0
"E09HT",302,461,"1200x900",1000,0,600,400,"False",95,711,584,-127,127,1
"E09HT",303,65,"1200x900",600,0,600,400,"True",442,645,600,-45,45,1
"E09HT",304,471,"1200x900",1000,0,600,400,"False",122,200,303,103,103,1
"E09HT",305,440,"1200x900",1000,0,600,400,"False",71,237,60,-177,177,1
"E09HT",306,597,"1200x900",1000,2,600,400,"False",352,239,175,-64,64,0
"E09HT",307,444,"1200x900",1000,0,600,400,"False",101,714,498,-216,216,1
"E09HT",308,229,"1200x900",800,0,600,400,"False",117,697,525,-172,172,1
"E09HT",309,333,"1200x900",800,1,600,400,"False",521,548,450,-98,98,0
"E09HT",310,305,"1200x900",800,1,600,400,"False",471,716,491,-225,225,0
"E09HT",311,18,"1200x900",600,0,600,400,"True",400,318,308,-10,10,1
"E09HT",312,156,"1200x900",600,2,600,400,"False",913,197,589,392,392,0
"E09HT",313,121,"1200x900",600,1,600,400,"True",884,364,411,47,47,0
"E09HT",314,633,"1200x900",1000,2,600,400,"False",564,253,376,123,123,0
"E09HT",315,437,"1200x900",1000,0,600,400,"False",74,667,475,-192,192,1
"E09HT",316,24,"1200x900",600,0,600,400,"True",430,538,540,2,2,1
"E09HT",317,456,"1200x900",1000,0,600,400,"True",91,257,187,-70,70,1
"E09HT",318,342,"1200x900",800,1,600,400,"False",677,204,341,137,137,0
"E09HT",319,147,"1200x900",600,2,600,400,"False",942,418,555,137,137,0
"E09HT",320,352,"1200x900",800,1,600,400,"False",235,717,406,-311,311,0
"E09HT",321,558,"1200x900",1000,1,600,400,"True",72,464,492,28,28,1
"E09HT",322,544,"1200x900",1000,1,600,400,"False",602,620,455,-165,165,0
"E09HT",323,589,"1200x900",1000,2,600,400,"True",856,418,433,15,15,0
"E09HT",324,506,"1200x900",1000,1,600,400,"False",559,567,377,-190,190,1
"E09HT",325,642,"1200x900",1000,2,600,400,"True",776,316,376,60,60,0
"E09HT",327,117,"1200x900",600,1,600,400,"True",711,456,445,-11,11,0
"E09HT",328,559,"1200x900",1000,1,600,400,"True",641,244,279,35,35,0
"E09HT",329,75,"1200x900",600,1,600,400,"False",635,558,297,-261,261,0
"E09HT",330,324,"1200x900",800,1,600,400,"False",719,712,483,-229,229,1
"E09HT",331,109,"1200x900",600,1,600,400,"False",691,589,276,-313,313,0
"E09HT",333,44,"1200x900",600,0,600,400,"True",305,554,496,-58,58,1
"E09HT",334,394,"1200x900",800,2,600,400,"False",847,292,449,157,157,0
"E09HT",335,536,"1200x900",1000,1,600,400,"False",580,213,296,83,83,0
"E09HT",336,403,"1200x900",800,2,600,400,"False",625,704,591,-113,113,0
"E09HT",337,618,"1200x900",1000,2,600,400,"False",276,671,588,-83,83,0
"E09HT",338,171,"1200x900",600,2,600,400,"False",909,200,521,321,321,0
"E09HT",339,454,"1200x900",1000,0,600,400,"True",78,687,666,-21,21,1
"E09HT",340,551,"1200x900",1000,1,600,400,"False",146,445,569,124,124,1
"E09HT",341,235,"1200x900",800,0,600,400,"False",146,646,490,-156,156,1
"E09HT",342,116,"1200x900",600,1,600,400,"False",767,289,213,-76,76,0
"E09HT",343,413,"1200x900",800,2,600,400,"False",849,506,611,105,105,0
"E09HT",344,203,"1200x900",600,2,600,400,"True",938,603,554,-49,49,0
"E09HT",345,637,"1200x900",1000,2,600,400,"False",750,460,581,121,121,0
"E09HT",346,520,"1200x900",1000,1,600,400,"False",564,260,516,256,256,0
"E09HT",347,110,"1200x900",600,1,600,400,"True",776,550,576,26,26,1
"E09HT",348,447,"1200x900",1000,0,600,400,"False",71,339,488,149,149,1
"E09HT",349,122,"1200x900",600,1,600,400,"False",817,709,489,-220,220,0
"E09HT",350,336,"1200x900",800,1,600,400,"False",251,587,209,-378,378,0
"E09HT",351,253,"1200x900",800,0,600,400,"True",177,424,391,-33,33,1
"E09HT",352,479,"1200x900",1000,0,600,400,"False",74,705,820,115,115,1
"E09HT",353,178,"1200x900",600,2,600,400,"False",1041,510,588,78,78,0
"E09HT",354,401,"1200x900",800,2,600,400,"False",821,260,183,-77,77,0
"E09HT",355,189,"1200x900",600,2,600,400,"True",881,397,360,-37,37,0
"E09HT",356,560,"1200x900",1000,1,600,400,"False",516,693,403,-290,290,0
"E09HT",357,515,"1200x900",1000,1,600,400,"False",307,217,513,296,296,0
"E09HT",358,82,"1200x900",600,1,600,400,"False",108,213,347,134,134,0
"E09HT",359,438,"1200x900",1000,0,600,400,"False",77,713,551,-162,162,1
"E09HT",360,291,"1200x900",800,1,600,400,"True",522,694,753,59,59,0
"E09HT",361,307,"1200x900",800,1,600,400,"False",716,247,439,192,192,0
"E09HT",362,94,"1200x900",600,1,600,400,"False",729,482,277,-205,205,0
"E09HT",363,58,"1200x900",600,0,600,400,"False",353,655,382,-273,273,1
"E09HT",364,78,"1200x900",600,1,600,400,"True",885,684,581,-103,103,0
"E09HT",365,244,"1200x900",800,0,600,400,"False",194,203,325,122,122,1
"E09HT",366,408,"1200x900",800,2,600,400,"False",758,567,365,-202,202,0
"E09HT",367,390,"1200x900",800,2,600,400,"False",982,674,337,-337,337,1
"E09HT",368,433,"1200x900",1000,0,600,400,"False",76,222,356,134,134,1
"E09HT",369,497,"1200x900",1000,0,600,400,"False",106,696,450,-246,246,1
"E09HT",370,598,"1200x900",1000,2,600,400,"True",706,559,493,-66,66,0
"E09HT",371,206,"1200x900",600,2,600,400,"True",975,223,301,78,78,0
"E09HT",372,628,"1200x900",1000,2,600,400,"True",768,410,487,77,77,0
"E09HT",373,293,"1200x900",800,1,600,400,"True",561,396,413,17,17,0
"E09HT",374,645,"1200x900",1000,2,600,400,"True",619,396,359,-37,37,0
"E09HT",375,528,"1200x900",1000,1,600,400,"False",839,227,647,420,420,1
"E09HT",376,608,"1200x900",1000,2,600,400,"False",742,250,540,290,290,0
"E09HT",377,529,"1200x900",1000,1,600,400,"True",267,412,466,54,54,1
"E09HT",378,52,"1200x900",600,0,600,400,"True",171,188,193,5,5,0
"E09HT",379,594,"1200x900",1000,2,600,400,"True",537,637,665,28,28,0
"E09HT",380,60,"1200x900",600,0,600,400,"True",365,213,230,17,17,1
"E09HT",381,509,"1200x900",1000,1,600,400,"False",509,434,275,-159,159,0
"E09HT",382,91,"1200x900",600,1,600,400,"False",417,630,742,112,112,1
"E09HT",383,279,"1200x900",800,0,600,400,"False",252,202,385,183,183,1
"E09HT",384,441,"1200x900",1000,0,600,400,"True",85,684,624,-60,60,1
"E09HT",385,409,"1200x900",800,2,600,400,"False",501,659,730,71,71,0
"E09HT",386,46,"1200x900",600,0,600,400,"False",193,355,438,83,83,1
"E09HT",387,155,"1200x900",600,2,600,400,"False",940,269,457,188,188,0
"E09HT",388,27,"1200x900",600,0,600,400,"True",373,309,303,-6,6,1
"E09HT",389,162,"1200x900",600,2,600,400,"True",849,279,305,26,26,0
"E09HT",390,287,"1200x900",800,0,600,400,"False",120,567,493,-74,74,1
"E09HT",391,141,"1200x900",600,1,600,400,"False",671,582,491,-91,91,0
"E09HT",392,399,"1200x900",800,2,600,400,"False",603,602,487,-115,115,0
"E09HT",393,21,"1200x900",600,0,600,400,"True",314,383,371,-12,12,1
"E09HT",394,377,"1200x900",800,2,600,400,"True",683,388,372,-16,16,0
"E09HT",395,222,"1200x900",800,0,600,400,"False",152,206,334,128,128,1
"E09HT",396,43,"1200x900",600,0,600,400,"True",277,446,472,26,26,1
"E09HT",397,280,"1200x900",800,0,600,400,"False",104,302,376,74,74,1
"E09HT",398,644,"1200x900",1000,2,600,400,"False",495,486,371,-115,115,0
"E09HT",399,161,"1200x900",600,2,600,400,"False",939,553,368,-185,185,0
"E09HT",400,405,"1200x900",800,2,600,400,"False",790,307,447,140,140,0
"E09HT",401,26,"1200x900",600,0,600,400,"False",70,712,578,-134,134,0
"E09HT",402,325,"1200x900",800,1,600,400,"True",105,394,389,-5,5,0
"E09HT",403,584,"1200x900",1000,2,600,400,"True",731,413,413,0,0,0
"E09HT",404,111,"1200x900",600,1,600,400,"False",922,552,406,-146,146,1
"E09HT",405,249,"1200x900",800,0,600,400,"False",126,306,380,74,74,1
"E09HT",406,259,"1200x900",800,0,600,400,"False",156,180,324,144,144,1
"E09HT",407,209,"1200x900",600,2,600,400,"False",937,637,380,-257,257,0
"E09HT",408,632,"1200x900",1000,2,600,400,"False",984,227,379,152,152,0
"E09HT",410,518,"1200x900",1000,1,600,400,"False",583,717,378,-339,339,0
"E09HT",411,72,"1200x900",600,0,600,400,"True",158,537,506,-31,31,0
"E09HT",412,194,"1200x900",600,2,600,400,"False",896,236,502,266,266,0
"E09HT",413,81,"1200x900",600,1,600,400,"False",696,225,366,141,141,0
"E09HT",414,424,"1200x900",800,2,600,400,"False",903,545,374,-171,171,0
"E09HT",415,183,"1200x900",600,2,600,400,"True",927,289,360,71,71,0
"E09HT",416,602,"1200x900",1000,2,600,400,"False",865,452,343,-109,109,0
"E09HT",417,359,"1200x900",800,1,600,400,"True",653,241,266,25,25,0
"E09HT",418,294,"1200x900",800,1,600,400,"False",262,287,381,94,94,0
"E09HT",419,298,"1200x900",800,1,600,400,"True",311,457,409,-48,48,0
"E09HT",420,83,"1200x900",600,1,600,400,"False",763,568,331,-237,237,1
"E09HT",421,98,"1200x900",600,1,600,400,"True",625,530,533,3,3,0
"E09HT",422,372,"1200x900",800,2,600,400,"True",833,620,666,46,46,0
"E09HT",423,316,"1200x900",800,1,600,400,"False",362,319,450,131,131,0
"E09HT",424,286,"1200x900",800,0,600,400,"False",105,378,237,-141,141,1
"E09HT",425,533,"1200x900",1000,1,600,400,"False",355,483,652,169,169,0
"E09HT",426,504,"1200x900",1000,0,600,400,"True",107,699,637,-62,62,1
"E09HT",427,501,"1200x900",1000,0,600,400,"False",96,323,230,-93,93,1
"E09HT",428,474,"1200x900",1000,0,600,400,"False",85,339,435,96,96,1
"E09HT",429,452,"1200x900",1000,0,600,400,"False",97,273,429,156,156,1
"E09HT",430,414,"1200x900",800,2,600,400,"False",831,592,495,-97,97,0
"E09HT",431,567,"1200x900",1000,1,600,400,"True",655,297,271,-26,26,1
"E09HT",432,47,"1200x900",600,0,600,400,"True",303,499,483,-16,16,1
"E09HT",433,484,"1200x900",1000,0,600,400,"False",100,223,301,78,78,1
"E09HT",434,473,"1200x900",1000,0,600,400,"True",75,323,282,-41,41,1
"E09HT",435,418,"1200x900",800,2,600,400,"False",754,507,294,-213,213,0
"E09HT",436,231,"1200x900",800,0,600,400,"False",251,718,574,-144,144,1
"E09HT",437,406,"1200x900",800,2,600,400,"False",971,233,476,243,243,0
"E09HT",438,53,"1200x900",600,0,600,400,"False",177,189,382,193,193,0
"E09HT",439,391,"1200x900",800,2,600,400,"False",895,521,389,-132,132,0
"E09HT",440,604,"1200x900",1000,2,600,400,"True",459,593,552,-41,41,0
"E09HT",441,380,"1200x900",800,2,600,400,"False",942,228,374,146,146,0
"E09HT",442,423,"1200x900",800,2,600,400,"False",1051,710,551,-159,159,1
"E09HT",443,367,"1200x900",800,2,600,400,"True",613,464,476,12,12,0
"E09HT",444,552,"1200x900",1000,1,600,400,"True",255,412,403,-9,9,0
"E09HT",445,314,"1200x900",800,1,600,400,"True",277,616,610,-6,6,1
"E09HT",446,404,"1200x900",800,2,600,400,"False",842,396,561,165,165,0
"E09HT",447,577,"1200x900",1000,2,600,400,"False",455,420,220,-200,200,0
"E09HT",448,127,"1200x900",600,1,600,400,"False",309,691,409,-282,282,0
"E09HT",449,169,"1200x900",600,2,600,400,"False",924,290,503,213,213,0
"E09HT",450,17,"1200x900",600,0,600,400,"True",402,496,483,-13,13,1
"E09HT",451,498,"1200x900",1000,0,600,400,"False",100,260,358,98,98,1
"E09HT",452,74,"1200x900",600,1,600,400,"True",115,358,335,-23,23,0
"E09HT",453,129,"1200x900",600,1,600,400,"False",859,482,257,-225,225,1
"E09HT",454,495,"1200x900",1000,0,600,400,"False",93,692,552,-140,140,1
"E09HT",455,574,"1200x900",1000,1,600,400,"False",614,194,420,226,226,0
"E09HT",456,322,"1200x900",800,1,600,400,"False",703,206,560,354,354,1
"E09HT",457,571,"1200x900",1000,1,600,400,"False",239,522,288,-234,234,1
"E09HT",458,468,"1200x900",1000,0,600,400,"False",121,219,341,122,122,1
"E09HT",459,548,"1200x900",1000,1,600,400,"False",103,278,631,353,353,0
"E09HT",460,42,"1200x900",600,0,600,400,"True",233,479,490,11,11,0
"E09HT",462,228,"1200x900",800,0,600,400,"True",174,687,631,-56,56,1
"E09HT",463,458,"1200x900",1000,0,600,400,"True",78,624,616,-8,8,1
"E09HT",464,69,"1200x900",600,0,600,400,"False",322,268,494,226,226,0
"E09HT",465,448,"1200x900",1000,0,600,400,"True",107,641,584,-57,57,1
"E09HT",466,15,"1200x900",600,0,600,400,"True",473,352,335,-17,17,1
"E09HT",467,366,"1200x900",800,2,600,400,"False",931,464,379,-85,85,0
"E09HT",468,617,"1200x900",1000,2,600,400,"False",294,180,423,243,243,0
"E09HT",469,266,"1200x900",800,0,600,400,"True",126,303,284,-19,19,1
"E09HT",470,425,"1200x900",800,2,600,400,"False",621,438,324,-114,114,0
"E09HT",471,421,"1200x900",800,2,600,400,"False",898,394,325,-69,69,0
"E09HT",472,436,"1200x900",1000,0,600,400,"True",82,617,561,-56,56,1
"E09HT",473,601,"1200x900",1000,2,600,400,"False",735,697,457,-240,240,0
"E09HT",474,419,"1200x900",800,2,600,400,"False",769,351,525,174,174,0
"E09HT",475,29,"1200x900",600,0,600,400,"True",385,533,489,-44,44,1
"E09HT",476,443,"1200x900",1000,0,600,400,"False",99,651,566,-85,85,1
"E09HT",477,207,"1200x900",600,2,600,400,"False",838,235,560,325,325,0
"E09HT",478,624,"1200x900",1000,2,600,400,"True",693,501,522,21,21,0
"E09HT",479,434,"1200x900",1000,0,600,400,"False",89,657,501,-156,156,1
"E09HT",480,554,"1200x900",1000,1,600,400,"True",79,309,333,24,24,1
"E09HT",481,170,"1200x900",600,2,600,400,"False",996,468,265,-203,203,0
"E09HT",482,635,"1200x900",1000,2,600,400,"False",833,402,282,-120,120,0
"E09HT",483,580,"1200x900",1000,2,600,400,"True",651,267,288,21,21,0
"E09HT",484,315,"1200x900",800,1,600,400,"True",105,211,230,19,19,0
"E09HT",485,146,"1200x900",600,2,600,400,"False",989,492,195,-297,297,0
"E09HT",486,422,"1200x900",800,2,600,400,"False",712,558,392,-166,166,0
"E09HT",487,277,"1200x900",800,0,600,400,"True",140,310,327,17,17,1
"E09HT",488,212,"1200x900",600,2,600,400,"False",841,206,376,170,170,0
"E09HT",489,478,"1200x900",1000,0,600,400,"False",79,672,503,-169,169,1
"E09HT",490,79,"1200x900",600,1,600,400,"False",731,289,397,108,108,0
"E09HT",491,180,"1200x900",600,2,600,400,"False",929,270,392,122,122,0
"E09HT",492,227,"1200x900",800,0,600,400,"True",196,551,555,4,4,1
"E09HT",493,251,"1200x900",800,0,600,400,"False",88,352,465,113,113,1
"E09HT",494,288,"1200x900",800,0,600,400,"True",180,547,498,-49,49,1
"E09HT",495,487,"1200x900",1000,0,600,400,"False",78,670,591,-79,79,1
"E09HT",496,86,"1200x900",600,1,600,400,"False",692,388,521,133,133,1
"E09HT",497,174,"1200x900",600,2,600,400,"True",998,457,485,28,28,0
"E09HT",498,396,"1200x900",800,2,600,400,"False",678,663,468,-195,195,0
"E09HT",499,638,"1200x900",1000,2,600,400,"False",385,198,446,248,248,0
"E09HT",500,416,"1200x900",800,2,600,400,"False",748,617,480,-137,137,0
"E09HT",501,383,"1200x900",800,2,600,400,"False",855,407,483,76,76,0
"E09HT",502,346,"1200x900",800,1,600,400,"False",269,635,414,-221,221,0
"E09HT",503,581,"1200x900",1000,2,600,400,"False",310,357,479,122,122,0
"E09HT",504,114,"1200x900",600,1,600,400,"True",183,697,688,-9,9,0
"E09HT",505,106,"1200x900",600,1,600,400,"False",803,659,538,-121,121,1
"E09HT",506,545,"1200x900",1000,1,600,400,"True",358,562,542,-20,20,0
"E09HT",507,214,"1200x900",600,2,600,400,"False",1046,305,514,209,209,0
"E09HT",508,267,"1200x900",800,0,600,400,"False",145,665,595,-70,70,1
"E09HT",509,320,"1200x900",800,1,600,400,"False",644,376,542,166,166,0
"E09HT",510,211,"1200x900",600,2,600,400,"True",986,407,477,70,70,0
"E09HT",511,38,"1200x900",600,0,600,400,"False",120,628,524,-104,104,1
"E09HT",512,603,"1200x900",1000,2,600,400,"False",693,280,436,156,156,0
"E09HT",513,564,"1200x900",1000,1,600,400,"False",215,264,369,105,105,0
"E09HT",514,317,"1200x900",800,1,600,400,"True",185,564,571,7,7,0
"E09HT",515,248,"1200x900",800,0,600,400,"False",94,240,425,185,185,1
"E09HT",516,599,"1200x900",1000,2,600,400,"False",316,570,373,-197,197,0
"E09HT",517,532,"1200x900",1000,1,600,400,"False",215,207,327,120,120,0
"E09HT",518,224,"1200x900",800,0,600,400,"False",161,474,307,-167,167,1
"E09HT",519,108,"1200x900",600,1,600,400,"True",830,239,293,54,54,0
"E09HT",520,176,"1200x900",600,2,600,400,"True",1033,281,245,-36,36,0
"E09HT",521,427,"1200x900",800,2,600,400,"False",812,380,296,-84,84,0
"E09HT",522,270,"1200x900",800,0,600,400,"False",192,418,276,-142,142,1
"E09HT",523,77,"1200x900",600,1,600,400,"True",780,525,577,52,52,0
"E09HT",524,208,"1200x900",600,2,600,400,"False",946,399,641,242,242,0
"E09HT",525,524,"1200x900",1000,1,600,400,"False",534,470,552,82,82,0
"E09HT",526,226,"1200x900",800,0,600,400,"True",187,229,273,44,44,1
"E09HT",527,489,"1200x900",1000,0,600,400,"False",88,604,483,-121,121,1
"E09HT",528,482,"1200x900",1000,0,600,400,"False",79,686,614,-72,72,1
"E09HT",529,8,"1200x900",600,0,600,400,"True",156,679,622,-57,57,0
"E09HT",530,154,"1200x900",600,2,600,400,"False",941,454,277,-177,177,0
"E09HT",531,50,"1200x900",600,0,600,400,"True",75,582,529,-53,53,0
"E09HT",532,159,"1200x900",600,2,600,400,"True",992,309,379,70,70,0
"E09HT",533,35,"1200x900",600,0,600,400,"True",366,555,566,11,11,1
"E09HT",534,132,"1200x900",600,1,600,400,"True",333,185,228,43,43,0
"E09HT",535,292,"1200x900",800,1,600,400,"False",88,565,381,-184,184,0
"E09HT",536,204,"1200x900",600,2,600,400,"False",1053,432,377,-55,55,0
"E09HT",537,609,"1200x900",1000,2,600,400,"False",697,627,374,-253,253,0
"E09HT",538,274,"1200x900",800,0,600,400,"True",146,497,495,-2,2,1
"E09HT",539,411,"1200x900",800,2,600,400,"True",805,361,404,43,43,0
"E09HT",540,517,"1200x900",1000,1,600,400,"False",548,182,255,73,73,0
"E09HT",541,480,"1200x900",1000,0,600,400,"True",100,231,222,-9,9,1
"E09HT",542,33,"1200x900",600,0,600,400,"True",198,533,517,-16,16,1
"E09HT",543,39,"1200x900",600,0,600,400,"False",210,609,504,-105,105,0
"E09HT",544,579,"1200x900",1000,2,600,400,"False",803,394,533,139,139,0
"E09HT",545,335,"1200x900",800,1,600,400,"True",124,360,289,-71,71,0
"E09HT",546,139,"1200x900",600,1,600,400,"False",192,695,310,-385,385,0
"E09HT",547,238,"1200x900",800,0,600,400,"True",162,283,294,11,11,1
"E09HT",548,610,"1200x900",1000,2,600,400,"True",702,293,293,0,0,0
"E09HT",549,500,"1200x900",1000,0,600,400,"False",105,700,628,-72,72,1
"E09HT",550,36,"1200x900",600,0,600,400,"False",128,346,442,96,96,1
"E09HT",551,576,"1200x900",1000,1,600,400,"False",376,713,361,-352,352,0
"E09HT",552,269,"1200x900",800,0,600,400,"False",160,295,219,-76,76,1
"E09HT",553,648,"1200x900",1000,2,600,400,"False",557,394,322,-72,72,0
"E09HT",554,148,"1200x900",600,2,600,400,"True",907,330,279,-51,51,0
"E09HT",555,101,"1200x900",600,1,600,400,"False",541,656,511,-145,145,0
"E09HT",556,57,"1200x900",600,0,600,400,"True",354,508,491,-17,17,1
"E09HT",557,641,"1200x900",1000,2,600,400,"False",897,272,609,337,337,0
"E09HT",558,285,"1200x900",800,0,600,400,"False",237,396,303,-93,93,1
"E09HT",559,420,"1200x900",800,2,600,400,"False",519,223,334,111,111,0
"E09HT",561,14,"1200x900",600,0,600,400,"False",399,224,320,96,96,1
"E09HT",562,179,"1200x900",600,2,600,400,"False",908,602,453,-149,149,0
"E09HT",563,193,"1200x900",600,2,600,400,"False",874,588,443,-145,145,0
"E09HT",564,210,"1200x900",600,2,600,400,"False",835,506,572,66,66,0
"E09HT",565,295,"1200x900",800,1,600,400,"False",471,334,154,-180,180,0
"E09HT",566,360,"1200x900",800,1,600,400,"False",203,608,473,-135,135,0
"E09HT",567,625,"1200x900",1000,2,600,400,"True",279,228,214,-14,14,0
"E09HT",568,531,"1200x900",1000,1,600,400,"True",233,362,330,-32,32,0
"E09HT",569,593,"1200x900",1000,2,600,400,"True",246,719,711,-8,8,0
"E09HT",570,647,"1200x900",1000,2,600,400,"False",560,637,715,78,78,0
"E09HT",571,585,"1200x900",1000,2,600,400,"False",698,688,527,-161,161,1
"E09HT",572,526,"1200x900",1000,1,600,400,"True",497,710,776,66,66,0
"E09HT",573,157,"1200x900",600,2,600,400,"False",1016,323,614,291,291,0
"E09HT",574,31,"1200x900",600,0,600,400,"True",365,338,357,19,19,1
"E09HT",575,573,"1200x900",1000,1,600,400,"False",486,615,491,-124,124,0
"E09HT",576,332,"1200x900",800,1,600,400,"False",260,699,458,-241,241,0
"E09HT",577,120,"1200x900",600,1,600,400,"True",690,655,698,43,43,0
"E09HT",578,290,"1200x900",800,1,600,400,"False",789,603,503,-100,100,0
"E09HT",579,357,"1200x900",800,1,600,400,"False",109,594,672,78,78,0
"E09HT",580,143,"1200x900",600,1,600,400,"True",479,284,286,2,2,1
"E09HT",581,386,"1200x900",800,2,600,400,"True",774,301,248,-53,53,0
"E09HT",582,432,"1200x900",800,2,600,400,"False",792,380,316,-64,64,0
"E09HT",583,350,"1200x900",800,1,600,400,"False",182,566,430,-136,136,0
"E09HT",584,534,"1200x900",1000,1,600,400,"False",328,504,384,-120,120,1
"E09HT",585,19,"1200x900",600,0,600,400,"False",286,686,491,-195,195,0
"E09HT",586,595,"1200x900",1000,2,600,400,"False",687,640,298,-342,342,0
"E09HT",587,243,"1200x900",800,0,600,400,"True",114,332,390,58,58,1
"E09HT",588,588,"1200x900",1000,2,600,400,"True",585,350,298,-52,52,0
"E09HT",589,365,"1200x900",800,2,600,400,"False",1055,305,561,256,256,0
"E09HT",590,140,"1200x900",600,1,600,400,"True",700,523,532,9,9,0
"E09HT",591,73,"1200x900",600,1,600,400,"True",94,665,601,-64,64,0
"E09HT",592,54,"1200x900",600,0,600,400,"True",474,564,563,-1,1,1
"E09HT",593,615,"1200x900",1000,2,600,400,"False",736,634,693,59,59,0
"E09HT",594,481,"1200x900",1000,0,600,400,"False",80,185,511,326,326,1
"E09HT",595,347,"1200x900",800,1,600,400,"False",757,295,654,359,359,1
"E09HT",596,611,"1200x900",1000,2,600,400,"True",414,511,517,6,6,0
"E09HT",597,296,"1200x900",800,1,600,400,"True",89,279,349,70,70,0
"E09HT",598,66,"1200x900",600,0,600,400,"True",155,673,719,46,46,0
"E09HT",599,502,"1200x900",1000,0,600,400,"True",111,639,645,6,6,1
"E09HT",600,103,"1200x900",600,1,600,400,"False",528,320,495,175,175,1
"E09HT",601,201,"1200x900",600,2,600,400,"False",1005,462,352,-110,110,0
"E09HT",602,312,"1200x900",800,1,600,400,"False",238,683,398,-285,285,0
"E09HT",603,192,"1200x900",600,2,600,400,"False",1064,320,638,318,318,0
"E09HT",604,13,"1200x900",600,0,600,400,"False",296,211,357,146,146,1
"E09HT",605,561,"1200x900",1000,1,600,400,"False",231,406,489,83,83,0
"E09HT",606,125,"1200x900",600,1,600,400,"True",750,531,474,-57,57,0
"E09HT",607,439,"1200x900",1000,0,600,400,"False",110,229,437,208,208,1
"E09HT",608,3,"1200x900",600,0,600,400,"True",298,443,392,-51,51,1
"E09HT",609,348,"1200x900",800,1,600,400,"False",764,294,387,93,93,0
"E09HT",610,188,"1200x900",600,2,600,400,"False",900,195,394,199,199,0
"E09HT",611,384,"1200x900",800,2,600,400,"False",821,707,399,-308,308,0
"E09HT",612,62,"1200x900",600,0,600,400,"True",345,346,404,58,58,1
"E09HT",613,538,"1200x900",1000,1,600,400,"False",308,457,745,288,288,1
"E09HT",614,90,"1200x900",600,1,600,400,"False",560,474,367,-107,107,0
"E09HT",615,472,"1200x900",1000,0,600,400,"False",77,685,562,-123,123,1
"E09HT",616,338,"1200x900",800,1,600,400,"False",813,253,490,237,237,1
"E09HT",617,273,"1200x900",800,0,600,400,"False",180,309,420,111,111,1
"E09HT",618,371,"1200x900",800,2,600,400,"False",730,560,427,-133,133,0
"E09HT",619,582,"1200x900",1000,2,600,400,"False",554,347,571,224,224,0
"E09HT",620,476,"1200x900",1000,0,600,400,"True",76,359,395,36,36,1
"E09HT",621,70,"1200x900",600,0,600,400,"True",309,703,695,-8,8,1
"E09HT",622,449,"1200x900",1000,0,600,400,"False",105,683,620,-63,63,1
"E09HT",623,569,"1200x900",1000,1,600,400,"False",494,720,630,-90,90,0
"E09HT",624,34,"1200x900",600,0,600,400,"True",361,242,242,0,0,1
"E09HT",625,113,"1200x900",600,1,600,400,"False",897,657,403,-254,254,0
"E09HT",627,177,"1200x900",600,2,600,400,"True",912,236,307,71,71,0
"E09HT",628,134,"1200x900",600,1,600,400,"True",300,188,195,7,7,0
"E09HT",629,5,"1200x900",600,0,600,400,"False",228,587,409,-178,178,0
"E09HT",630,563,"1200x900",1000,1,600,400,"True",201,696,713,17,17,0
"E09HT",631,30,"1200x900",600,0,600,400,"True",107,353,388,35,35,0
"E09HT",632,172,"1200x900",600,2,600,400,"False",912,444,334,-110,110,0
"E09HT",633,546,"1200x900",1000,1,600,400,"True",305,374,364,-10,10,0
"E09HT",634,619,"1200x900",1000,2,600,400,"False",803,247,324,77,77,0
"E09HT",635,510,"1200x900",1000,1,600,400,"True",486,338,325,-13,13,1
"E09HT",637,508,"1200x900",1000,1,600,400,"False",596,485,335,-150,150,0
"E09HT",638,627,"1200x900",1000,2,600,400,"True",760,510,515,5,5,0
"E09HT",639,643,"1200x900",1000,2,600,400,"True",740,325,327,2,2,0
"E09HT",640,205,"1200x900",600,2,600,400,"False",1021,504,715,211,211,0
"E09HT",641,217,"1200x900",800,0,600,400,"False",85,573,473,-100,100,1
"E09HT",642,330,"1200x900",800,1,600,400,"True",759,301,272,-29,29,1
"E09HT",643,363,"1200x900",800,2,600,400,"False",800,218,406,188,188,0
"E09HT",644,182,"1200x900",600,2,600,400,"True",933,389,368,-21,21,0
"E09HT",645,115,"1200x900",600,1,600,400,"True",545,307,258,-49,49,0
"E09HT",646,309,"1200x900",800,1,600,400,"False",186,225,520,295,295,0
"E09HT",647,519,"1200x900",1000,1,600,400,"False",319,565,389,-176,176,1
"E09HT",648,494,"1200x900",1000,0,600,400,"False",127,692,562,-130,130,1
"E10PO",1,46,"1200x900",600,0,600,400,"True",193,355,395,40,40,1
"E10PO",2,232,"1200x900",800,0,600,400,"False",84,511,311,-200,200,1
"E10PO",3,465,"1200x900",1000,0,600,400,"True",85,203,221,18,18,1
"E10PO",4,328,"1200x900",800,1,600,400,"False",104,649,567,-82,82,0
"E10PO",5,69,"1200x900",600,0,600,400,"True",322,268,289,21,21,0
"E10PO",6,517,"1200x900",1000,1,600,400,"False",548,182,265,83,83,0
"E10PO",7,625,"1200x900",1000,2,600,400,"False",279,228,143,-85,85,0
"E10PO",8,316,"1200x900",800,1,600,400,"False",362,319,447,128,128,0
"E10PO",9,60,"1200x900",600,0,600,400,"True",365,213,232,19,19,1
"E10PO",10,300,"1200x900",800,1,600,400,"False",620,693,314,-379,379,0
"E10PO",11,96,"1200x900",600,1,600,400,"False",433,458,533,75,75,0
"E10PO",12,573,"1200x900",1000,1,600,400,"False",486,615,530,-85,85,0
"E10PO",13,215,"1200x900",600,2,600,400,"True",939,596,585,-11,11,0
"E10PO",14,382,"1200x900",800,2,600,400,"True",870,523,521,-2,2,0
"E10PO",15,627,"1200x900",1000,2,600,400,"True",760,510,526,16,16,0
"E10PO",16,431,"1200x900",800,2,600,400,"False",694,382,457,75,75,0
"E10PO",17,345,"1200x900",800,1,600,400,"True",841,566,560,-6,6,1
"E10PO",18,129,"1200x900",600,1,600,400,"False",859,482,398,-84,84,1
"E10PO",19,454,"1200x900",1000,0,600,400,"False",78,687,305,-382,382,1
"E10PO",20,155,"1200x900",600,2,600,400,"True",940,269,313,44,44,0
"E10PO",21,324,"1200x900",800,1,600,400,"False",719,712,310,-402,402,1
"E10PO",22,538,"1200x900",1000,1,600,400,"True",308,457,380,-77,77,1
"E10PO",23,281,"1200x900",800,0,600,400,"True",112,611,565,-46,46,1
"E10PO",24,1,"1200x900",600,0,600,400,"True",136,502,492,-10,10,0
"E10PO",26,58,"1200x900",600,0,600,400,"False",353,655,564,-91,91,1
"E10PO",27,509,"1200x900",1000,1,600,400,"True",509,434,485,51,51,0
"E10PO",28,582,"1200x900",1000,2,600,400,"False",554,347,562,215,215,0
"E10PO",29,169,"1200x900",600,2,600,400,"False",924,290,553,263,263,0
"E10PO",30,323,"1200x900",800,1,600,400,"False",388,348,736,388,388,0
"E10PO",31,544,"1200x900",1000,1,600,400,"False",602,620,703,83,83,0
"E10PO",32,288,"1200x900",800,0,600,400,"False",180,547,626,79,79,1
"E10PO",33,640,"1200x900",1000,2,600,400,"True",361,334,338,4,4,0
"E10PO",34,522,"1200x900",1000,1,600,400,"True",223,379,430,51,51,0
"E10PO",35,448,"1200x900",1000,0,600,400,"False",107,641,517,-124,124,1
"E10PO",36,167,"1200x900",600,2,600,400,"True",956,241,301,60,60,0
"E10PO",37,610,"1200x900",1000,2,600,400,"False",702,293,393,100,100,0
"E10PO",38,273,"1200x900",800,0,600,400,"False",180,309,385,76,76,1
"E10PO",40,212,"1200x900",600,2,600,400,"False",841,206,381,175,175,0
"E10PO",41,396,"1200x900",800,2,600,400,"False",678,663,378,-285,285,0
"E10PO",42,28,"1200x900",600,0,600,400,"True",336,410,435,25,25,1
"E10PO",43,139,"1200x900",600,1,600,400,"False",192,695,602,-93,93,0
"E10PO",44,393,"1200x900",800,2,600,400,"False",657,620,691,71,71,0
"E10PO",45,357,"1200x900",800,1,600,400,"False",109,594,434,-160,160,0
"E10PO",46,484,"1200x900",1000,0,600,400,"False",100,223,482,259,259,1
"E10PO",47,190,"1200x900",600,2,600,400,"True",977,238,230,-8,8,0
"E10PO",48,332,"1200x900",800,1,600,400,"True",260,699,613,-86,86,0
"E10PO",49,648,"1200x900",1000,2,600,400,"False",557,394,199,-195,195,0
"E10PO",50,192,"1200x900",600,2,600,400,"False",1064,320,848,528,528,0
"E10PO",51,329,"1200x900",800,1,600,400,"False",517,239,451,212,212,0
"E10PO",52,631,"1200x900",1000,2,600,400,"True",699,479,505,26,26,0
"E10PO",53,32,"1200x900",600,0,600,400,"False",152,563,431,-132,132,1
"E10PO",54,514,"1200x900",1000,1,600,400,"False",539,690,432,-258,258,0
"E10PO",55,422,"1200x900",800,2,600,400,"False",712,558,418,-140,140,0
"E10PO",56,379,"1200x900",800,2,600,400,"False",994,325,586,261,261,0
"E10PO",57,325,"1200x900",800,1,600,400,"True",105,394,428,34,34,0
"E10PO",58,411,"1200x900",800,2,600,400,"False",805,361,477,116,116,0
"E10PO",59,200,"1200x900",600,2,600,400,"True",897,302,344,42,42,0
"E10PO",60,226,"1200x900",800,0,600,400,"False",187,229,297,68,68,1
"E10PO",61,460,"1200x900",1000,0,600,400,"False",155,189,290,101,101,1
"E10PO",62,204,"1200x900",600,2,600,400,"False",1053,432,287,-145,145,0
"E10PO",63,479,"1200x900",1000,0,600,400,"False",74,705,345,-360,360,1
"E10PO",64,609,"1200x900",1000,2,600,400,"False",697,627,375,-252,252,0
"E10PO",65,634,"1200x900",1000,2,600,400,"False",735,313,383,70,70,0
"E10PO",66,142,"1200x900",600,1,600,400,"False",286,474,337,-137,137,0
"E10PO",67,413,"1200x900",800,2,600,400,"False",849,506,365,-141,141,0
"E10PO",68,528,"1200x900",1000,1,600,400,"False",839,227,346,119,119,1
"E10PO",69,304,"1200x900",800,1,600,400,"False",667,605,347,-258,258,0
"E10PO",70,501,"1200x900",1000,0,600,400,"False",96,323,390,67,67,1
"E10PO",71,138,"1200x900",600,1,600,400,"False",844,580,373,-207,207,1
"E10PO",72,35,"1200x900",600,0,600,400,"True",366,555,525,-30,30,1
"E10PO",73,173,"1200x900",600,2,600,400,"False",948,693,324,-369,369,0
"E10PO",74,110,"1200x900",600,1,600,400,"False",776,550,739,189,189,1
"E10PO",75,221,"1200x900",800,0,600,400,"False",132,520,338,-182,182,1
"E10PO",76,189,"1200x900",600,2,600,400,"False",881,397,583,186,186,0
"E10PO",77,7,"1200x900",600,0,600,400,"False",431,654,532,-122,122,1
"E10PO",78,425,"1200x900",800,2,600,400,"False",621,438,615,177,177,0
"E10PO",79,151,"1200x900",600,2,600,400,"False",828,680,578,-102,102,0
"E10PO",80,191,"1200x900",600,2,600,400,"False",962,396,580,184,184,0
"E10PO",81,233,"1200x900",800,0,600,400,"True",164,700,691,-9,9,1
"E10PO",82,591,"1200x900",1000,2,600,400,"False",698,336,644,308,308,0
"E10PO",83,145,"1200x900",600,2,600,400,"True",1004,630,646,16,16,0
"E10PO",84,255,"1200x900",800,0,600,400,"False",93,709,606,-103,103,1
"E10PO",85,74,"1200x900",600,1,600,400,"False",115,358,639,281,281,0
"E10PO",86,337,"1200x900",800,1,600,400,"False",299,622,707,85,85,0
"E10PO",87,524,"1200x900",1000,1,600,400,"False",534,470,680,210,210,0
"E10PO",88,48,"1200x900",600,0,600,400,"True",323,645,613,-32,32,1
"E10PO",89,257,"1200x900",800,0,600,400,"True",97,219,230,11,11,1
"E10PO",90,296,"1200x900",800,1,600,400,"False",89,279,405,126,126,0
"E10PO",91,360,"1200x900",800,1,600,400,"False",203,608,360,-248,248,0
"E10PO",92,201,"1200x900",600,2,600,400,"False",1005,462,348,-114,114,0
"E10PO",93,563,"1200x900",1000,1,600,400,"False",201,696,266,-430,430,0
"E10PO",94,140,"1200x900",600,1,600,400,"True",700,523,569,46,46,0
"E10PO",95,77,"1200x900",600,1,600,400,"True",780,525,571,46,46,0
"E10PO",96,604,"1200x900",1000,2,600,400,"True",459,593,563,-30,30,0
"E10PO",97,612,"1200x900",1000,2,600,400,"False",706,198,445,247,247,0
"E10PO",98,15,"1200x900",600,0,600,400,"True",473,352,326,-26,26,1
"E10PO",99,91,"1200x900",600,1,600,400,"False",417,630,420,-210,210,1
"E10PO",100,126,"1200x900",600,1,600,400,"True",849,354,412,58,58,0
"E10PO",101,306,"1200x900",800,1,600,400,"True",164,524,574,50,50,0
"E10PO",102,293,"1200x900",800,1,600,400,"False",561,396,530,134,134,0
"E10PO",103,588,"1200x900",1000,2,600,400,"False",585,350,440,90,90,0
"E10PO",104,245,"1200x900",800,0,600,400,"False",296,235,361,126,126,1
"E10PO",105,327,"1200x900",800,1,600,400,"True",152,339,286,-53,53,0
"E10PO",106,568,"1200x900",1000,1,600,400,"True",286,475,448,-27,27,1
"E10PO",107,291,"1200x900",800,1,600,400,"False",522,694,450,-244,244,0
"E10PO",108,208,"1200x900",600,2,600,400,"True",946,399,453,54,54,0
"E10PO",109,381,"1200x900",800,2,600,400,"True",705,408,442,34,34,0
"E10PO",110,476,"1200x900",1000,0,600,400,"False",76,359,459,100,100,1
"E10PO",111,530,"1200x900",1000,1,600,400,"True",584,405,366,-39,39,1
"E10PO",112,358,"1200x900",800,1,600,400,"False",263,635,332,-303,303,0
"E10PO",113,64,"1200x900",600,0,600,400,"True",102,339,325,-14,14,0
"E10PO",114,391,"1200x900",800,2,600,400,"False",895,521,367,-154,154,0
"E10PO",115,308,"1200x900",800,1,600,400,"False",437,425,291,-134,134,0
"E10PO",116,565,"1200x900",1000,1,600,400,"False",451,562,347,-215,215,0
"E10PO",117,647,"1200x900",1000,2,600,400,"False",560,637,494,-143,143,0
"E10PO",118,401,"1200x900",800,2,600,400,"False",821,260,486,226,226,0
"E10PO",119,557,"1200x900",1000,1,600,400,"False",677,505,566,61,61,1
"E10PO",120,152,"1200x900",600,2,600,400,"True",971,399,353,-46,46,0
"E10PO",121,47,"1200x900",600,0,600,400,"False",303,499,375,-124,124,1
"E10PO",122,10,"1200x900",600,0,600,400,"False",400,499,376,-123,123,1
"E10PO",123,598,"1200x900",1000,2,600,400,"False",706,559,381,-178,178,0
"E10PO",124,417,"1200x900",800,2,600,400,"False",750,280,400,120,120,0
"E10PO",125,506,"1200x900",1000,1,600,400,"False",559,567,403,-164,164,1
"E10PO",126,331,"1200x900",800,1,600,400,"True",240,620,590,-30,30,0
"E10PO",127,375,"1200x900",800,2,600,400,"False",716,384,592,208,208,0
"E10PO",128,311,"1200x900",800,1,600,400,"False",710,261,590,329,329,0
"E10PO",129,302,"1200x900",800,1,600,400,"False",479,467,541,74,74,1
"E10PO",130,50,"1200x900",600,0,600,400,"True",75,582,536,-46,46,0
"E10PO",131,217,"1200x900",800,0,600,400,"False",85,573,502,-71,71,1
"E10PO",132,210,"1200x900",600,2,600,400,"True",835,506,561,55,55,0
"E10PO",133,372,"1200x900",800,2,600,400,"True",833,620,560,-60,60,0
"E10PO",136,475,"1200x900",1000,0,600,400,"False",101,715,581,-134,134,1
"E10PO",137,451,"1200x900",1000,0,600,400,"False",110,702,626,-76,76,1
"E10PO",138,390,"1200x900",800,2,600,400,"True",982,674,576,-98,98,1
"E10PO",139,394,"1200x900",800,2,600,400,"False",847,292,595,303,303,0
"E10PO",140,386,"1200x900",800,2,600,400,"True",774,301,380,79,79,0
"E10PO",141,471,"1200x900",1000,0,600,400,"True",122,200,188,-12,12,1
"E10PO",142,550,"1200x900",1000,1,600,400,"False",301,459,253,-206,206,0
"E10PO",143,642,"1200x900",1000,2,600,400,"True",776,316,346,30,30,0
"E10PO",145,579,"1200x900",1000,2,600,400,"True",803,394,436,42,42,0
"E10PO",146,66,"1200x900",600,0,600,400,"True",155,673,615,-58,58,0
"E10PO",147,113,"1200x900",600,1,600,400,"False",897,657,536,-121,121,0
"E10PO",148,546,"1200x900",1000,1,600,400,"False",305,374,538,164,164,0
"E10PO",149,33,"1200x900",600,0,600,400,"True",198,533,506,-27,27,1
"E10PO",150,111,"1200x900",600,1,600,400,"True",922,552,553,1,1,1
"E10PO",151,377,"1200x900",800,2,600,400,"False",683,388,569,181,181,0
"E10PO",152,260,"1200x900",800,0,600,400,"True",103,525,496,-29,29,1
"E10PO",153,88,"1200x900",600,1,600,400,"True",186,554,569,15,15,0
"E10PO",154,513,"1200x900",1000,1,600,400,"False",235,602,453,-149,149,0
"E10PO",155,57,"1200x900",600,0,600,400,"True",354,508,521,13,13,1
"E10PO",156,26,"1200x900",600,0,600,400,"False",70,712,566,-146,146,0
"E10PO",157,494,"1200x900",1000,0,600,400,"True",127,692,735,43,43,1
"E10PO",158,636,"1200x900",1000,2,600,400,"False",575,583,487,-96,96,0
"E10PO",159,174,"1200x900",600,2,600,400,"True",998,457,469,12,12,0
"E10PO",160,19,"1200x900",600,0,600,400,"True",286,686,730,44,44,0
"E10PO",161,532,"1200x900",1000,1,600,400,"False",215,207,523,316,316,0
"E10PO",162,56,"1200x900",600,0,600,400,"True",148,491,470,-21,21,0
"E10PO",163,234,"1200x900",800,0,600,400,"True",72,344,405,61,61,1
"E10PO",164,326,"1200x900",800,1,600,400,"False",103,482,388,-94,94,0
"E10PO",165,11,"1200x900",600,0,600,400,"True",372,670,669,-1,1,1
"E10PO",166,427,"1200x900",800,2,600,400,"False",812,380,506,126,126,0
"E10PO",167,347,"1200x900",800,1,600,400,"False",757,295,420,125,125,1
"E10PO",168,62,"1200x900",600,0,600,400,"True",345,346,330,-16,16,1
"E10PO",169,227,"1200x900",800,0,600,400,"False",196,551,744,193,193,1
"E10PO",170,259,"1200x900",800,0,600,400,"False",156,180,365,185,185,1
"E10PO",171,39,"1200x900",600,0,600,400,"False",210,609,473,-136,136,0
"E10PO",172,367,"1200x900",800,2,600,400,"True",613,464,448,-16,16,0
"E10PO",173,503,"1200x900",1000,0,600,400,"True",86,279,271,-8,8,1
"E10PO",174,519,"1200x900",1000,1,600,400,"True",319,565,598,33,33,1
"E10PO",175,136,"1200x900",600,1,600,400,"False",264,205,314,109,109,0
"E10PO",176,416,"1200x900",800,2,600,400,"False",748,617,307,-310,310,0
"E10PO",177,38,"1200x900",600,0,600,400,"False",120,628,729,101,101,1
"E10PO",178,252,"1200x900",800,0,600,400,"True",224,673,719,46,46,1
"E10PO",179,241,"1200x900",800,0,600,400,"False",129,227,336,109,109,1
"E10PO",180,555,"1200x900",1000,1,600,400,"False",444,556,465,-91,91,0
"E10PO",181,440,"1200x900",1000,0,600,400,"False",71,237,324,87,87,1
"E10PO",182,109,"1200x900",600,1,600,400,"True",691,589,542,-47,47,0
"E10PO",183,292,"1200x900",800,1,600,400,"False",88,565,715,150,150,0
"E10PO",184,343,"1200x900",800,1,600,400,"False",407,557,656,99,99,0
"E10PO",185,423,"1200x900",800,2,600,400,"True",1051,710,652,-58,58,1
"E10PO",186,101,"1200x900",600,1,600,400,"False",541,656,766,110,110,0
"E10PO",187,585,"1200x900",1000,2,600,400,"False",698,688,606,-82,82,1
"E10PO",188,27,"1200x900",600,0,600,400,"False",373,309,379,70,70,1
"E10PO",189,335,"1200x900",800,1,600,400,"True",124,360,362,2,2,0
"E10PO",190,36,"1200x900",600,0,600,400,"False",128,346,272,-74,74,1
"E10PO",191,364,"1200x900",800,2,600,400,"False",1018,204,471,267,267,0
"E10PO",192,577,"1200x900",1000,2,600,400,"True",455,420,462,42,42,0
"E10PO",193,405,"1200x900",800,2,600,400,"False",790,307,461,154,154,0
"E10PO",194,272,"1200x900",800,0,600,400,"False",200,181,242,61,61,1
"E10PO",195,278,"1200x900",800,0,600,400,"False",251,711,497,-214,214,1
"E10PO",196,415,"1200x900",800,2,600,400,"False",823,684,499,-185,185,0
"E10PO",197,333,"1200x900",800,1,600,400,"True",521,548,619,71,71,0
"E10PO",198,52,"1200x900",600,0,600,400,"True",171,188,123,-65,65,0
"E10PO",199,622,"1200x900",1000,2,600,400,"False",307,683,226,-457,457,0
"E10PO",200,560,"1200x900",1000,1,600,400,"False",516,693,379,-314,314,0
"E10PO",201,321,"1200x900",800,1,600,400,"False",601,190,278,88,88,0
"E10PO",202,159,"1200x900",600,2,600,400,"False",992,309,159,-150,150,0
"E10PO",203,351,"1200x900",800,1,600,400,"True",122,581,543,-38,38,0
"E10PO",204,71,"1200x900",600,0,600,400,"True",219,248,300,52,52,0
"E10PO",205,34,"1200x900",600,0,600,400,"True",361,242,192,-50,50,1
"E10PO",206,41,"1200x900",600,0,600,400,"False",370,452,348,-104,104,1
"E10PO",207,439,"1200x900",1000,0,600,400,"True",110,229,278,49,49,1
"E10PO",208,30,"1200x900",600,0,600,400,"True",107,353,337,-16,16,0
"E10PO",209,629,"1200x900",1000,2,600,400,"True",681,257,226,-31,31,0
"E10PO",210,256,"1200x900",800,0,600,400,"True",192,656,720,64,64,1
"E10PO",211,409,"1200x900",800,2,600,400,"True",501,659,685,26,26,0
"E10PO",212,467,"1200x900",1000,0,600,400,"False",74,712,631,-81,81,1
"E10PO",213,537,"1200x900",1000,1,600,400,"False",621,412,521,109,109,1
"E10PO",214,470,"1200x900",1000,0,600,400,"True",91,666,650,-16,16,1
"E10PO",215,269,"1200x900",800,0,600,400,"True",160,295,313,18,18,1
"E10PO",216,624,"1200x900",1000,2,600,400,"False",693,501,317,-184,184,0
"E10PO",217,185,"1200x900",600,2,600,400,"False",907,212,364,152,152,0
"E10PO",218,594,"1200x900",1000,2,600,400,"False",537,637,458,-179,179,0
"E10PO",219,286,"1200x900",800,0,600,400,"True",105,378,318,-60,60,1
"E10PO",220,518,"1200x900",1000,1,600,400,"False",583,717,338,-379,379,0
"E10PO",221,461,"1200x900",1000,0,600,400,"True",95,711,693,-18,18,1
"E10PO",222,539,"1200x900",1000,1,600,400,"False",510,383,696,313,313,0
"E10PO",223,224,"1200x900",800,0,600,400,"True",161,474,485,11,11,1
"E10PO",224,455,"1200x900",1000,0,600,400,"False",107,718,570,-148,148,1
"E10PO",225,198,"1200x900",600,2,600,400,"False",976,500,579,79,79,0
"E10PO",226,258,"1200x900",800,0,600,400,"True",126,664,705,41,41,1
"E10PO",227,459,"1200x900",1000,0,600,400,"True",70,645,631,-14,14,1
"E10PO",228,500,"1200x900",1000,0,600,400,"False",105,700,603,-97,97,1
"E10PO",229,78,"1200x900",600,1,600,400,"True",885,684,556,-128,128,0
"E10PO",230,163,"1200x900",600,2,600,400,"True",1046,665,616,-49,49,0
"E10PO",231,236,"1200x900",800,0,600,400,"True",162,350,285,-65,65,1
"E10PO",232,246,"1200x900",800,0,600,400,"True",196,418,351,-67,67,1
"E10PO",233,44,"1200x900",600,0,600,400,"False",305,554,444,-110,110,1
"E10PO",234,299,"1200x900",800,1,600,400,"False",779,274,613,339,339,0
"E10PO",235,342,"1200x900",800,1,600,400,"False",677,204,427,223,223,0
"E10PO",236,40,"1200x900",600,0,600,400,"True",143,513,563,50,50,0
"E10PO",237,374,"1200x900",800,2,600,400,"True",755,450,409,-41,41,0
"E10PO",238,179,"1200x900",600,2,600,400,"True",908,602,526,-76,76,0
"E10PO",239,630,"1200x900",1000,2,600,400,"True",754,559,583,24,24,0
"E10PO",240,265,"1200x900",800,0,600,400,"True",229,353,380,27,27,1
"E10PO",241,73,"1200x900",600,1,600,400,"False",94,665,516,-149,149,0
"E10PO",242,206,"1200x900",600,2,600,400,"False",975,223,331,108,108,0
"E10PO",243,472,"1200x900",1000,0,600,400,"False",77,685,457,-228,228,1
"E10PO",244,433,"1200x900",1000,0,600,400,"True",76,222,241,19,19,1
"E10PO",245,182,"1200x900",600,2,600,400,"False",933,389,250,-139,139,0
"E10PO",246,355,"1200x900",800,1,600,400,"True",77,386,307,-79,79,0
"E10PO",247,527,"1200x900",1000,1,600,400,"False",565,601,300,-301,301,0
"E10PO",248,20,"1200x900",600,0,600,400,"True",204,545,532,-13,13,1
"E10PO",249,597,"1200x900",1000,2,600,400,"False",352,239,471,232,232,0
"E10PO",250,430,"1200x900",800,2,600,400,"True",922,254,323,69,69,0
"E10PO",251,104,"1200x900",600,1,600,400,"True",448,584,509,-75,75,0
"E10PO",252,230,"1200x900",800,0,600,400,"False",99,678,590,-88,88,1
"E10PO",253,42,"1200x900",600,0,600,400,"True",233,479,505,26,26,0
"E10PO",254,114,"1200x900",600,1,600,400,"False",183,697,783,86,86,0
"E10PO",255,615,"1200x900",1000,2,600,400,"False",736,634,280,-354,354,0
"E10PO",256,216,"1200x900",600,2,600,400,"True",1029,286,331,45,45,0
"E10PO",257,84,"1200x900",600,1,600,400,"True",144,184,171,-13,13,0
"E10PO",258,63,"1200x900",600,0,600,400,"True",311,188,184,-4,4,1
"E10PO",259,369,"1200x900",800,2,600,400,"True",903,594,626,32,32,0
"E10PO",260,118,"1200x900",600,1,600,400,"True",190,588,640,52,52,0
"E10PO",261,486,"1200x900",1000,0,600,400,"False",102,676,579,-97,97,1
"E10PO",262,645,"1200x900",1000,2,600,400,"False",619,396,723,327,327,0
"E10PO",263,387,"1200x900",800,2,600,400,"False",990,444,341,-103,103,0
"E10PO",264,646,"1200x900",1000,2,600,400,"True",829,227,317,90,90,1
"E10PO",265,132,"1200x900",600,1,600,400,"False",333,185,332,147,147,0
"E10PO",266,543,"1200x900",1000,1,600,400,"False",88,202,650,448,448,0
"E10PO",267,426,"1200x900",800,2,600,400,"False",830,263,450,187,187,0
"E10PO",268,638,"1200x900",1000,2,600,400,"False",385,198,517,319,319,0
"E10PO",269,121,"1200x900",600,1,600,400,"False",884,364,271,-93,93,0
"E10PO",270,322,"1200x900",800,1,600,400,"False",703,206,412,206,206,1
"E10PO",271,97,"1200x900",600,1,600,400,"False",760,643,734,91,91,1
"E10PO",272,250,"1200x900",800,0,600,400,"False",290,248,319,71,71,1
"E10PO",273,320,"1200x900",800,1,600,400,"True",644,376,362,-14,14,0
"E10PO",274,49,"1200x900",600,0,600,400,"True",109,380,405,25,25,0
"E10PO",275,202,"1200x900",600,2,600,400,"False",966,460,395,-65,65,0
"E10PO",276,280,"1200x900",800,0,600,400,"True",104,302,255,-47,47,1
"E10PO",277,600,"1200x900",1000,2,600,400,"False",765,207,393,186,186,0
"E10PO",278,473,"1200x900",1000,0,600,400,"True",75,323,256,-67,67,1
"E10PO",279,643,"1200x900",1000,2,600,400,"True",740,325,323,-2,2,0
"E10PO",280,593,"1200x900",1000,2,600,400,"False",246,719,392,-327,327,0
"E10PO",281,570,"1200x900",1000,1,600,400,"False",315,352,503,151,151,0
"E10PO",282,410,"1200x900",800,2,600,400,"True",916,477,520,43,43,0
"E10PO",283,376,"1200x900",800,2,600,400,"False",788,275,569,294,294,0
"E10PO",284,261,"1200x900",800,0,600,400,"True",86,713,683,-30,30,1
"E10PO",285,196,"1200x900",600,2,600,400,"False",1030,397,336,-61,61,0
"E10PO",286,262,"1200x900",800,0,600,400,"False",196,481,398,-83,83,1
"E10PO",287,117,"1200x900",600,1,600,400,"False",711,456,396,-60,60,0
"E10PO",288,235,"1200x900",800,0,600,400,"False",146,646,492,-154,154,1
"E10PO",289,115,"1200x900",600,1,600,400,"False",545,307,490,183,183,0
"E10PO",290,213,"1200x900",600,2,600,400,"False",822,275,408,133,133,0
"E10PO",291,24,"1200x900",600,0,600,400,"False",430,538,394,-144,144,1
"E10PO",292,59,"1200x900",600,0,600,400,"True",391,692,719,27,27,1
"E10PO",293,620,"1200x900",1000,2,600,400,"True",832,649,711,62,62,0
"E10PO",294,93,"1200x900",600,1,600,400,"False",139,540,648,108,108,0
"E10PO",295,16,"1200x900",600,0,600,400,"False",297,514,592,78,78,1
"E10PO",296,402,"1200x900",800,2,600,400,"False",878,234,558,324,324,0
"E10PO",297,558,"1200x900",1000,1,600,400,"False",72,464,617,153,153,1
"E10PO",298,542,"1200x900",1000,1,600,400,"True",304,401,405,4,4,0
"E10PO",299,587,"1200x900",1000,2,600,400,"False",741,686,411,-275,275,0
"E10PO",300,282,"1200x900",800,0,600,400,"False",109,246,355,109,109,1
"E10PO",301,397,"1200x900",800,2,600,400,"False",817,692,435,-257,257,0
"E10PO",302,457,"1200x900",1000,0,600,400,"False",97,630,479,-151,151,1
"E10PO",303,359,"1200x900",800,1,600,400,"False",653,241,482,241,241,0
"E10PO",304,497,"1200x900",1000,0,600,400,"False",106,696,531,-165,165,1
"E10PO",305,229,"1200x900",800,0,600,400,"True",117,697,677,-20,20,1
"E10PO",306,424,"1200x900",800,2,600,400,"False",903,545,411,-134,134,0
"E10PO",307,384,"1200x900",800,2,600,400,"True",821,707,674,-33,33,0
"E10PO",308,572,"1200x900",1000,1,600,400,"False",302,260,653,393,393,0
"E10PO",309,350,"1200x900",800,1,600,400,"False",182,566,492,-74,74,0
"E10PO",310,248,"1200x900",800,0,600,400,"False",94,240,371,131,131,1
"E10PO",311,483,"1200x900",1000,0,600,400,"False",93,191,283,92,92,1
"E10PO",312,187,"1200x900",600,2,600,400,"False",857,639,543,-96,96,0
"E10PO",313,566,"1200x900",1000,1,600,400,"False",378,472,395,-77,77,1
"E10PO",314,516,"1200x900",1000,1,600,400,"False",440,559,483,-76,76,0
"E10PO",315,4,"1200x900",600,0,600,400,"False",602,200,362,162,162,1
"E10PO",316,8,"1200x900",600,0,600,400,"False",156,679,591,-88,88,0
"E10PO",317,432,"1200x900",800,2,600,400,"True",792,380,470,90,90,0
"E10PO",318,249,"1200x900",800,0,600,400,"True",126,306,285,-21,21,1
"E10PO",319,338,"1200x900",800,1,600,400,"False",813,253,395,142,142,1
"E10PO",320,164,"1200x900",600,2,600,400,"True",1051,268,281,13,13,0
"E10PO",321,237,"1200x900",800,0,600,400,"False",204,481,400,-81,81,1
"E10PO",322,535,"1200x900",1000,1,600,400,"True",372,410,468,58,58,0
"E10PO",323,561,"1200x900",1000,1,600,400,"False",231,406,525,119,119,0
"E10PO",324,365,"1200x900",800,2,600,400,"False",1055,305,571,266,266,0
"E10PO",325,303,"1200x900",800,1,600,400,"False",241,431,260,-171,171,0
"E10PO",326,356,"1200x900",800,1,600,400,"False",123,484,588,104,104,0
"E10PO",327,298,"1200x900",800,1,600,400,"False",311,457,361,-96,96,0
"E10PO",328,119,"1200x900",600,1,600,400,"True",168,563,545,-18,18,0
"E10PO",329,399,"1200x900",800,2,600,400,"True",603,602,637,35,35,0
"E10PO",330,428,"1200x900",800,2,600,400,"True",732,665,631,-34,34,0
"E10PO",331,314,"1200x900",800,1,600,400,"False",277,616,700,84,84,1
"E10PO",332,354,"1200x900",800,1,600,400,"False",118,236,622,386,386,0
"E10PO",333,251,"1200x900",800,0,600,400,"False",88,352,240,-112,112,1
"E10PO",334,156,"1200x900",600,2,600,400,"False",913,197,306,109,109,0
"E10PO",335,305,"1200x900",800,1,600,400,"False",471,716,481,-235,235,0
"E10PO",336,82,"1200x900",600,1,600,400,"False",108,213,493,280,280,0
"E10PO",337,456,"1200x900",1000,0,600,400,"True",91,257,269,12,12,1
"E10PO",338,551,"1200x900",1000,1,600,400,"False",146,445,559,114,114,1
"E10PO",339,313,"1200x900",800,1,600,400,"False",588,421,516,95,95,0
"E10PO",340,158,"1200x900",600,2,600,400,"True",939,300,274,-26,26,0
"E10PO",341,112,"1200x900",600,1,600,400,"False",681,490,328,-162,162,0
"E10PO",342,18,"1200x900",600,0,600,400,"True",400,318,360,42,42,1
"E10PO",343,122,"1200x900",600,1,600,400,"False",817,709,428,-281,281,0
"E10PO",344,576,"1200x900",1000,1,600,400,"True",376,713,655,-58,58,0
"E10PO",345,177,"1200x900",600,2,600,400,"False",912,236,383,147,147,0
"E10PO",346,105,"1200x900",600,1,600,400,"False",527,440,638,198,198,0
"E10PO",347,209,"1200x900",600,2,600,400,"True",937,637,669,32,32,0
"E10PO",348,554,"1200x900",1000,1,600,400,"False",79,309,199,-110,110,1
"E10PO",349,238,"1200x900",800,0,600,400,"True",162,283,251,-32,32,1
"E10PO",350,515,"1200x900",1000,1,600,400,"False",307,217,356,139,139,0
"E10PO",351,75,"1200x900",600,1,600,400,"False",635,558,461,-97,97,0
"E10PO",352,312,"1200x900",800,1,600,400,"False",238,683,573,-110,110,0
"E10PO",353,162,"1200x900",600,2,600,400,"False",849,279,398,119,119,0
"E10PO",354,466,"1200x900",1000,0,600,400,"False",82,205,273,68,68,1
"E10PO",355,315,"1200x900",800,1,600,400,"False",105,211,321,110,110,0
"E10PO",356,344,"1200x900",800,1,600,400,"True",589,408,400,-8,8,0
"E10PO",357,607,"1200x900",1000,2,600,400,"True",900,573,580,7,7,1
"E10PO",358,218,"1200x900",800,0,600,400,"True",106,397,432,35,35,1
"E10PO",359,556,"1200x900",1000,1,600,400,"True",415,420,452,32,32,0
"E10PO",360,72,"1200x900",600,0,600,400,"True",158,537,501,-36,36,0
"E10PO",361,294,"1200x900",800,1,600,400,"False",262,287,579,292,292,0
"E10PO",362,443,"1200x900",1000,0,600,400,"True",99,651,681,30,30,1
"E10PO",363,569,"1200x900",1000,1,600,400,"True",494,720,708,-12,12,0
"E10PO",364,22,"1200x900",600,0,600,400,"True",398,591,646,55,55,1
"E10PO",365,53,"1200x900",600,0,600,400,"False",177,189,294,105,105,0
"E10PO",366,253,"1200x900",800,0,600,400,"False",177,424,186,-238,238,1
"E10PO",367,525,"1200x900",1000,1,600,400,"False",123,690,421,-269,269,0
"E10PO",368,438,"1200x900",1000,0,600,400,"True",77,713,664,-49,49,1
"E10PO",369,146,"1200x900",600,2,600,400,"False",989,492,143,-349,349,0
"E10PO",370,507,"1200x900",1000,1,600,400,"False",608,583,461,-122,122,1
"E10PO",371,389,"1200x900",800,2,600,400,"True",843,530,507,-23,23,0
"E10PO",372,635,"1200x900",1000,2,600,400,"False",833,402,321,-81,81,0
"E10PO",373,124,"1200x900",600,1,600,400,"True",345,467,486,19,19,0
"E10PO",374,223,"1200x900",800,0,600,400,"True",179,191,189,-2,2,1
"E10PO",375,533,"1200x900",1000,1,600,400,"True",355,483,435,-48,48,0
"E10PO",376,181,"1200x900",600,2,600,400,"True",1018,223,278,55,55,0
"E10PO",377,504,"1200x900",1000,0,600,400,"False",107,699,561,-138,138,1
"E10PO",378,310,"1200x900",800,1,600,400,"False",559,592,517,-75,75,0
"E10PO",379,107,"1200x900",600,1,600,400,"False",878,678,408,-270,270,0
"E10PO",380,559,"1200x900",1000,1,600,400,"False",641,244,428,184,184,0
"E10PO",381,644,"1200x900",1000,2,600,400,"True",495,486,477,-9,9,0
"E10PO",382,352,"1200x900",800,1,600,400,"False",235,717,537,-180,180,0
"E10PO",383,67,"1200x900",600,0,600,400,"True",289,308,359,51,51,1
"E10PO",384,157,"1200x900",600,2,600,400,"False",1016,323,257,-66,66,0
"E10PO",385,133,"1200x900",600,1,600,400,"False",345,551,625,74,74,0
"E10PO",386,55,"1200x900",600,0,600,400,"True",211,305,326,21,21,1
"E10PO",387,521,"1200x900",1000,1,600,400,"True",111,303,255,-48,48,1
"E10PO",388,130,"1200x900",600,1,600,400,"False",741,428,335,-93,93,0
"E10PO",389,171,"1200x900",600,2,600,400,"True",909,200,291,91,91,0
"E10PO",390,127,"1200x900",600,1,600,400,"False",309,691,482,-209,209,0
"E10PO",391,487,"1200x900",1000,0,600,400,"True",78,670,736,66,66,1
"E10PO",392,434,"1200x900",1000,0,600,400,"True",89,657,600,-57,57,1
"E10PO",393,614,"1200x900",1000,2,600,400,"True",823,563,519,-44,44,0
"E10PO",394,143,"1200x900",600,1,600,400,"False",479,284,422,138,138,1
"E10PO",395,511,"1200x900",1000,1,600,400,"True",408,390,421,31,31,1
"E10PO",396,480,"1200x900",1000,0,600,400,"True",100,231,255,24,24,1
"E10PO",397,362,"1200x900",800,2,600,400,"True",819,338,260,-78,78,0
"E10PO",398,309,"1200x900",800,1,600,400,"False",186,225,500,275,275,0
"E10PO",399,108,"1200x900",600,1,600,400,"False",830,239,324,85,85,0
"E10PO",400,383,"1200x900",800,2,600,400,"False",855,407,510,103,103,0
"E10PO",401,553,"1200x900",1000,1,600,400,"False",116,712,379,-333,333,0
"E10PO",402,606,"1200x900",1000,2,600,400,"True",653,627,554,-73,73,0
"E10PO",403,267,"1200x900",800,0,600,400,"True",145,665,709,44,44,1
"E10PO",404,581,"1200x900",1000,2,600,400,"False",310,357,265,-92,92,0
"E10PO",405,449,"1200x900",1000,0,600,400,"False",105,683,434,-249,249,1
"E10PO",406,193,"1200x900",600,2,600,400,"False",874,588,437,-151,151,0
"E10PO",407,403,"1200x900",800,2,600,400,"False",625,704,616,-88,88,0
"E10PO",408,141,"1200x900",600,1,600,400,"True",671,582,586,4,4,0
"E10PO",409,79,"1200x900",600,1,600,400,"False",731,289,480,191,191,0
"E10PO",410,184,"1200x900",600,2,600,400,"False",1067,441,669,228,228,0
"E10PO",411,639,"1200x900",1000,2,600,400,"False",504,456,329,-127,127,0
"E10PO",412,562,"1200x900",1000,1,600,400,"False",347,540,385,-155,155,0
"E10PO",413,488,"1200x900",1000,0,600,400,"True",129,687,756,69,69,1
"E10PO",414,398,"1200x900",800,2,600,400,"False",944,698,495,-203,203,0
"E10PO",415,549,"1200x900",1000,1,600,400,"False",657,366,456,90,90,0
"E10PO",416,529,"1200x900",1000,1,600,400,"True",267,412,454,42,42,1
"E10PO",417,502,"1200x900",1000,0,600,400,"True",111,639,622,-17,17,1
"E10PO",418,580,"1200x900",1000,2,600,400,"False",651,267,620,353,353,0
"E10PO",419,508,"1200x900",1000,1,600,400,"False",596,485,576,91,91,0
"E10PO",420,244,"1200x900",800,0,600,400,"True",194,203,153,-50,50,1
"E10PO",421,134,"1200x900",600,1,600,400,"True",300,188,253,65,65,0
"E10PO",422,307,"1200x900",800,1,600,400,"True",716,247,295,48,48,0
"E10PO",423,240,"1200x900",800,0,600,400,"False",330,656,438,-218,218,1
"E10PO",424,70,"1200x900",600,0,600,400,"True",309,703,664,-39,39,1
"E10PO",425,317,"1200x900",800,1,600,400,"False",185,564,438,-126,126,0
"E10PO",426,120,"1200x900",600,1,600,400,"False",690,655,516,-139,139,0
"E10PO",427,54,"1200x900",600,0,600,400,"True",474,564,581,17,17,1
"E10PO",428,458,"1200x900",1000,0,600,400,"True",78,624,665,41,41,1
"E10PO",429,637,"1200x900",1000,2,600,400,"False",750,460,576,116,116,0
"E10PO",430,586,"1200x900",1000,2,600,400,"False",802,262,465,203,203,0
"E10PO",431,348,"1200x900",800,1,600,400,"False",764,294,425,131,131,0
"E10PO",432,61,"1200x900",600,0,600,400,"True",272,670,644,-26,26,1
"E10PO",433,90,"1200x900",600,1,600,400,"True",560,474,498,24,24,0
"E10PO",434,231,"1200x900",800,0,600,400,"False",251,718,564,-154,154,1
"E10PO",435,536,"1200x900",1000,1,600,400,"False",580,213,565,352,352,0
"E10PO",436,510,"1200x900",1000,1,600,400,"True",486,338,344,6,6,1
"E10PO",437,290,"1200x900",800,1,600,400,"False",789,603,400,-203,203,0
"E10PO",438,268,"1200x900",800,0,600,400,"True",148,400,415,15,15,1
"E10PO",439,301,"1200x900",800,1,600,400,"False",162,574,642,68,68,0
"E10PO",440,6,"1200x900",600,0,600,400,"True",217,689,657,-32,32,1
"E10PO",441,270,"1200x900",800,0,600,400,"False",192,418,528,110,110,1
"E10PO",442,81,"1200x900",600,1,600,400,"False",696,225,514,289,289,0
"E10PO",443,225,"1200x900",800,0,600,400,"True",178,423,386,-37,37,1
"E10PO",444,149,"1200x900",600,2,600,400,"False",890,289,383,94,94,0
"E10PO",445,153,"1200x900",600,2,600,400,"True",1037,601,616,15,15,0
"E10PO",446,477,"1200x900",1000,0,600,400,"False",88,640,556,-84,84,1
"E10PO",447,380,"1200x900",800,2,600,400,"False",942,228,527,299,299,0
"E10PO",448,330,"1200x900",800,1,600,400,"False",759,301,245,-56,56,1
"E10PO",449,385,"1200x900",800,2,600,400,"False",740,456,692,236,236,0
"E10PO",450,464,"1200x900",1000,0,600,400,"False",82,222,337,115,115,1
"E10PO",451,254,"1200x900",800,0,600,400,"False",136,583,373,-210,210,1
"E10PO",452,520,"1200x900",1000,1,600,400,"False",564,260,438,178,178,0
"E10PO",453,523,"1200x900",1000,1,600,400,"False",339,318,386,68,68,0
"E10PO",454,98,"1200x900",600,1,600,400,"False",625,530,421,-109,109,0
"E10PO",455,445,"1200x900",1000,0,600,400,"True",78,302,274,-28,28,1
"E10PO",456,131,"1200x900",600,1,600,400,"False",531,367,430,63,63,0
"E10PO",457,592,"1200x900",1000,2,600,400,"False",492,392,485,93,93,0
"E10PO",458,595,"1200x900",1000,2,600,400,"False",687,640,482,-158,158,0
"E10PO",459,414,"1200x900",800,2,600,400,"True",831,592,609,17,17,0
"E10PO",460,175,"1200x900",600,2,600,400,"False",1028,432,324,-108,108,0
"E10PO",461,478,"1200x900",1000,0,600,400,"False",79,672,604,-68,68,1
"E10PO",462,601,"1200x900",1000,2,600,400,"True",735,697,723,26,26,0
"E10PO",463,468,"1200x900",1000,0,600,400,"True",121,219,197,-22,22,1
"E10PO",464,211,"1200x900",600,2,600,400,"False",986,407,344,-63,63,0
"E10PO",465,68,"1200x900",600,0,600,400,"True",165,367,437,70,70,0
"E10PO",466,574,"1200x900",1000,1,600,400,"True",614,194,179,-15,15,0
"E10PO",467,419,"1200x900",800,2,600,400,"True",769,351,321,-30,30,0
"E10PO",468,222,"1200x900",800,0,600,400,"True",152,206,242,36,36,1
"E10PO",469,165,"1200x900",600,2,600,400,"False",912,554,408,-146,146,0
"E10PO",471,633,"1200x900",1000,2,600,400,"False",564,253,403,150,150,0
"E10PO",472,219,"1200x900",800,0,600,400,"True",202,502,455,-47,47,1
"E10PO",473,318,"1200x900",800,1,600,400,"True",788,534,559,25,25,0
"E10PO",474,23,"1200x900",600,0,600,400,"False",308,463,390,-73,73,1
"E10PO",475,205,"1200x900",600,2,600,400,"False",1021,504,589,85,85,0
"E10PO",476,228,"1200x900",800,0,600,400,"True",174,687,632,-55,55,1
"E10PO",477,2,"1200x900",600,0,600,400,"False",159,323,407,84,84,0
"E10PO",478,195,"1200x900",600,2,600,400,"True",942,249,310,61,61,0
"E10PO",479,116,"1200x900",600,1,600,400,"True",767,289,329,40,40,0
"E10PO",480,247,"1200x900",800,0,600,400,"True",160,424,470,46,46,1
"E10PO",481,144,"1200x900",600,1,600,400,"False",718,371,524,153,153,0
"E10PO",482,170,"1200x900",600,2,600,400,"True",996,468,416,-52,52,0
"E10PO",483,541,"1200x900",1000,1,600,400,"True",339,478,442,-36,36,0
"E10PO",484,277,"1200x900",800,0,600,400,"True",140,310,292,-18,18,1
"E10PO",485,547,"1200x900",1000,1,600,400,"True",369,384,450,66,66,1
"E10PO",486,619,"1200x900",1000,2,600,400,"False",803,247,522,275,275,0
"E10PO",487,125,"1200x900",600,1,600,400,"True",750,531,536,5,5,0
"E10PO",488,147,"1200x900",600,2,600,400,"True",942,418,433,15,15,0
"E10PO",489,29,"1200x900",600,0,600,400,"True",385,533,512,-21,21,1
"E10PO",490,5,"1200x900",600,0,600,400,"True",228,587,532,-55,55,0
"E10PO",491,534,"1200x900",1000,1,600,400,"False",328,504,613,109,109,1
"E10PO",492,3,"1200x900",600,0,600,400,"True",298,443,480,37,37,1
"E10PO",493,199,"1200x900",600,2,600,400,"False",992,467,320,-147,147,0
"E10PO",494,9,"1200x900",600,0,600,400,"False",509,654,546,-108,108,1
"E10PO",495,214,"1200x900",600,2,600,400,"True",1046,305,366,61,61,0
"E10PO",496,496,"1200x900",1000,0,600,400,"False",70,639,569,-70,70,1
"E10PO",497,13,"1200x900",600,0,600,400,"True",296,211,207,-4,4,1
"E10PO",498,86,"1200x900",600,1,600,400,"False",692,388,533,145,145,1
"E10PO",499,95,"1200x900",600,1,600,400,"False",749,425,333,-92,92,1
"E10PO",500,371,"1200x900",800,2,600,400,"True",730,560,561,1,1,0
"E10PO",501,180,"1200x900",600,2,600,400,"True",929,270,343,73,73,0
"E10PO",502,613,"1200x900",1000,2,600,400,"False",690,374,570,196,196,0
"E10PO",503,421,"1200x900",800,2,600,400,"True",898,394,372,-22,22,0
"E10PO",504,531,"1200x900",1000,1,600,400,"False",233,362,681,319,319,0
"E10PO",505,370,"1200x900",800,2,600,400,"True",874,336,380,44,44,0
"E10PO",506,491,"1200x900",1000,0,600,400,"False",108,198,339,141,141,1
"E10PO",507,334,"1200x900",800,1,600,400,"False",481,665,414,-251,251,0
"E10PO",508,441,"1200x900",1000,0,600,400,"True",85,684,649,-35,35,1
"E10PO",509,548,"1200x900",1000,1,600,400,"False",103,278,409,131,131,0
"E10PO",510,178,"1200x900",600,2,600,400,"False",1041,510,682,172,172,0
"E10PO",511,447,"1200x900",1000,0,600,400,"True",71,339,301,-38,38,1
"E10PO",512,608,"1200x900",1000,2,600,400,"False",742,250,467,217,217,0
"E10PO",513,498,"1200x900",1000,0,600,400,"False",100,260,368,108,108,1
"E10PO",514,287,"1200x900",800,0,600,400,"False",120,567,667,100,100,1
"E10PO",515,368,"1200x900",800,2,600,400,"True",778,515,478,-37,37,0
"E10PO",516,578,"1200x900",1000,2,600,400,"False",966,276,711,435,435,0
"E10PO",517,295,"1200x900",800,1,600,400,"False",471,334,699,365,365,0
"E10PO",518,194,"1200x900",600,2,600,400,"False",896,236,511,275,275,0
"E10PO",519,160,"1200x900",600,2,600,400,"True",863,606,578,-28,28,0
"E10PO",520,489,"1200x900",1000,0,600,400,"False",88,604,458,-146,146,1
"E10PO",521,400,"1200x900",800,2,600,400,"False",733,297,414,117,117,0
"E10PO",522,495,"1200x900",1000,0,600,400,"False",93,692,479,-213,213,1
"E10PO",523,83,"1200x900",600,1,600,400,"False",763,568,381,-187,187,1
"E10PO",524,442,"1200x900",1000,0,600,400,"True",87,183,246,63,63,1
"E10PO",525,154,"1200x900",600,2,600,400,"False",941,454,196,-258,258,0
"E10PO",526,183,"1200x900",600,2,600,400,"True",927,289,243,-46,46,0
"E10PO",527,103,"1200x900",600,1,600,400,"False",528,320,399,79,79,1
"E10PO",528,584,"1200x900",1000,2,600,400,"True",731,413,415,2,2,0
"E10PO",529,349,"1200x900",800,1,600,400,"False",402,665,565,-100,100,0
"E10PO",530,85,"1200x900",600,1,600,400,"False",434,347,690,343,343,0
"E10PO",531,271,"1200x900",800,0,600,400,"False",74,360,244,-116,116,1
"E10PO",532,392,"1200x900",800,2,600,400,"True",1031,618,545,-73,73,0
"E10PO",533,469,"1200x900",1000,0,600,400,"True",73,227,182,-45,45,1
"E10PO",534,437,"1200x900",1000,0,600,400,"False",74,667,444,-223,223,1
"E10PO",535,123,"1200x900",600,1,600,400,"False",761,365,560,195,195,1
"E10PO",536,463,"1200x900",1000,0,600,400,"False",115,693,551,-142,142,1
"E10PO",537,435,"1200x900",1000,0,600,400,"False",119,200,305,105,105,1
"E10PO",538,603,"1200x900",1000,2,600,400,"True",693,280,357,77,77,0
"E10PO",539,203,"1200x900",600,2,600,400,"False",938,603,464,-139,139,0
"E10PO",540,363,"1200x900",800,2,600,400,"False",800,218,415,197,197,0
"E10PO",541,242,"1200x900",800,0,600,400,"False",117,448,374,-74,74,1
"E10PO",542,474,"1200x900",1000,0,600,400,"False",85,339,184,-155,155,1
"E10PO",543,87,"1200x900",600,1,600,400,"True",231,604,537,-67,67,0
"E10PO",544,319,"1200x900",800,1,600,400,"True",494,587,579,-8,8,1
"E10PO",545,346,"1200x900",800,1,600,400,"True",269,635,573,-62,62,0
"E10PO",546,407,"1200x900",800,2,600,400,"True",989,340,326,-14,14,0
"E10PO",547,102,"1200x900",600,1,600,400,"False",861,603,459,-144,144,0
"E10PO",548,611,"1200x900",1000,2,600,400,"True",414,511,524,13,13,0
"E10PO",549,339,"1200x900",800,1,600,400,"False",273,545,634,89,89,1
"E10PO",550,43,"1200x900",600,0,600,400,"False",277,446,575,129,129,1
"E10PO",551,526,"1200x900",1000,1,600,400,"False",497,710,574,-136,136,0
"E10PO",552,207,"1200x900",600,2,600,400,"False",838,235,527,292,292,0
"E10PO",553,266,"1200x900",800,0,600,400,"False",126,303,530,227,227,1
"E10PO",554,148,"1200x900",600,2,600,400,"True",907,330,333,3,3,0
"E10PO",555,366,"1200x900",800,2,600,400,"False",931,464,302,-162,162,0
"E10PO",556,76,"1200x900",600,1,600,400,"False",647,614,700,86,86,0
"E10PO",557,150,"1200x900",600,2,600,400,"False",897,345,661,316,316,0
"E10PO",558,499,"1200x900",1000,0,600,400,"False",93,271,404,133,133,1
"E10PO",559,373,"1200x900",800,2,600,400,"False",694,326,415,89,89,0
"E10PO",560,605,"1200x900",1000,2,600,400,"False",493,665,580,-85,85,0
"E10PO",561,172,"1200x900",600,2,600,400,"False",912,444,579,135,135,0
"E10PO",562,341,"1200x900",800,1,600,400,"True",735,632,577,-55,55,1
"E10PO",563,420,"1200x900",800,2,600,400,"False",519,223,574,351,351,0
"E10PO",564,14,"1200x900",600,0,600,400,"False",399,224,359,135,135,1
"E10PO",565,297,"1200x900",800,1,600,400,"False",625,244,327,83,83,0
"E10PO",566,92,"1200x900",600,1,600,400,"False",624,605,660,55,55,0
"E10PO",567,186,"1200x900",600,2,600,400,"False",997,197,409,212,212,0
"E10PO",568,275,"1200x900",800,0,600,400,"False",120,594,489,-105,105,0
"E10PO",569,17,"1200x900",600,0,600,400,"True",402,496,454,-42,42,1
"E10PO",570,274,"1200x900",800,0,600,400,"False",146,497,429,-68,68,1
"E10PO",571,100,"1200x900",600,1,600,400,"False",453,511,376,-135,135,0
"E10PO",572,571,"1200x900",1000,1,600,400,"False",239,522,650,128,128,1
"E10PO",573,632,"1200x900",1000,2,600,400,"False",984,227,705,478,478,0
"E10PO",574,284,"1200x900",800,0,600,400,"True",135,293,308,15,15,1
"E10PO",575,482,"1200x900",1000,0,600,400,"False",79,686,475,-211,211,1
"E10PO",576,621,"1200x900",1000,2,600,400,"True",540,478,481,3,3,0
"E10PO",577,128,"1200x900",600,1,600,400,"True",661,258,284,26,26,1
"E10PO",578,361,"1200x900",800,2,600,400,"True",931,328,290,-38,38,0
"E10PO",579,492,"1200x900",1000,0,600,400,"False",76,692,534,-158,158,1
"E10PO",580,388,"1200x900",800,2,600,400,"False",930,320,610,290,290,0
"E10PO",581,243,"1200x900",800,0,600,400,"True",114,332,388,56,56,1
"E10PO",582,418,"1200x900",800,2,600,400,"False",754,507,382,-125,125,0
"E10PO",583,80,"1200x900",600,1,600,400,"True",616,423,477,54,54,1
"E10PO",584,444,"1200x900",1000,0,600,400,"False",101,714,612,-102,102,1
"E10PO",585,552,"1200x900",1000,1,600,400,"True",255,412,358,-54,54,0
"E10PO",586,618,"1200x900",1000,2,600,400,"False",276,671,502,-169,169,0
"E10PO",587,137,"1200x900",600,1,600,400,"True",789,577,590,13,13,0
"E10PO",588,12,"1200x900",600,0,600,400,"True",365,336,301,-35,35,1
"E10PO",589,446,"1200x900",1000,0,600,400,"True",72,298,233,-65,65,1
"E10PO",590,567,"1200x900",1000,1,600,400,"True",655,297,310,13,13,1
"E10PO",591,505,"1200x900",1000,1,600,400,"False",191,484,687,203,203,1
"E10PO",592,602,"1200x900",1000,2,600,400,"True",865,452,435,-17,17,0
"E10PO",593,596,"1200x900",1000,2,600,400,"True",706,513,532,19,19,0
"E10PO",594,89,"1200x900",600,1,600,400,"False",917,366,446,80,80,1
"E10PO",595,404,"1200x900",800,2,600,400,"True",842,396,450,54,54,0
"E10PO",596,462,"1200x900",1000,0,600,400,"False",102,672,448,-224,224,1
"E10PO",597,540,"1200x900",1000,1,600,400,"False",389,568,455,-113,113,1
"E10PO",598,599,"1200x900",1000,2,600,400,"True",316,570,536,-34,34,0
"E10PO",599,135,"1200x900",600,1,600,400,"True",759,569,590,21,21,0
"E10PO",600,31,"1200x900",600,0,600,400,"False",365,338,463,125,125,1
"E10PO",601,106,"1200x900",600,1,600,400,"False",803,659,446,-213,213,1
"E10PO",602,617,"1200x900",1000,2,600,400,"False",294,180,462,282,282,0
"E10PO",603,37,"1200x900",600,0,600,400,"True",258,403,376,-27,27,1
"E10PO",604,276,"1200x900",800,0,600,400,"False",281,217,309,92,92,1
"E10PO",605,453,"1200x900",1000,0,600,400,"True",71,393,370,-23,23,1
"E10PO",606,99,"1200x900",600,1,600,400,"True",811,407,427,20,20,0
"E10PO",607,626,"1200x900",1000,2,600,400,"False",329,449,190,-259,259,0
"E10PO",608,412,"1200x900",800,2,600,400,"True",842,280,246,-34,34,0
"E10PO",609,264,"1200x900",800,0,600,400,"False",198,660,542,-118,118,1
"E10PO",610,176,"1200x900",600,2,600,400,"False",1033,281,216,-65,65,0
"E10PO",611,51,"1200x900",600,0,600,400,"True",272,181,179,-2,2,1
"E10PO",612,589,"1200x900",1000,2,600,400,"True",856,418,378,-40,40,0
"E10PO",613,408,"1200x900",800,2,600,400,"False",758,567,477,-90,90,0
"E10PO",614,285,"1200x900",800,0,600,400,"False",237,396,459,63,63,1
"E10PO",615,188,"1200x900",600,2,600,400,"False",900,195,348,153,153,0
"E10PO",616,583,"1200x900",1000,2,600,400,"False",949,284,438,154,154,1
"E10PO",617,429,"1200x900",800,2,600,400,"True",682,692,659,-33,33,0
"E10PO",618,166,"1200x900",600,2,600,400,"False",896,274,392,118,118,0
"E10PO",619,283,"1200x900",800,0,600,400,"True",90,264,244,-20,20,1
"E10PO",620,25,"1200x900",600,0,600,400,"True",263,403,353,-50,50,1
"E10PO",621,490,"1200x900",1000,0,600,400,"False",114,183,261,78,78,1
"E10PO",622,493,"1200x900",1000,0,600,400,"False",80,582,394,-188,188,1
"E10PO",623,289,"1200x900",800,1,600,400,"False",421,703,537,-166,166,1
"E10PO",624,336,"1200x900",800,1,600,400,"False",251,587,769,182,182,0
"E10PO",625,45,"1200x900",600,0,600,400,"True",487,678,678,0,0,1
"E10PO",626,452,"1200x900",1000,0,600,400,"False",97,273,552,279,279,1
"E10PO",627,436,"1200x900",1000,0,600,400,"True",82,617,588,-29,29,1
"E10PO",628,616,"1200x900",1000,2,600,400,"True",854,357,355,-2,2,1
"E10PO",629,340,"1200x900",800,1,600,400,"False",226,240,502,262,262,0
"E10PO",630,575,"1200x900",1000,1,600,400,"False",272,693,602,-91,91,0
"E10PO",631,545,"1200x900",1000,1,600,400,"False",358,562,781,219,219,0
"E10PO",632,279,"1200x900",800,0,600,400,"True",252,202,189,-13,13,1
"E10PO",633,220,"1200x900",800,0,600,400,"False",108,699,629,-70,70,1
"E10PO",634,450,"1200x900",1000,0,600,400,"False",130,204,305,101,101,1
"E10PO",635,395,"1200x900",800,2,600,400,"True",743,334,394,60,60,0
"E10PO",636,481,"1200x900",1000,0,600,400,"False",80,185,250,65,65,1
"E10PO",637,353,"1200x900",800,1,600,400,"False",90,476,684,208,208,0
"E10PO",638,485,"1200x900",1000,0,600,400,"True",121,694,632,-62,62,1
"E10PO",639,641,"1200x900",1000,2,600,400,"False",897,272,481,209,209,0
"E10PO",640,239,"1200x900",800,0,600,400,"True",114,231,261,30,30,1
"E10PO",641,564,"1200x900",1000,1,600,400,"True",215,264,308,44,44,0
"E10PO",642,168,"1200x900",600,2,600,400,"False",1001,439,275,-164,164,0
"E10PO",643,197,"1200x900",600,2,600,400,"False",903,212,360,148,148,0
"E10PO",644,94,"1200x900",600,1,600,400,"True",729,482,523,41,41,0
"E10PO",645,512,"1200x900",1000,1,600,400,"False",139,261,661,400,400,0
"E10PO",646,378,"1200x900",800,2,600,400,"False",1018,708,286,-422,422,0
"E10PO",647,628,"1200x900",1000,2,600,400,"True",768,410,377,-33,33,0
"E10PO",648,623,"1200x900",1000,2,600,400,"False",636,527,429,-98,98,0
"E11HS",1,110,"1200x900",600,1,600,400,"False",776,550,668,118,118,1
"E11HS",2,525,"1200x900",1000,1,600,400,"False",123,690,570,-120,120,0
"E11HS",3,304,"1200x900",800,1,600,400,"False",667,605,519,-86,86,0
"E11HS",4,133,"1200x900",600,1,600,400,"True",345,551,560,9,9,0
"E11HS",5,541,"1200x900",1000,1,600,400,"True",339,478,439,-39,39,0
"E11HS",6,568,"1200x900",1000,1,600,400,"False",286,475,536,61,61,1
"E11HS",7,558,"1200x900",1000,1,600,400,"False",72,464,589,125,125,1
"E11HS",8,169,"1200x900",600,2,600,400,"False",924,290,415,125,125,0
"E11HS",9,63,"1200x900",600,0,600,400,"True",311,188,229,41,41,1
"E11HS",10,305,"1200x900",800,1,600,400,"False",471,716,461,-255,255,0
"E11HS",11,85,"1200x900",600,1,600,400,"False",434,347,572,225,225,0
"E11HS",12,539,"1200x900",1000,1,600,400,"True",510,383,410,27,27,0
"E11HS",13,492,"1200x900",1000,0,600,400,"False",76,692,572,-120,120,1
"E11HS",14,601,"1200x900",1000,2,600,400,"False",735,697,464,-233,233,0
"E11HS",15,332,"1200x900",800,1,600,400,"False",260,699,850,151,151,0
"E11HS",16,107,"1200x900",600,1,600,400,"False",878,678,757,79,79,0
"E11HS",17,312,"1200x900",800,1,600,400,"False",238,683,747,64,64,0
"E11HS",18,28,"1200x900",600,0,600,400,"True",336,410,388,-22,22,1
"E11HS",19,245,"1200x900",800,0,600,400,"False",296,235,414,179,179,1
"E11HS",20,518,"1200x900",1000,1,600,400,"True",583,717,708,-9,9,0
"E11HS",21,225,"1200x900",800,0,600,400,"False",178,423,346,-77,77,1
"E11HS",22,545,"1200x900",1000,1,600,400,"False",358,562,444,-118,118,0
"E11HS",23,113,"1200x900",600,1,600,400,"True",897,657,663,6,6,0
"E11HS",24,224,"1200x900",800,0,600,400,"False",161,474,559,85,85,1
"E11HS",25,198,"1200x900",600,2,600,400,"True",976,500,431,-69,69,0
"E11HS",26,120,"1200x900",600,1,600,400,"True",690,655,649,-6,6,0
"E11HS",27,108,"1200x900",600,1,600,400,"True",830,239,303,64,64,0
"E11HS",28,127,"1200x900",600,1,600,400,"False",309,691,582,-109,109,0
"E11HS",29,246,"1200x900",800,0,600,400,"False",196,418,491,73,73,1
"E11HS",30,309,"1200x900",800,1,600,400,"False",186,225,516,291,291,0
"E11HS",31,311,"1200x900",800,1,600,400,"False",710,261,363,102,102,0
"E11HS",32,542,"1200x900",1000,1,600,400,"False",304,401,232,-169,169,0
"E11HS",33,160,"1200x900",600,2,600,400,"False",863,606,474,-132,132,0
"E11HS",34,559,"1200x900",1000,1,600,400,"True",641,244,308,64,64,0
"E11HS",35,608,"1200x900",1000,2,600,400,"False",742,250,364,114,114,0
"E11HS",36,594,"1200x900",1000,2,600,400,"False",537,637,433,-204,204,0
"E11HS",37,376,"1200x900",800,2,600,400,"True",788,275,262,-13,13,0
"E11HS",38,30,"1200x900",600,0,600,400,"True",107,353,384,31,31,0
"E11HS",39,32,"1200x900",600,0,600,400,"False",152,563,457,-106,106,1
"E11HS",40,434,"1200x900",1000,0,600,400,"False",89,657,460,-197,197,1
"E11HS",41,157,"1200x900",600,2,600,400,"True",1016,323,375,52,52,0
"E11HS",42,334,"1200x900",800,1,600,400,"False",481,665,549,-116,116,0
"E11HS",43,543,"1200x900",1000,1,600,400,"False",88,202,430,228,228,0
"E11HS",44,475,"1200x900",1000,0,600,400,"False",101,715,618,-97,97,1
"E11HS",45,398,"1200x900",800,2,600,400,"False",944,698,445,-253,253,0
"E11HS",46,155,"1200x900",600,2,600,400,"False",940,269,449,180,180,0
"E11HS",47,15,"1200x900",600,0,600,400,"True",473,352,391,39,39,1
"E11HS",48,509,"1200x900",1000,1,600,400,"True",509,434,415,-19,19,0
"E11HS",49,553,"1200x900",1000,1,600,400,"False",116,712,492,-220,220,0
"E11HS",50,444,"1200x900",1000,0,600,400,"False",101,714,400,-314,314,1
"E11HS",51,489,"1200x900",1000,0,600,400,"False",88,604,389,-215,215,1
"E11HS",52,317,"1200x900",800,1,600,400,"True",185,564,552,-12,12,0
"E11HS",53,517,"1200x900",1000,1,600,400,"False",548,182,347,165,165,0
"E11HS",54,612,"1200x900",1000,2,600,400,"False",706,198,287,89,89,0
"E11HS",55,499,"1200x900",1000,0,600,400,"True",93,271,271,0,0,1
"E11HS",56,390,"1200x900",800,2,600,400,"False",982,674,370,-304,304,1
"E11HS",57,464,"1200x900",1000,0,600,400,"False",82,222,340,118,118,1
"E11HS",59,642,"1200x900",1000,2,600,400,"False",776,316,651,335,335,0
"E11HS",60,389,"1200x900",800,2,600,400,"False",843,530,369,-161,161,0
"E11HS",61,89,"1200x900",600,1,600,400,"False",917,366,568,202,202,1
"E11HS",62,353,"1200x900",800,1,600,400,"False",90,476,785,309,309,0
"E11HS",63,391,"1200x900",800,2,600,400,"True",895,521,443,-78,78,0
"E11HS",64,78,"1200x900",600,1,600,400,"True",885,684,732,48,48,0
"E11HS",65,365,"1200x900",800,2,600,400,"False",1055,305,667,362,362,0
"E11HS",66,46,"1200x900",600,0,600,400,"True",193,355,356,1,1,1
"E11HS",67,324,"1200x900",800,1,600,400,"False",719,712,462,-250,250,1
"E11HS",68,94,"1200x900",600,1,600,400,"True",729,482,473,-9,9,0
"E11HS",69,623,"1200x900",1000,2,600,400,"False",636,527,370,-157,157,0
"E11HS",70,370,"1200x900",800,2,600,400,"False",874,336,442,106,106,0
"E11HS",71,537,"1200x900",1000,1,600,400,"False",621,412,574,162,162,1
"E11HS",72,512,"1200x900",1000,1,600,400,"False",139,261,576,315,315,0
"E11HS",73,498,"1200x900",1000,0,600,400,"False",100,260,487,227,227,1
"E11HS",74,6,"1200x900",600,0,600,400,"True",217,689,662,-27,27,1
"E11HS",75,467,"1200x900",1000,0,600,400,"True",74,712,751,39,39,1
"E11HS",76,96,"1200x900",600,1,600,400,"False",433,458,555,97,97,0
"E11HS",77,22,"1200x900",600,0,600,400,"True",398,591,602,11,11,1
"E11HS",78,494,"1200x900",1000,0,600,400,"True",127,692,696,4,4,1
"E11HS",79,449,"1200x900",1000,0,600,400,"True",105,683,663,-20,20,1
"E11HS",80,301,"1200x900",800,1,600,400,"True",162,574,511,-63,63,0
"E11HS",81,135,"1200x900",600,1,600,400,"True",759,569,587,18,18,0
"E11HS",82,164,"1200x900",600,2,600,400,"False",1051,268,564,296,296,0
"E11HS",83,230,"1200x900",800,0,600,400,"True",99,678,623,-55,55,1
"E11HS",84,532,"1200x900",1000,1,600,400,"False",215,207,348,141,141,0
"E11HS",85,258,"1200x900",800,0,600,400,"False",126,664,528,-136,136,1
"E11HS",86,340,"1200x900",800,1,600,400,"False",226,240,343,103,103,0
"E11HS",87,277,"1200x900",800,0,600,400,"True",140,310,313,3,3,1
"E11HS",88,5,"1200x900",600,0,600,400,"False",228,587,509,-78,78,0
"E11HS",89,212,"1200x900",600,2,600,400,"False",841,206,435,229,229,0
"E11HS",90,14,"1200x900",600,0,600,400,"True",399,224,169,-55,55,1
"E11HS",91,355,"1200x900",800,1,600,400,"True",77,386,407,21,21,0
"E11HS",92,450,"1200x900",1000,0,600,400,"False",130,204,275,71,71,1
"E11HS",93,634,"1200x900",1000,2,600,400,"False",735,313,451,138,138,0
"E11HS",94,645,"1200x900",1000,2,600,400,"True",619,396,471,75,75,0
"E11HS",95,439,"1200x900",1000,0,600,400,"False",110,229,377,148,148,1
"E11HS",96,144,"1200x900",600,1,600,400,"False",718,371,612,241,241,0
"E11HS",97,341,"1200x900",800,1,600,400,"True",735,632,579,-53,53,1
"E11HS",98,92,"1200x900",600,1,600,400,"False",624,605,384,-221,221,0
"E11HS",99,427,"1200x900",800,2,600,400,"True",812,380,448,68,68,0
"E11HS",100,384,"1200x900",800,2,600,400,"False",821,707,607,-100,100,0
"E11HS",101,586,"1200x900",1000,2,600,400,"False",802,262,650,388,388,0
"E11HS",102,554,"1200x900",1000,1,600,400,"True",79,309,267,-42,42,1
"E11HS",103,497,"1200x900",1000,0,600,400,"False",106,696,415,-281,281,1
"E11HS",104,514,"1200x900",1000,1,600,400,"False",539,690,599,-91,91,0
"E11HS",105,368,"1200x900",800,2,600,400,"True",778,515,590,75,75,0
"E11HS",106,294,"1200x900",800,1,600,400,"False",262,287,532,245,245,0
"E11HS",107,503,"1200x900",1000,0,600,400,"False",86,279,418,139,139,1
"E11HS",108,285,"1200x900",800,0,600,400,"True",237,396,382,-14,14,1
"E11HS",109,321,"1200x900",800,1,600,400,"False",601,190,377,187,187,0
"E11HS",110,469,"1200x900",1000,0,600,400,"False",73,227,311,84,84,1
"E11HS",111,275,"1200x900",800,0,600,400,"False",120,594,451,-143,143,0
"E11HS",112,104,"1200x900",600,1,600,400,"False",448,584,672,88,88,0
"E11HS",113,54,"1200x900",600,0,600,400,"True",474,564,533,-31,31,1
"E11HS",114,646,"1200x900",1000,2,600,400,"True",829,227,276,49,49,1
"E11HS",115,207,"1200x900",600,2,600,400,"False",838,235,392,157,157,0
"E11HS",116,43,"1200x900",600,0,600,400,"False",277,446,370,-76,76,1
"E11HS",117,82,"1200x900",600,1,600,400,"False",108,213,351,138,138,0
"E11HS",118,648,"1200x900",1000,2,600,400,"False",557,394,321,-73,73,0
"E11HS",119,102,"1200x900",600,1,600,400,"True",861,603,586,-17,17,0
"E11HS",120,36,"1200x900",600,0,600,400,"True",128,346,293,-53,53,1
"E11HS",121,181,"1200x900",600,2,600,400,"True",1018,223,191,-32,32,0
"E11HS",122,485,"1200x900",1000,0,600,400,"False",121,694,462,-232,232,1
"E11HS",123,270,"1200x900",800,0,600,400,"False",192,418,500,82,82,1
"E11HS",124,44,"1200x900",600,0,600,400,"True",305,554,489,-65,65,1
"E11HS",125,101,"1200x900",600,1,600,400,"True",541,656,691,35,35,0
"E11HS",126,40,"1200x900",600,0,600,400,"True",143,513,542,29,29,0
"E11HS",127,569,"1200x900",1000,1,600,400,"False",494,720,352,-368,368,0
"E11HS",128,142,"1200x900",600,1,600,400,"True",286,474,466,-8,8,0
"E11HS",129,228,"1200x900",800,0,600,400,"True",174,687,621,-66,66,1
"E11HS",130,619,"1200x900",1000,2,600,400,"False",803,247,567,320,320,0
"E11HS",131,400,"1200x900",800,2,600,400,"True",733,297,273,-24,24,0
"E11HS",132,435,"1200x900",1000,0,600,400,"True",119,200,257,57,57,1
"E11HS",133,179,"1200x900",600,2,600,400,"False",908,602,477,-125,125,0
"E11HS",134,183,"1200x900",600,2,600,400,"False",927,289,229,-60,60,0
"E11HS",135,495,"1200x900",1000,0,600,400,"False",93,692,520,-172,172,1
"E11HS",136,523,"1200x900",1000,1,600,400,"False",339,318,443,125,125,0
"E11HS",137,187,"1200x900",600,2,600,400,"False",857,639,537,-102,102,0
"E11HS",138,192,"1200x900",600,2,600,400,"False",1064,320,619,299,299,0
"E11HS",139,443,"1200x900",1000,0,600,400,"False",99,651,478,-173,173,1
"E11HS",140,126,"1200x900",600,1,600,400,"False",849,354,456,102,102,0
"E11HS",141,276,"1200x900",800,0,600,400,"False",281,217,326,109,109,1
"E11HS",142,256,"1200x900",800,0,600,400,"False",192,656,735,79,79,1
"E11HS",143,323,"1200x900",800,1,600,400,"False",388,348,641,293,293,0
"E11HS",144,433,"1200x900",1000,0,600,400,"False",76,222,340,118,118,1
"E11HS",145,522,"1200x900",1000,1,600,400,"False",223,379,547,168,168,0
"E11HS",146,290,"1200x900",800,1,600,400,"True",789,603,673,70,70,0
"E11HS",147,86,"1200x900",600,1,600,400,"True",692,388,392,4,4,1
"E11HS",148,496,"1200x900",1000,0,600,400,"False",70,639,535,-104,104,1
"E11HS",149,165,"1200x900",600,2,600,400,"True",912,554,595,41,41,0
"E11HS",150,595,"1200x900",1000,2,600,400,"False",687,640,364,-276,276,0
"E11HS",151,118,"1200x900",600,1,600,400,"True",190,588,565,-23,23,0
"E11HS",152,583,"1200x900",1000,2,600,400,"False",949,284,228,-56,56,1
"E11HS",153,393,"1200x900",800,2,600,400,"True",657,620,556,-64,64,0
"E11HS",154,64,"1200x900",600,0,600,400,"True",102,339,377,38,38,0
"E11HS",155,582,"1200x900",1000,2,600,400,"True",554,347,352,5,5,0
"E11HS",156,483,"1200x900",1000,0,600,400,"True",93,191,243,52,52,1
"E11HS",157,507,"1200x900",1000,1,600,400,"True",608,583,610,27,27,1
"E11HS",158,72,"1200x900",600,0,600,400,"True",158,537,570,33,33,0
"E11HS",159,320,"1200x900",800,1,600,400,"False",644,376,489,113,113,0
"E11HS",160,240,"1200x900",800,0,600,400,"True",330,656,611,-45,45,1
"E11HS",161,111,"1200x900",600,1,600,400,"False",922,552,715,163,163,1
"E11HS",162,371,"1200x900",800,2,600,400,"True",730,560,579,19,19,0
"E11HS",163,237,"1200x900",800,0,600,400,"True",204,481,489,8,8,1
"E11HS",164,447,"1200x900",1000,0,600,400,"False",71,339,481,142,142,1
"E11HS",165,481,"1200x900",1000,0,600,400,"False",80,185,350,165,165,1
"E11HS",166,124,"1200x900",600,1,600,400,"True",345,467,424,-43,43,0
"E11HS",167,420,"1200x900",800,2,600,400,"False",519,223,359,136,136,0
"E11HS",168,421,"1200x900",800,2,600,400,"True",898,394,363,-31,31,0
"E11HS",169,232,"1200x900",800,0,600,400,"True",84,511,455,-56,56,1
"E11HS",170,161,"1200x900",600,2,600,400,"False",939,553,426,-127,127,0
"E11HS",171,97,"1200x900",600,1,600,400,"False",760,643,535,-108,108,1
"E11HS",172,598,"1200x900",1000,2,600,400,"True",706,559,534,-25,25,0
"E11HS",173,613,"1200x900",1000,2,600,400,"False",690,374,509,135,135,0
"E11HS",174,520,"1200x900",1000,1,600,400,"True",564,260,285,25,25,0
"E11HS",175,462,"1200x900",1000,0,600,400,"False",102,672,537,-135,135,1
"E11HS",176,416,"1200x900",800,2,600,400,"False",748,617,369,-248,248,0
"E11HS",177,7,"1200x900",600,0,600,400,"True",431,654,615,-39,39,1
"E11HS",178,163,"1200x900",600,2,600,400,"True",1046,665,593,-72,72,0
"E11HS",179,244,"1200x900",800,0,600,400,"False",194,203,119,-84,84,1
"E11HS",180,128,"1200x900",600,1,600,400,"True",661,258,278,20,20,1
"E11HS",181,600,"1200x900",1000,2,600,400,"False",765,207,307,100,100,0
"E11HS",182,431,"1200x900",800,2,600,400,"False",694,382,482,100,100,0
"E11HS",183,254,"1200x900",800,0,600,400,"False",136,583,515,-68,68,1
"E11HS",184,37,"1200x900",600,0,600,400,"True",258,403,368,-35,35,1
"E11HS",185,563,"1200x900",1000,1,600,400,"False",201,696,541,-155,155,0
"E11HS",186,591,"1200x900",1000,2,600,400,"False",698,336,443,107,107,0
"E11HS",187,175,"1200x900",600,2,600,400,"False",1028,432,348,-84,84,0
"E11HS",188,132,"1200x900",600,1,600,400,"False",333,185,387,202,202,0
"E11HS",189,93,"1200x900",600,1,600,400,"True",139,540,576,36,36,0
"E11HS",190,146,"1200x900",600,2,600,400,"True",989,492,440,-52,52,0
"E11HS",191,403,"1200x900",800,2,600,400,"False",625,704,567,-137,137,0
"E11HS",192,220,"1200x900",800,0,600,400,"True",108,699,669,-30,30,1
"E11HS",193,599,"1200x900",1000,2,600,400,"False",316,570,665,95,95,0
"E11HS",194,493,"1200x900",1000,0,600,400,"True",80,582,589,7,7,1
"E11HS",195,1,"1200x900",600,0,600,400,"True",136,502,510,8,8,0
"E11HS",196,80,"1200x900",600,1,600,400,"False",616,423,567,144,144,1
"E11HS",197,148,"1200x900",600,2,600,400,"False",907,330,566,236,236,0
"E11HS",198,638,"1200x900",1000,2,600,400,"False",385,198,497,299,299,0
"E11HS",199,151,"1200x900",600,2,600,400,"False",828,680,568,-112,112,0
"E11HS",200,222,"1200x900",800,0,600,400,"False",152,206,280,74,74,1
"E11HS",201,137,"1200x900",600,1,600,400,"False",789,577,479,-98,98,0
"E11HS",202,243,"1200x900",800,0,600,400,"True",114,332,391,59,59,1
"E11HS",203,318,"1200x900",800,1,600,400,"False",788,534,678,144,144,0
"E11HS",204,236,"1200x900",800,0,600,400,"True",162,350,311,-39,39,1
"E11HS",205,26,"1200x900",600,0,600,400,"False",70,712,610,-102,102,0
"E11HS",206,534,"1200x900",1000,1,600,400,"False",328,504,629,125,125,1
"E11HS",207,197,"1200x900",600,2,600,400,"True",903,212,280,68,68,0
"E11HS",208,226,"1200x900",800,0,600,400,"True",187,229,246,17,17,1
"E11HS",209,147,"1200x900",600,2,600,400,"False",942,418,290,-128,128,0
"E11HS",210,106,"1200x900",600,1,600,400,"False",803,659,523,-136,136,1
"E11HS",211,465,"1200x900",1000,0,600,400,"False",85,203,409,206,206,1
"E11HS",212,636,"1200x900",1000,2,600,400,"False",575,583,365,-218,218,0
"E11HS",213,189,"1200x900",600,2,600,400,"True",881,397,422,25,25,0
"E11HS",214,386,"1200x900",800,2,600,400,"False",774,301,421,120,120,0
"E11HS",215,59,"1200x900",600,0,600,400,"True",391,692,716,24,24,1
"E11HS",216,470,"1200x900",1000,0,600,400,"False",91,666,566,-100,100,1
"E11HS",217,488,"1200x900",1000,0,600,400,"False",129,687,476,-211,211,1
"E11HS",218,383,"1200x900",800,2,600,400,"True",855,407,380,-27,27,0
"E11HS",219,265,"1200x900",800,0,600,400,"True",229,353,306,-47,47,1
"E11HS",220,476,"1200x900",1000,0,600,400,"True",76,359,330,-29,29,1
"E11HS",221,632,"1200x900",1000,2,600,400,"False",984,227,662,435,435,0
"E11HS",222,401,"1200x900",800,2,600,400,"True",821,260,323,63,63,0
"E11HS",223,567,"1200x900",1000,1,600,400,"True",655,297,298,1,1,1
"E11HS",224,596,"1200x900",1000,2,600,400,"False",706,513,598,85,85,0
"E11HS",225,628,"1200x900",1000,2,600,400,"False",768,410,541,131,131,0
"E11HS",226,180,"1200x900",600,2,600,400,"False",929,270,528,258,258,0
"E11HS",227,602,"1200x900",1000,2,600,400,"True",865,452,396,-56,56,0
"E11HS",228,644,"1200x900",1000,2,600,400,"True",495,486,483,-3,3,0
"E11HS",229,199,"1200x900",600,2,600,400,"True",992,467,514,47,47,0
"E11HS",230,326,"1200x900",800,1,600,400,"True",103,482,480,-2,2,0
"E11HS",231,578,"1200x900",1000,2,600,400,"False",966,276,586,310,310,0
"E11HS",232,112,"1200x900",600,1,600,400,"True",681,490,456,-34,34,0
"E11HS",233,505,"1200x900",1000,1,600,400,"False",191,484,579,95,95,1
"E11HS",234,166,"1200x900",600,2,600,400,"False",896,274,555,281,281,0
"E11HS",235,278,"1200x900",800,0,600,400,"False",251,711,630,-81,81,1
"E11HS",236,373,"1200x900",800,2,600,400,"False",694,326,540,214,214,0
"E11HS",237,229,"1200x900",800,0,600,400,"True",117,697,744,47,47,1
"E11HS",238,486,"1200x900",1000,0,600,400,"True",102,676,712,36,36,1
"E11HS",239,640,"1200x900",1000,2,600,400,"False",361,334,490,156,156,0
"E11HS",240,173,"1200x900",600,2,600,400,"False",948,693,531,-162,162,0
"E11HS",241,349,"1200x900",800,1,600,400,"True",402,665,682,17,17,0
"E11HS",242,614,"1200x900",1000,2,600,400,"False",823,563,471,-92,92,0
"E11HS",243,193,"1200x900",600,2,600,400,"True",874,588,548,-40,40,0
"E11HS",244,24,"1200x900",600,0,600,400,"False",430,538,415,-123,123,1
"E11HS",245,150,"1200x900",600,2,600,400,"True",897,345,385,40,40,0
"E11HS",246,56,"1200x900",600,0,600,400,"True",148,491,470,-21,21,0
"E11HS",247,622,"1200x900",1000,2,600,400,"False",307,683,479,-204,204,0
"E11HS",248,152,"1200x900",600,2,600,400,"False",971,399,317,-82,82,0
"E11HS",249,200,"1200x900",600,2,600,400,"True",897,302,365,63,63,0
"E11HS",250,158,"1200x900",600,2,600,400,"True",939,300,366,66,66,0
"E11HS",251,291,"1200x900",800,1,600,400,"False",522,694,597,-97,97,0
"E11HS",252,552,"1200x900",1000,1,600,400,"False",255,412,659,247,247,0
"E11HS",253,359,"1200x900",800,1,600,400,"False",653,241,411,170,170,0
"E11HS",254,562,"1200x900",1000,1,600,400,"True",347,540,504,-36,36,0
"E11HS",255,267,"1200x900",800,0,600,400,"True",145,665,637,-28,28,1
"E11HS",256,399,"1200x900",800,2,600,400,"True",603,602,584,-18,18,0
"E11HS",257,206,"1200x900",600,2,600,400,"True",975,223,246,23,23,0
"E11HS",258,17,"1200x900",600,0,600,400,"False",402,496,382,-114,114,1
"E11HS",259,451,"1200x900",1000,0,600,400,"False",110,702,533,-169,169,1
"E11HS",260,178,"1200x900",600,2,600,400,"False",1041,510,621,111,111,0
"E11HS",261,134,"1200x900",600,1,600,400,"True",300,188,294,106,106,0
"E11HS",262,392,"1200x900",800,2,600,400,"True",1031,618,533,-85,85,0
"E11HS",263,624,"1200x900",1000,2,600,400,"False",693,501,366,-135,135,0
"E11HS",264,609,"1200x900",1000,2,600,400,"True",697,627,562,-65,65,0
"E11HS",265,577,"1200x900",1000,2,600,400,"False",455,420,354,-66,66,0
"E11HS",266,605,"1200x900",1000,2,600,400,"False",493,665,580,-85,85,0
"E11HS",267,174,"1200x900",600,2,600,400,"False",998,457,288,-169,169,0
"E11HS",268,65,"1200x900",600,0,600,400,"False",442,645,552,-93,93,1
"E11HS",269,540,"1200x900",1000,1,600,400,"False",389,568,268,-300,300,1
"E11HS",270,555,"1200x900",1000,1,600,400,"False",444,556,483,-73,73,0
"E11HS",271,196,"1200x900",600,2,600,400,"True",1030,397,354,-43,43,0
"E11HS",272,25,"1200x900",600,0,600,400,"True",263,403,390,-13,13,1
"E11HS",273,458,"1200x900",1000,0,600,400,"False",78,624,546,-78,78,1
"E11HS",274,140,"1200x900",600,1,600,400,"True",700,523,511,-12,12,0
"E11HS",275,295,"1200x900",800,1,600,400,"True",471,334,323,-11,11,0
"E11HS",276,500,"1200x900",1000,0,600,400,"False",105,700,497,-203,203,1
"E11HS",277,531,"1200x900",1000,1,600,400,"True",233,362,422,60,60,0
"E11HS",278,250,"1200x900",800,0,600,400,"False",290,248,314,66,66,1
"E11HS",279,316,"1200x900",800,1,600,400,"False",362,319,563,244,244,0
"E11HS",280,259,"1200x900",800,0,600,400,"True",156,180,214,34,34,1
"E11HS",281,205,"1200x900",600,2,600,400,"True",1021,504,475,-29,29,0
"E11HS",282,479,"1200x900",1000,0,600,400,"False",74,705,585,-120,120,1
"E11HS",283,21,"1200x900",600,0,600,400,"False",314,383,452,69,69,1
"E11HS",284,186,"1200x900",600,2,600,400,"False",997,197,410,213,213,0
"E11HS",285,362,"1200x900",800,2,600,400,"True",819,338,386,48,48,0
"E11HS",286,335,"1200x900",800,1,600,400,"False",124,360,462,102,102,0
"E11HS",287,176,"1200x900",600,2,600,400,"False",1033,281,517,236,236,0
"E11HS",288,162,"1200x900",600,2,600,400,"False",849,279,433,154,154,0
"E11HS",289,415,"1200x900",800,2,600,400,"False",823,684,584,-100,100,0
"E11HS",290,404,"1200x900",800,2,600,400,"True",842,396,387,-9,9,0
"E11HS",291,208,"1200x900",600,2,600,400,"False",946,399,526,127,127,0
"E11HS",292,88,"1200x900",600,1,600,400,"True",186,554,606,52,52,0
"E11HS",293,369,"1200x900",800,2,600,400,"True",903,594,608,14,14,0
"E11HS",294,16,"1200x900",600,0,600,400,"True",297,514,507,-7,7,1
"E11HS",295,213,"1200x900",600,2,600,400,"True",822,275,363,88,88,0
"E11HS",296,528,"1200x900",1000,1,600,400,"False",839,227,600,373,373,1
"E11HS",297,68,"1200x900",600,0,600,400,"True",165,367,353,-14,14,0
"E11HS",298,167,"1200x900",600,2,600,400,"True",956,241,308,67,67,0
"E11HS",299,218,"1200x900",800,0,600,400,"True",106,397,406,9,9,1
"E11HS",300,380,"1200x900",800,2,600,400,"False",942,228,347,119,119,0
"E11HS",301,580,"1200x900",1000,2,600,400,"False",651,267,388,121,121,0
"E11HS",302,590,"1200x900",1000,2,600,400,"True",636,278,334,56,56,0
"E11HS",303,61,"1200x900",600,0,600,400,"False",272,670,513,-157,157,1
"E11HS",304,379,"1200x900",800,2,600,400,"False",994,325,585,260,260,0
"E11HS",305,402,"1200x900",800,2,600,400,"False",878,234,351,117,117,0
"E11HS",306,491,"1200x900",1000,0,600,400,"True",108,198,243,45,45,1
"E11HS",307,314,"1200x900",800,1,600,400,"True",277,616,564,-52,52,1
"E11HS",308,579,"1200x900",1000,2,600,400,"False",803,394,597,203,203,0
"E11HS",309,504,"1200x900",1000,0,600,400,"False",107,699,628,-71,71,1
"E11HS",310,460,"1200x900",1000,0,600,400,"False",155,189,271,82,82,1
"E11HS",311,269,"1200x900",800,0,600,400,"True",160,295,288,-7,7,1
"E11HS",312,145,"1200x900",600,2,600,400,"False",1004,630,467,-163,163,0
"E11HS",313,217,"1200x900",800,0,600,400,"True",85,573,510,-63,63,1
"E11HS",314,257,"1200x900",800,0,600,400,"True",97,219,267,48,48,1
"E11HS",315,203,"1200x900",600,2,600,400,"False",938,603,505,-98,98,0
"E11HS",316,234,"1200x900",800,0,600,400,"True",72,344,384,40,40,1
"E11HS",317,284,"1200x900",800,0,600,400,"True",135,293,330,37,37,1
"E11HS",318,211,"1200x900",600,2,600,400,"True",986,407,436,29,29,0
"E11HS",319,319,"1200x900",800,1,600,400,"True",494,587,629,42,42,1
"E11HS",320,396,"1200x900",800,2,600,400,"False",678,663,514,-149,149,0
"E11HS",321,407,"1200x900",800,2,600,400,"False",989,340,239,-101,101,0
"E11HS",322,47,"1200x900",600,0,600,400,"False",303,499,417,-82,82,1
"E11HS",323,437,"1200x900",1000,0,600,400,"False",74,667,504,-163,163,1
"E11HS",324,511,"1200x900",1000,1,600,400,"False",408,390,571,181,181,1
"E11HS",325,643,"1200x900",1000,2,600,400,"True",740,325,400,75,75,0
"E11HS",326,209,"1200x900",600,2,600,400,"True",937,637,600,-37,37,0
"E11HS",327,279,"1200x900",800,0,600,400,"True",252,202,242,40,40,1
"E11HS",328,468,"1200x900",1000,0,600,400,"True",121,219,281,62,62,1
"E11HS",329,191,"1200x900",600,2,600,400,"True",962,396,352,-44,44,0
"E11HS",330,480,"1200x900",1000,0,600,400,"False",100,231,295,64,64,1
"E11HS",331,288,"1200x900",800,0,600,400,"True",180,547,587,40,40,1
"E11HS",332,556,"1200x900",1000,1,600,400,"False",415,420,702,282,282,0
"E11HS",333,411,"1200x900",800,2,600,400,"True",805,361,389,28,28,0
"E11HS",334,8,"1200x900",600,0,600,400,"True",156,679,680,1,1,0
"E11HS",335,296,"1200x900",800,1,600,400,"False",89,279,389,110,110,0
"E11HS",336,629,"1200x900",1000,2,600,400,"False",681,257,639,382,382,0
"E11HS",337,410,"1200x900",800,2,600,400,"False",916,477,351,-126,126,0
"E11HS",338,303,"1200x900",800,1,600,400,"True",241,431,402,-29,29,0
"E11HS",339,345,"1200x900",800,1,600,400,"False",841,566,635,69,69,1
"E11HS",340,597,"1200x900",1000,2,600,400,"True",352,239,309,70,70,0
"E11HS",341,536,"1200x900",1000,1,600,400,"False",580,213,297,84,84,0
"E11HS",342,170,"1200x900",600,2,600,400,"False",996,468,401,-67,67,0
"E11HS",343,154,"1200x900",600,2,600,400,"False",941,454,379,-75,75,0
"E11HS",344,172,"1200x900",600,2,600,400,"True",912,444,443,-1,1,0
"E11HS",345,413,"1200x900",800,2,600,400,"True",849,506,533,27,27,0
"E11HS",346,424,"1200x900",800,2,600,400,"True",903,545,496,-49,49,0
"E11HS",347,214,"1200x900",600,2,600,400,"True",1046,305,376,71,71,0
"E11HS",348,337,"1200x900",800,1,600,400,"True",299,622,563,-59,59,0
"E11HS",349,397,"1200x900",800,2,600,400,"True",817,692,654,-38,38,0
"E11HS",350,121,"1200x900",600,1,600,400,"False",884,364,475,111,111,0
"E11HS",351,255,"1200x900",800,0,600,400,"True",93,709,686,-23,23,1
"E11HS",352,253,"1200x900",800,0,600,400,"False",177,424,552,128,128,1
"E11HS",353,83,"1200x900",600,1,600,400,"True",763,568,517,-51,51,1
"E11HS",354,374,"1200x900",800,2,600,400,"False",755,450,513,63,63,0
"E11HS",355,363,"1200x900",800,2,600,400,"False",800,218,352,134,134,0
"E11HS",356,473,"1200x900",1000,0,600,400,"False",75,323,448,125,125,1
"E11HS",357,502,"1200x900",1000,0,600,400,"False",111,639,492,-147,147,1
"E11HS",358,11,"1200x900",600,0,600,400,"True",372,670,619,-51,51,1
"E11HS",359,289,"1200x900",800,1,600,400,"True",421,703,659,-44,44,1
"E11HS",360,422,"1200x900",800,2,600,400,"True",712,558,565,7,7,0
"E11HS",361,215,"1200x900",600,2,600,400,"True",939,596,568,-28,28,0
"E11HS",362,48,"1200x900",600,0,600,400,"True",323,645,646,1,1,1
"E11HS",363,3,"1200x900",600,0,600,400,"True",298,443,450,7,7,1
"E11HS",364,560,"1200x900",1000,1,600,400,"True",516,693,705,12,12,0
"E11HS",365,360,"1200x900",800,1,600,400,"True",203,608,657,49,49,0
"E11HS",366,547,"1200x900",1000,1,600,400,"False",369,384,586,202,202,1
"E11HS",367,561,"1200x900",1000,1,600,400,"False",231,406,519,113,113,0
"E11HS",368,375,"1200x900",800,2,600,400,"False",716,384,499,115,115,0
"E11HS",369,457,"1200x900",1000,0,600,400,"False",97,630,469,-161,161,1
"E11HS",370,109,"1200x900",600,1,600,400,"False",691,589,511,-78,78,0
"E11HS",371,57,"1200x900",600,0,600,400,"True",354,508,534,26,26,1
"E11HS",372,125,"1200x900",600,1,600,400,"True",750,531,568,37,37,0
"E11HS",373,60,"1200x900",600,0,600,400,"False",365,213,321,108,108,1
"E11HS",374,313,"1200x900",800,1,600,400,"True",588,421,365,-56,56,0
"E11HS",375,538,"1200x900",1000,1,600,400,"False",308,457,272,-185,185,1
"E11HS",376,487,"1200x900",1000,0,600,400,"False",78,670,462,-208,208,1
"E11HS",377,587,"1200x900",1000,2,600,400,"False",741,686,467,-219,219,0
"E11HS",378,631,"1200x900",1000,2,600,400,"False",699,479,562,83,83,0
"E11HS",379,241,"1200x900",800,0,600,400,"False",129,227,324,97,97,1
"E11HS",380,453,"1200x900",1000,0,600,400,"True",71,393,451,58,58,1
"E11HS",381,445,"1200x900",1000,0,600,400,"False",78,302,402,100,100,1
"E11HS",382,482,"1200x900",1000,0,600,400,"False",79,686,506,-180,180,1
"E11HS",383,342,"1200x900",800,1,600,400,"False",677,204,496,292,292,0
"E11HS",384,248,"1200x900",800,0,600,400,"True",94,240,262,22,22,1
"E11HS",385,185,"1200x900",600,2,600,400,"False",907,212,340,128,128,0
"E11HS",386,358,"1200x900",800,1,600,400,"False",263,635,332,-303,303,0
"E11HS",387,626,"1200x900",1000,2,600,400,"True",329,449,500,51,51,0
"E11HS",388,344,"1200x900",800,1,600,400,"True",589,408,405,-3,3,0
"E11HS",389,251,"1200x900",800,0,600,400,"True",88,352,343,-9,9,1
"E11HS",390,378,"1200x900",800,2,600,400,"False",1018,708,418,-290,290,0
"E11HS",391,546,"1200x900",1000,1,600,400,"False",305,374,513,139,139,0
"E11HS",392,466,"1200x900",1000,0,600,400,"False",82,205,345,140,140,1
"E11HS",393,423,"1200x900",800,2,600,400,"False",1051,710,586,-124,124,1
"E11HS",394,406,"1200x900",800,2,600,400,"False",971,233,546,313,313,0
"E11HS",395,238,"1200x900",800,0,600,400,"False",162,283,377,94,94,1
"E11HS",396,51,"1200x900",600,0,600,400,"True",272,181,146,-35,35,1
"E11HS",397,441,"1200x900",1000,0,600,400,"False",85,684,459,-225,225,1
"E11HS",398,123,"1200x900",600,1,600,400,"True",761,365,368,3,3,1
"E11HS",399,10,"1200x900",600,0,600,400,"True",400,499,443,-56,56,1
"E11HS",400,333,"1200x900",800,1,600,400,"False",521,548,696,148,148,0
"E11HS",401,184,"1200x900",600,2,600,400,"True",1067,441,369,-72,72,0
"E11HS",402,564,"1200x900",1000,1,600,400,"False",215,264,505,241,241,0
"E11HS",403,272,"1200x900",800,0,600,400,"True",200,181,161,-20,20,1
"E11HS",404,280,"1200x900",800,0,600,400,"True",104,302,334,32,32,1
"E11HS",405,621,"1200x900",1000,2,600,400,"True",540,478,499,21,21,0
"E11HS",406,639,"1200x900",1000,2,600,400,"False",504,456,329,-127,127,0
"E11HS",407,221,"1200x900",800,0,600,400,"False",132,520,397,-123,123,1
"E11HS",408,129,"1200x900",600,1,600,400,"False",859,482,371,-111,111,1
"E11HS",409,138,"1200x900",600,1,600,400,"False",844,580,668,88,88,1
"E11HS",410,223,"1200x900",800,0,600,400,"False",179,191,118,-73,73,1
"E11HS",411,325,"1200x900",800,1,600,400,"False",105,394,330,-64,64,0
"E11HS",412,417,"1200x900",800,2,600,400,"False",750,280,411,131,131,0
"E11HS",413,249,"1200x900",800,0,600,400,"False",126,306,377,71,71,1
"E11HS",415,281,"1200x900",800,0,600,400,"False",112,611,521,-90,90,1
"E11HS",416,418,"1200x900",800,2,600,400,"True",754,507,452,-55,55,0
"E11HS",417,592,"1200x900",1000,2,600,400,"True",492,392,424,32,32,0
"E11HS",418,2,"1200x900",600,0,600,400,"True",159,323,333,10,10,0
"E11HS",419,91,"1200x900",600,1,600,400,"False",417,630,498,-132,132,1
"E11HS",420,429,"1200x900",800,2,600,400,"True",682,692,620,-72,72,0
"E11HS",421,62,"1200x900",600,0,600,400,"True",345,346,349,3,3,1
"E11HS",422,153,"1200x900",600,2,600,400,"True",1037,601,611,10,10,0
"E11HS",423,526,"1200x900",1000,1,600,400,"True",497,710,644,-66,66,0
"E11HS",424,647,"1200x900",1000,2,600,400,"True",560,637,574,-63,63,0
"E11HS",425,322,"1200x900",800,1,600,400,"False",703,206,283,77,77,1
"E11HS",426,519,"1200x900",1000,1,600,400,"True",319,565,621,56,56,1
"E11HS",427,98,"1200x900",600,1,600,400,"True",625,530,584,54,54,0
"E11HS",428,524,"1200x900",1000,1,600,400,"True",534,470,496,26,26,0
"E11HS",429,286,"1200x900",800,0,600,400,"True",105,378,387,9,9,1
"E11HS",430,361,"1200x900",800,2,600,400,"True",931,328,345,17,17,0
"E11HS",431,103,"1200x900",600,1,600,400,"False",528,320,472,152,152,1
"E11HS",432,350,"1200x900",800,1,600,400,"False",182,566,320,-246,246,0
"E11HS",433,50,"1200x900",600,0,600,400,"False",75,582,483,-99,99,0
"E11HS",434,442,"1200x900",1000,0,600,400,"False",87,183,327,144,144,1
"E11HS",435,575,"1200x900",1000,1,600,400,"False",272,693,495,-198,198,0
"E11HS",436,266,"1200x900",800,0,600,400,"False",126,303,422,119,119,1
"E11HS",437,463,"1200x900",1000,0,600,400,"True",115,693,634,-59,59,1
"E11HS",438,95,"1200x900",600,1,600,400,"True",749,425,376,-49,49,1
"E11HS",439,45,"1200x900",600,0,600,400,"False",487,678,570,-108,108,1
"E11HS",440,604,"1200x900",1000,2,600,400,"False",459,593,529,-64,64,0
"E11HS",441,331,"1200x900",800,1,600,400,"True",240,620,577,-43,43,0
"E11HS",442,41,"1200x900",600,0,600,400,"True",370,452,435,-17,17,1
"E11HS",443,455,"1200x900",1000,0,600,400,"False",107,718,647,-71,71,1
"E11HS",444,408,"1200x900",800,2,600,400,"False",758,567,410,-157,157,0
"E11HS",445,551,"1200x900",1000,1,600,400,"False",146,445,568,123,123,1
"E11HS",446,610,"1200x900",1000,2,600,400,"False",702,293,384,91,91,0
"E11HS",447,438,"1200x900",1000,0,600,400,"False",77,713,490,-223,223,1
"E11HS",448,204,"1200x900",600,2,600,400,"False",1053,432,339,-93,93,0
"E11HS",449,202,"1200x900",600,2,600,400,"True",966,460,478,18,18,0
"E11HS",450,572,"1200x900",1000,1,600,400,"True",302,260,287,27,27,0
"E11HS",451,19,"1200x900",600,0,600,400,"False",286,686,577,-109,109,0
"E11HS",452,4,"1200x900",600,0,600,400,"False",602,200,296,96,96,1
"E11HS",453,242,"1200x900",800,0,600,400,"False",117,448,363,-85,85,1
"E11HS",454,508,"1200x900",1000,1,600,400,"True",596,485,470,-15,15,0
"E11HS",455,356,"1200x900",800,1,600,400,"False",123,484,570,86,86,0
"E11HS",456,637,"1200x900",1000,2,600,400,"True",750,460,447,-13,13,0
"E11HS",457,84,"1200x900",600,1,600,400,"False",144,184,351,167,167,0
"E11HS",458,372,"1200x900",800,2,600,400,"False",833,620,409,-211,211,0
"E11HS",459,618,"1200x900",1000,2,600,400,"True",276,671,642,-29,29,0
"E11HS",460,574,"1200x900",1000,1,600,400,"True",614,194,237,43,43,0
"E11HS",461,216,"1200x900",600,2,600,400,"True",1029,286,287,1,1,0
"E11HS",462,615,"1200x900",1000,2,600,400,"True",736,634,601,-33,33,0
"E11HS",463,627,"1200x900",1000,2,600,400,"False",760,510,598,88,88,0
"E11HS",464,79,"1200x900",600,1,600,400,"True",731,289,302,13,13,0
"E11HS",465,357,"1200x900",800,1,600,400,"True",109,594,578,-16,16,0
"E11HS",466,414,"1200x900",800,2,600,400,"True",831,592,581,-11,11,0
"E11HS",467,472,"1200x900",1000,0,600,400,"True",77,685,718,33,33,1
"E11HS",468,190,"1200x900",600,2,600,400,"True",977,238,318,80,80,0
"E11HS",469,412,"1200x900",800,2,600,400,"True",842,280,316,36,36,0
"E11HS",470,81,"1200x900",600,1,600,400,"False",696,225,296,71,71,0
"E11HS",471,611,"1200x900",1000,2,600,400,"True",414,511,515,4,4,0
"E11HS",472,336,"1200x900",800,1,600,400,"False",251,587,429,-158,158,0
"E11HS",473,533,"1200x900",1000,1,600,400,"True",355,483,492,9,9,0
"E11HS",474,620,"1200x900",1000,2,600,400,"False",832,649,422,-227,227,0
"E11HS",475,352,"1200x900",800,1,600,400,"False",235,717,618,-99,99,0
"E11HS",476,436,"1200x900",1000,0,600,400,"True",82,617,566,-51,51,1
"E11HS",477,168,"1200x900",600,2,600,400,"True",1001,439,420,-19,19,0
"E11HS",478,122,"1200x900",600,1,600,400,"False",817,709,580,-129,129,0
"E11HS",479,177,"1200x900",600,2,600,400,"True",912,236,303,67,67,0
"E11HS",480,239,"1200x900",800,0,600,400,"True",114,231,278,47,47,1
"E11HS",481,58,"1200x900",600,0,600,400,"False",353,655,543,-112,112,1
"E11HS",482,74,"1200x900",600,1,600,400,"True",115,358,373,15,15,0
"E11HS",483,351,"1200x900",800,1,600,400,"True",122,581,538,-43,43,0
"E11HS",484,581,"1200x900",1000,2,600,400,"True",310,357,431,74,74,0
"E11HS",485,387,"1200x900",800,2,600,400,"True",990,444,397,-47,47,0
"E11HS",486,260,"1200x900",800,0,600,400,"False",103,525,414,-111,111,1
"E11HS",487,219,"1200x900",800,0,600,400,"True",202,502,557,55,55,1
"E11HS",488,9,"1200x900",600,0,600,400,"False",509,654,548,-106,106,1
"E11HS",489,287,"1200x900",800,0,600,400,"False",120,567,433,-134,134,1
"E11HS",490,549,"1200x900",1000,1,600,400,"False",657,366,459,93,93,0
"E11HS",491,346,"1200x900",800,1,600,400,"True",269,635,571,-64,64,0
"E11HS",492,529,"1200x900",1000,1,600,400,"False",267,412,344,-68,68,1
"E11HS",493,282,"1200x900",800,0,600,400,"True",109,246,285,39,39,1
"E11HS",494,235,"1200x900",800,0,600,400,"False",146,646,486,-160,160,1
"E11HS",495,306,"1200x900",800,1,600,400,"False",164,524,598,74,74,0
"E11HS",496,76,"1200x900",600,1,600,400,"True",647,614,533,-81,81,0
"E11HS",497,395,"1200x900",800,2,600,400,"True",743,334,328,-6,6,0
"E11HS",498,576,"1200x900",1000,1,600,400,"True",376,713,733,20,20,0
"E11HS",499,501,"1200x900",1000,0,600,400,"False",96,323,445,122,122,1
"E11HS",500,115,"1200x900",600,1,600,400,"True",545,307,408,101,101,0
"E11HS",501,593,"1200x900",1000,2,600,400,"True",246,719,719,0,0,0
"E11HS",502,116,"1200x900",600,1,600,400,"True",767,289,314,25,25,0
"E11HS",503,139,"1200x900",600,1,600,400,"True",192,695,625,-70,70,0
"E11HS",504,42,"1200x900",600,0,600,400,"True",233,479,445,-34,34,0
"E11HS",505,329,"1200x900",800,1,600,400,"False",517,239,394,155,155,0
"E11HS",506,31,"1200x900",600,0,600,400,"True",365,338,379,41,41,1
"E11HS",507,454,"1200x900",1000,0,600,400,"False",78,687,541,-146,146,1
"E11HS",508,27,"1200x900",600,0,600,400,"True",373,309,329,20,20,1
"E11HS",509,227,"1200x900",800,0,600,400,"False",196,551,653,102,102,1
"E11HS",510,171,"1200x900",600,2,600,400,"False",909,200,384,184,184,0
"E11HS",511,52,"1200x900",600,0,600,400,"True",171,188,207,19,19,0
"E11HS",512,262,"1200x900",800,0,600,400,"False",196,481,329,-152,152,1
"E11HS",513,298,"1200x900",800,1,600,400,"False",311,457,361,-96,96,0
"E11HS",514,12,"1200x900",600,0,600,400,"True",365,336,386,50,50,1
"E11HS",515,119,"1200x900",600,1,600,400,"True",168,563,589,26,26,0
"E11HS",516,456,"1200x900",1000,0,600,400,"False",91,257,408,151,151,1
"E11HS",517,66,"1200x900",600,0,600,400,"True",155,673,632,-41,41,0
"E11HS",518,300,"1200x900",800,1,600,400,"True",620,693,684,-9,9,0
"E11HS",519,388,"1200x900",800,2,600,400,"False",930,320,666,346,346,0
"E11HS",520,544,"1200x900",1000,1,600,400,"True",602,620,637,17,17,0
"E11HS",521,100,"1200x900",600,1,600,400,"False",453,511,388,-123,123,0
"E11HS",522,446,"1200x900",1000,0,600,400,"False",72,298,464,166,166,1
"E11HS",523,35,"1200x900",600,0,600,400,"True",366,555,543,-12,12,1
"E11HS",524,338,"1200x900",800,1,600,400,"False",813,253,376,123,123,1
"E11HS",525,377,"1200x900",800,2,600,400,"True",683,388,409,21,21,0
"E11HS",526,394,"1200x900",800,2,600,400,"False",847,292,490,198,198,0
"E11HS",527,69,"1200x900",600,0,600,400,"True",322,268,261,-7,7,0
"E11HS",528,606,"1200x900",1000,2,600,400,"False",653,627,411,-216,216,0
"E11HS",529,571,"1200x900",1000,1,600,400,"False",239,522,582,60,60,1
"E11HS",530,490,"1200x900",1000,0,600,400,"False",114,183,411,228,228,1
"E11HS",531,566,"1200x900",1000,1,600,400,"False",378,472,400,-72,72,1
"E11HS",532,426,"1200x900",800,2,600,400,"False",830,263,377,114,114,0
"E11HS",533,366,"1200x900",800,2,600,400,"False",931,464,366,-98,98,0
"E11HS",534,535,"1200x900",1000,1,600,400,"True",372,410,409,-1,1,0
"E11HS",535,29,"1200x900",600,0,600,400,"True",385,533,517,-16,16,1
"E11HS",536,513,"1200x900",1000,1,600,400,"False",235,602,413,-189,189,0
"E11HS",537,283,"1200x900",800,0,600,400,"True",90,264,234,-30,30,1
"E11HS",538,557,"1200x900",1000,1,600,400,"False",677,505,708,203,203,1
"E11HS",539,530,"1200x900",1000,1,600,400,"False",584,405,334,-71,71,1
"E11HS",540,347,"1200x900",800,1,600,400,"False",757,295,592,297,297,1
"E11HS",541,273,"1200x900",800,0,600,400,"False",180,309,377,68,68,1
"E11HS",542,39,"1200x900",600,0,600,400,"True",210,609,548,-61,61,0
"E11HS",543,440,"1200x900",1000,0,600,400,"False",71,237,342,105,105,1
"E11HS",544,459,"1200x900",1000,0,600,400,"False",70,645,492,-153,153,1
"E11HS",545,263,"1200x900",800,0,600,400,"False",82,396,469,73,73,1
"E11HS",546,131,"1200x900",600,1,600,400,"False",531,367,603,236,236,0
"E11HS",547,617,"1200x900",1000,2,600,400,"False",294,180,272,92,92,0
"E11HS",548,159,"1200x900",600,2,600,400,"True",992,309,278,-31,31,0
"E11HS",549,589,"1200x900",1000,2,600,400,"False",856,418,579,161,161,0
"E11HS",550,233,"1200x900",800,0,600,400,"True",164,700,741,41,41,1
"E11HS",551,23,"1200x900",600,0,600,400,"True",308,463,519,56,56,1
"E11HS",552,432,"1200x900",800,2,600,400,"True",792,380,360,-20,20,0
"E11HS",553,343,"1200x900",800,1,600,400,"False",407,557,423,-134,134,0
"E11HS",554,77,"1200x900",600,1,600,400,"False",780,525,417,-108,108,0
"E11HS",555,516,"1200x900",1000,1,600,400,"True",440,559,520,-39,39,0
"E11HS",556,506,"1200x900",1000,1,600,400,"False",559,567,389,-178,178,1
"E11HS",557,53,"1200x900",600,0,600,400,"False",177,189,253,64,64,0
"E11HS",558,382,"1200x900",800,2,600,400,"False",870,523,339,-184,184,0
"E11HS",559,70,"1200x900",600,0,600,400,"True",309,703,697,-6,6,1
"E11HS",560,67,"1200x900",600,0,600,400,"True",289,308,363,55,55,1
"E11HS",561,405,"1200x900",800,2,600,400,"False",790,307,486,179,179,0
"E11HS",562,510,"1200x900",1000,1,600,400,"False",486,338,280,-58,58,1
"E11HS",563,75,"1200x900",600,1,600,400,"False",635,558,434,-124,124,0
"E11HS",564,143,"1200x900",600,1,600,400,"False",479,284,373,89,89,1
"E11HS",565,585,"1200x900",1000,2,600,400,"False",698,688,498,-190,190,1
"E11HS",566,130,"1200x900",600,1,600,400,"False",741,428,527,99,99,0
"E11HS",567,231,"1200x900",800,0,600,400,"False",251,718,623,-95,95,1
"E11HS",568,385,"1200x900",800,2,600,400,"False",740,456,641,185,185,0
"E11HS",569,452,"1200x900",1000,0,600,400,"False",97,273,429,156,156,1
"E11HS",570,409,"1200x900",800,2,600,400,"False",501,659,575,-84,84,0
"E11HS",571,630,"1200x900",1000,2,600,400,"True",754,559,571,12,12,0
"E11HS",572,264,"1200x900",800,0,600,400,"False",198,660,498,-162,162,1
"E11HS",573,484,"1200x900",1000,0,600,400,"True",100,223,285,62,62,1
"E11HS",574,635,"1200x900",1000,2,600,400,"True",833,402,348,-54,54,0
"E11HS",575,616,"1200x900",1000,2,600,400,"True",854,357,359,2,2,1
"E11HS",576,584,"1200x900",1000,2,600,400,"True",731,413,360,-53,53,0
"E11HS",577,188,"1200x900",600,2,600,400,"False",900,195,361,166,166,0
"E11HS",578,195,"1200x900",600,2,600,400,"True",942,249,279,30,30,0
"E11HS",579,550,"1200x900",1000,1,600,400,"True",301,459,406,-53,53,0
"E11HS",580,364,"1200x900",800,2,600,400,"False",1018,204,557,353,353,0
"E11HS",581,419,"1200x900",800,2,600,400,"True",769,351,356,5,5,0
"E11HS",582,252,"1200x900",800,0,600,400,"False",224,673,494,-179,179,1
"E11HS",583,327,"1200x900",800,1,600,400,"True",152,339,415,76,76,0
"E11HS",585,308,"1200x900",800,1,600,400,"False",437,425,542,117,117,0
"E11HS",586,182,"1200x900",600,2,600,400,"True",933,389,434,45,45,0
"E11HS",587,367,"1200x900",800,2,600,400,"True",613,464,425,-39,39,0
"E11HS",588,478,"1200x900",1000,0,600,400,"False",79,672,465,-207,207,1
"E11HS",589,33,"1200x900",600,0,600,400,"True",198,533,510,-23,23,1
"E11HS",590,117,"1200x900",600,1,600,400,"False",711,456,380,-76,76,0
"E11HS",591,330,"1200x900",800,1,600,400,"False",759,301,413,112,112,1
"E11HS",592,292,"1200x900",800,1,600,400,"True",88,565,565,0,0,0
"E11HS",593,302,"1200x900",800,1,600,400,"False",479,467,616,149,149,1
"E11HS",594,315,"1200x900",800,1,600,400,"False",105,211,367,156,156,0
"E11HS",595,268,"1200x900",800,0,600,400,"True",148,400,364,-36,36,1
"E11HS",596,430,"1200x900",800,2,600,400,"True",922,254,308,54,54,0
"E11HS",597,474,"1200x900",1000,0,600,400,"False",85,339,467,128,128,1
"E11HS",598,310,"1200x900",800,1,600,400,"True",559,592,570,-22,22,0
"E11HS",599,90,"1200x900",600,1,600,400,"False",560,474,322,-152,152,0
"E11HS",600,99,"1200x900",600,1,600,400,"True",811,407,449,42,42,0
"E11HS",601,13,"1200x900",600,0,600,400,"True",296,211,191,-20,20,1
"E11HS",602,49,"1200x900",600,0,600,400,"True",109,380,413,33,33,0
"E11HS",603,136,"1200x900",600,1,600,400,"True",264,205,293,88,88,0
"E11HS",604,565,"1200x900",1000,1,600,400,"True",451,562,600,38,38,0
"E11HS",605,348,"1200x900",800,1,600,400,"False",764,294,389,95,95,0
"E11HS",606,261,"1200x900",800,0,600,400,"True",86,713,730,17,17,1
"E11HS",607,641,"1200x900",1000,2,600,400,"False",897,272,629,357,357,0
"E11HS",608,194,"1200x900",600,2,600,400,"True",896,236,243,7,7,0
"E11HS",609,515,"1200x900",1000,1,600,400,"False",307,217,318,101,101,0
"E11HS",610,299,"1200x900",800,1,600,400,"False",779,274,423,149,149,0
"E11HS",611,105,"1200x900",600,1,600,400,"False",527,440,535,95,95,0
"E11HS",612,607,"1200x900",1000,2,600,400,"True",900,573,585,12,12,1
"E11HS",613,210,"1200x900",600,2,600,400,"False",835,506,600,94,94,0
"E11HS",614,156,"1200x900",600,2,600,400,"True",913,197,228,31,31,0
"E11HS",615,20,"1200x900",600,0,600,400,"False",204,545,451,-94,94,1
"E11HS",616,114,"1200x900",600,1,600,400,"True",183,697,620,-77,77,0
"E11HS",617,339,"1200x900",800,1,600,400,"False",273,545,644,99,99,1
"E11HS",618,328,"1200x900",800,1,600,400,"True",104,649,660,11,11,0
"E11HS",619,521,"1200x900",1000,1,600,400,"False",111,303,427,124,124,1
"E11HS",620,633,"1200x900",1000,2,600,400,"False",564,253,491,238,238,0
"E11HS",621,570,"1200x900",1000,1,600,400,"False",315,352,427,75,75,0
"E11HS",622,274,"1200x900",800,0,600,400,"True",146,497,460,-37,37,1
"E11HS",623,271,"1200x900",800,0,600,400,"True",74,360,311,-49,49,1
"E11HS",624,87,"1200x900",600,1,600,400,"True",231,604,624,20,20,0
"E11HS",625,548,"1200x900",1000,1,600,400,"False",103,278,581,303,303,0
"E11HS",626,471,"1200x900",1000,0,600,400,"False",122,200,326,126,126,1
"E11HS",627,625,"1200x900",1000,2,600,400,"False",279,228,380,152,152,0
"E11HS",628,573,"1200x900",1000,1,600,400,"False",486,615,486,-129,129,0
"E11HS",629,588,"1200x900",1000,2,600,400,"False",585,350,259,-91,91,0
"E11HS",630,307,"1200x900",800,1,600,400,"False",716,247,340,93,93,0
"E11HS",631,38,"1200x900",600,0,600,400,"False",120,628,476,-152,152,1
"E11HS",632,461,"1200x900",1000,0,600,400,"False",95,711,558,-153,153,1
"E11HS",633,428,"1200x900",800,2,600,400,"True",732,665,606,-59,59,0
"E11HS",634,477,"1200x900",1000,0,600,400,"False",88,640,553,-87,87,1
"E11HS",635,603,"1200x900",1000,2,600,400,"False",693,280,377,97,97,0
"E11HS",636,448,"1200x900",1000,0,600,400,"False",107,641,470,-171,171,1
"E11HS",637,34,"1200x900",600,0,600,400,"True",361,242,194,-48,48,1
"E11HS",638,527,"1200x900",1000,1,600,400,"True",565,601,612,11,11,0
"E11HS",639,293,"1200x900",800,1,600,400,"False",561,396,532,136,136,0
"E11HS",640,18,"1200x900",600,0,600,400,"False",400,318,406,88,88,1
"E11HS",641,71,"1200x900",600,0,600,400,"True",219,248,300,52,52,0
"E11HS",642,201,"1200x900",600,2,600,400,"False",1005,462,404,-58,58,0
"E11HS",643,55,"1200x900",600,0,600,400,"True",211,305,346,41,41,1
"E11HS",644,73,"1200x900",600,1,600,400,"True",94,665,656,-9,9,0
"E11HS",645,297,"1200x900",800,1,600,400,"False",625,244,365,121,121,0
"E11HS",646,247,"1200x900",800,0,600,400,"False",160,424,517,93,93,1
"E11HS",647,354,"1200x900",800,1,600,400,"False",118,236,329,93,93,0
"E11HS",648,381,"1200x900",800,2,600,400,"True",705,408,421,13,13,0
"E12AS",1,440,"1200x900",1000,0,600,400,"False",71,237,317,80,80,1
"E12AS",2,270,"1200x900",800,0,600,400,"True",192,418,481,63,63,1
"E12AS",3,607,"1200x900",1000,2,600,400,"False",900,573,747,174,174,1
"E12AS",4,92,"1200x900",600,1,600,400,"True",624,605,649,44,44,0
"E12AS",5,174,"1200x900",600,2,600,400,"False",998,457,591,134,134,0
"E12AS",6,137,"1200x900",600,1,600,400,"True",789,577,520,-57,57,0
"E12AS",7,376,"1200x900",800,2,600,400,"False",788,275,393,118,118,0
"E12AS",8,487,"1200x900",1000,0,600,400,"False",78,670,600,-70,70,1
"E12AS",9,390,"1200x900",800,2,600,400,"True",982,674,614,-60,60,1
"E12AS",10,391,"1200x900",800,2,600,400,"True",895,521,500,-21,21,0
"E12AS",11,64,"1200x900",600,0,600,400,"True",102,339,318,-21,21,0
"E12AS",12,69,"1200x900",600,0,600,400,"True",322,268,225,-43,43,0
"E12AS",13,572,"1200x900",1000,1,600,400,"True",302,260,248,-12,12,0
"E12AS",14,229,"1200x900",800,0,600,400,"True",117,697,723,26,26,1
"E12AS",15,49,"1200x900",600,0,600,400,"True",109,380,397,17,17,0
"E12AS",16,372,"1200x900",800,2,600,400,"True",833,620,839,219,219,0
"E12AS",17,398,"1200x900",800,2,600,400,"True",944,698,679,-19,19,0
"E12AS",18,163,"1200x900",600,2,600,400,"True",1046,665,685,20,20,0
"E12AS",19,56,"1200x900",600,0,600,400,"True",148,491,454,-37,37,0
"E12AS",20,555,"1200x900",1000,1,600,400,"True",444,556,584,28,28,0
"E12AS",21,313,"1200x900",800,1,600,400,"True",588,421,444,23,23,0
"E12AS",22,243,"1200x900",800,0,600,400,"True",114,332,380,48,48,1
"E12AS",23,6,"1200x900",600,0,600,400,"True",217,689,704,15,15,1
"E12AS",24,28,"1200x900",600,0,600,400,"True",336,410,414,4,4,1
"E12AS",25,425,"1200x900",800,2,600,400,"True",621,438,426,-12,12,0
"E12AS",26,603,"1200x900",1000,2,600,400,"False",693,280,507,227,227,0
"E12AS",27,334,"1200x900",800,1,600,400,"True",481,665,649,-16,16,0
"E12AS",28,626,"1200x900",1000,2,600,400,"False",329,449,528,79,79,0
"E12AS",29,85,"1200x900",600,1,600,400,"False",434,347,546,199,199,0
"E12AS",30,131,"1200x900",600,1,600,400,"False",531,367,547,180,180,0
"E12AS",31,220,"1200x900",800,0,600,400,"True",108,699,727,28,28,1
"E12AS",32,416,"1200x900",800,2,600,400,"False",748,617,497,-120,120,0
"E12AS",33,415,"1200x900",800,2,600,400,"False",823,684,601,-83,83,0
"E12AS",34,265,"1200x900",800,0,600,400,"True",229,353,334,-19,19,1
"E12AS",35,590,"1200x900",1000,2,600,400,"False",636,278,593,315,315,0
"E12AS",36,111,"1200x900",600,1,600,400,"True",922,552,491,-61,61,1
"E12AS",37,604,"1200x900",1000,2,600,400,"True",459,593,593,0,0,0
"E12AS",38,252,"1200x900",800,0,600,400,"True",224,673,683,10,10,1
"E12AS",39,311,"1200x900",800,1,600,400,"False",710,261,340,79,79,0
"E12AS",40,341,"1200x900",800,1,600,400,"False",735,632,739,107,107,1
"E12AS",41,83,"1200x900",600,1,600,400,"False",763,568,729,161,161,1
"E12AS",42,442,"1200x900",1000,0,600,400,"True",87,183,227,44,44,1
"E12AS",43,14,"1200x900",600,0,600,400,"True",399,224,214,-10,10,1
"E12AS",44,543,"1200x900",1000,1,600,400,"False",88,202,510,308,308,0
"E12AS",45,86,"1200x900",600,1,600,400,"False",692,388,176,-212,212,1
"E12AS",46,394,"1200x900",800,2,600,400,"False",847,292,540,248,248,0
"E12AS",47,279,"1200x900",800,0,600,400,"True",252,202,153,-49,49,1
"E12AS",48,267,"1200x900",800,0,600,400,"True",145,665,687,22,22,1
"E12AS",49,466,"1200x900",1000,0,600,400,"False",82,205,350,145,145,1
"E12AS",50,223,"1200x900",800,0,600,400,"True",179,191,215,24,24,1
"E12AS",51,84,"1200x900",600,1,600,400,"False",144,184,645,461,461,0
"E12AS",52,260,"1200x900",800,0,600,400,"False",103,525,406,-119,119,1
"E12AS",53,144,"1200x900",600,1,600,400,"False",718,371,495,124,124,0
"E12AS",54,90,"1200x900",600,1,600,400,"False",560,474,401,-73,73,0
"E12AS",55,527,"1200x900",1000,1,600,400,"False",565,601,521,-80,80,0
"E12AS",56,315,"1200x900",800,1,600,400,"False",105,211,471,260,260,0
"E12AS",57,480,"1200x900",1000,0,600,400,"False",100,231,344,113,113,1
"E12AS",58,446,"1200x900",1000,0,600,400,"True",72,298,228,-70,70,1
"E12AS",59,276,"1200x900",800,0,600,400,"True",281,217,238,21,21,1
"E12AS",60,375,"1200x900",800,2,600,400,"False",716,384,580,196,196,0
"E12AS",61,329,"1200x900",800,1,600,400,"True",517,239,298,59,59,0
"E12AS",62,471,"1200x900",1000,0,600,400,"False",122,200,367,167,167,1
"E12AS",63,189,"1200x900",600,2,600,400,"False",881,397,483,86,86,0
"E12AS",64,250,"1200x900",800,0,600,400,"True",290,248,250,2,2,1
"E12AS",65,4,"1200x900",600,0,600,400,"True",602,200,257,57,57,1
"E12AS",67,474,"1200x900",1000,0,600,400,"True",85,339,299,-40,40,1
"E12AS",68,122,"1200x900",600,1,600,400,"False",817,709,638,-71,71,0
"E12AS",69,483,"1200x900",1000,0,600,400,"False",93,191,282,91,91,1
"E12AS",70,640,"1200x900",1000,2,600,400,"False",361,334,434,100,100,0
"E12AS",71,196,"1200x900",600,2,600,400,"True",1030,397,470,73,73,0
"E12AS",72,10,"1200x900",600,0,600,400,"True",400,499,560,61,61,1
"E12AS",73,451,"1200x900",1000,0,600,400,"True",110,702,639,-63,63,1
"E12AS",74,297,"1200x900",800,1,600,400,"False",625,244,470,226,226,0
"E12AS",75,461,"1200x900",1000,0,600,400,"True",95,711,700,-11,11,1
"E12AS",76,348,"1200x900",800,1,600,400,"False",764,294,372,78,78,0
"E12AS",77,551,"1200x900",1000,1,600,400,"False",146,445,636,191,191,1
"E12AS",78,481,"1200x900",1000,0,600,400,"True",80,185,198,13,13,1
"E12AS",79,333,"1200x900",800,1,600,400,"False",521,548,777,229,229,0
"E12AS",80,253,"1200x900",800,0,600,400,"True",177,424,471,47,47,1
"E12AS",81,13,"1200x900",600,0,600,400,"True",296,211,219,8,8,1
"E12AS",82,419,"1200x900",800,2,600,400,"True",769,351,379,28,28,0
"E12AS",83,298,"1200x900",800,1,600,400,"True",311,457,461,4,4,0
"E12AS",84,525,"1200x900",1000,1,600,400,"False",123,690,484,-206,206,0
"E12AS",85,235,"1200x900",800,0,600,400,"True",146,646,630,-16,16,1
"E12AS",86,237,"1200x900",800,0,600,400,"False",204,481,550,69,69,1
"E12AS",87,486,"1200x900",1000,0,600,400,"True",102,676,702,26,26,1
"E12AS",88,134,"1200x900",600,1,600,400,"False",300,188,576,388,388,0
"E12AS",89,130,"1200x900",600,1,600,400,"True",741,428,476,48,48,0
"E12AS",90,195,"1200x900",600,2,600,400,"False",942,249,359,110,110,0
"E12AS",91,458,"1200x900",1000,0,600,400,"True",78,624,684,60,60,1
"E12AS",92,560,"1200x900",1000,1,600,400,"False",516,693,599,-94,94,0
"E12AS",93,470,"1200x900",1000,0,600,400,"True",91,666,669,3,3,1
"E12AS",94,55,"1200x900",600,0,600,400,"True",211,305,345,40,40,1
"E12AS",95,199,"1200x900",600,2,600,400,"False",992,467,387,-80,80,0
"E12AS",96,100,"1200x900",600,1,600,400,"False",453,511,320,-191,191,0
"E12AS",97,239,"1200x900",800,0,600,400,"True",114,231,185,-46,46,1
"E12AS",98,463,"1200x900",1000,0,600,400,"True",115,693,692,-1,1,1
"E12AS",99,577,"1200x900",1000,2,600,400,"True",455,420,434,14,14,0
"E12AS",100,582,"1200x900",1000,2,600,400,"False",554,347,481,134,134,0
"E12AS",101,9,"1200x900",600,0,600,400,"True",509,654,608,-46,46,1
"E12AS",102,485,"1200x900",1000,0,600,400,"True",121,694,718,24,24,1
"E12AS",103,255,"1200x900",800,0,600,400,"True",93,709,720,11,11,1
"E12AS",104,140,"1200x900",600,1,600,400,"False",700,523,600,77,77,0
"E12AS",105,48,"1200x900",600,0,600,400,"True",323,645,687,42,42,1
"E12AS",106,16,"1200x900",600,0,600,400,"True",297,514,485,-29,29,1
"E12AS",107,330,"1200x900",800,1,600,400,"True",759,301,387,86,86,1
"E12AS",108,289,"1200x900",800,1,600,400,"False",421,703,575,-128,128,1
"E12AS",109,93,"1200x900",600,1,600,400,"True",139,540,591,51,51,0
"E12AS",110,519,"1200x900",1000,1,600,400,"True",319,565,581,16,16,1
"E12AS",111,647,"1200x900",1000,2,600,400,"True",560,637,595,-42,42,0
"E12AS",112,476,"1200x900",1000,0,600,400,"False",76,359,202,-157,157,1
"E12AS",113,227,"1200x900",800,0,600,400,"True",196,551,496,-55,55,1
"E12AS",114,594,"1200x900",1000,2,600,400,"True",537,637,630,-7,7,0
"E12AS",115,562,"1200x900",1000,1,600,400,"True",347,540,557,17,17,0
"E12AS",116,633,"1200x900",1000,2,600,400,"False",564,253,555,302,302,0
"E12AS",117,175,"1200x900",600,2,600,400,"True",1028,432,479,47,47,0
"E12AS",118,293,"1200x900",800,1,600,400,"False",561,396,506,110,110,0
"E12AS",119,36,"1200x900",600,0,600,400,"False",128,346,432,86,86,1
"E12AS",120,566,"1200x900",1000,1,600,400,"False",378,472,406,-66,66,1
"E12AS",121,191,"1200x900",600,2,600,400,"True",962,396,454,58,58,0
"E12AS",122,230,"1200x900",800,0,600,400,"True",99,678,617,-61,61,1
"E12AS",123,504,"1200x900",1000,0,600,400,"True",107,699,669,-30,30,1
"E12AS",124,116,"1200x900",600,1,600,400,"True",767,289,273,-16,16,0
"E12AS",125,285,"1200x900",800,0,600,400,"True",237,396,407,11,11,1
"E12AS",126,351,"1200x900",800,1,600,400,"True",122,581,603,22,22,0
"E12AS",127,464,"1200x900",1000,0,600,400,"False",82,222,299,77,77,1
"E12AS",128,473,"1200x900",1000,0,600,400,"False",75,323,422,99,99,1
"E12AS",129,498,"1200x900",1000,0,600,400,"True",100,260,319,59,59,1
"E12AS",130,210,"1200x900",600,2,600,400,"False",835,506,641,135,135,0
"E12AS",131,550,"1200x900",1000,1,600,400,"False",301,459,532,73,73,0
"E12AS",132,612,"1200x900",1000,2,600,400,"False",706,198,414,216,216,0
"E12AS",133,533,"1200x900",1000,1,600,400,"False",355,483,397,-86,86,0
"E12AS",134,185,"1200x900",600,2,600,400,"False",907,212,432,220,220,0
"E12AS",135,51,"1200x900",600,0,600,400,"True",272,181,235,54,54,1
"E12AS",136,113,"1200x900",600,1,600,400,"False",897,657,427,-230,230,0
"E12AS",137,101,"1200x900",600,1,600,400,"True",541,656,682,26,26,0
"E12AS",138,538,"1200x900",1000,1,600,400,"True",308,457,514,57,57,1
"E12AS",139,236,"1200x900",800,0,600,400,"False",162,350,439,89,89,1
"E12AS",140,477,"1200x900",1000,0,600,400,"True",88,640,595,-45,45,1
"E12AS",141,639,"1200x900",1000,2,600,400,"True",504,456,482,26,26,0
"E12AS",142,154,"1200x900",600,2,600,400,"True",941,454,420,-34,34,0
"E12AS",143,105,"1200x900",600,1,600,400,"False",527,440,582,142,142,0
"E12AS",144,331,"1200x900",800,1,600,400,"False",240,620,382,-238,238,0
"E12AS",145,531,"1200x900",1000,1,600,400,"False",233,362,622,260,260,0
"E12AS",146,288,"1200x900",800,0,600,400,"True",180,547,548,1,1,1
"E12AS",147,244,"1200x900",800,0,600,400,"True",194,203,187,-16,16,1
"E12AS",148,325,"1200x900",800,1,600,400,"False",105,394,318,-76,76,0
"E12AS",149,549,"1200x900",1000,1,600,400,"True",657,366,414,48,48,0
"E12AS",150,584,"1200x900",1000,2,600,400,"True",731,413,375,-38,38,0
"E12AS",151,635,"1200x900",1000,2,600,400,"False",833,402,295,-107,107,0
"E12AS",152,75,"1200x900",600,1,600,400,"True",635,558,556,-2,2,0
"E12AS",153,202,"1200x900",600,2,600,400,"False",966,460,395,-65,65,0
"E12AS",154,537,"1200x900",1000,1,600,400,"False",621,412,564,152,152,1
"E12AS",155,400,"1200x900",800,2,600,400,"False",733,297,428,131,131,0
"E12AS",156,561,"1200x900",1000,1,600,400,"False",231,406,483,77,77,0
"E12AS",157,335,"1200x900",800,1,600,400,"True",124,360,382,22,22,0
"E12AS",158,52,"1200x900",600,0,600,400,"True",171,188,218,30,30,0
"E12AS",159,548,"1200x900",1000,1,600,400,"False",103,278,410,132,132,0
"E12AS",160,420,"1200x900",800,2,600,400,"False",519,223,462,239,239,0
"E12AS",161,272,"1200x900",800,0,600,400,"True",200,181,165,-16,16,1
"E12AS",162,108,"1200x900",600,1,600,400,"True",830,239,264,25,25,0
"E12AS",163,443,"1200x900",1000,0,600,400,"False",99,651,527,-124,124,1
"E12AS",164,233,"1200x900",800,0,600,400,"True",164,700,747,47,47,1
"E12AS",165,94,"1200x900",600,1,600,400,"True",729,482,536,54,54,0
"E12AS",166,567,"1200x900",1000,1,600,400,"True",655,297,307,10,10,1
"E12AS",167,291,"1200x900",800,1,600,400,"True",522,694,649,-45,45,0
"E12AS",168,569,"1200x900",1000,1,600,400,"False",494,720,391,-329,329,0
"E12AS",169,503,"1200x900",1000,0,600,400,"False",86,279,161,-118,118,1
"E12AS",170,179,"1200x900",600,2,600,400,"True",908,602,652,50,50,0
"E12AS",171,197,"1200x900",600,2,600,400,"False",903,212,407,195,195,0
"E12AS",172,160,"1200x900",600,2,600,400,"True",863,606,630,24,24,0
"E12AS",173,336,"1200x900",800,1,600,400,"False",251,587,490,-97,97,0
"E12AS",174,218,"1200x900",800,0,600,400,"True",106,397,363,-34,34,1
"E12AS",175,475,"1200x900",1000,0,600,400,"True",101,715,753,38,38,1
"E12AS",176,535,"1200x900",1000,1,600,400,"False",372,410,325,-85,85,0
"E12AS",177,121,"1200x900",600,1,600,400,"True",884,364,385,21,21,0
"E12AS",178,524,"1200x900",1000,1,600,400,"True",534,470,508,38,38,0
"E12AS",179,80,"1200x900",600,1,600,400,"False",616,423,504,81,81,1
"E12AS",180,232,"1200x900",800,0,600,400,"True",84,511,560,49,49,1
"E12AS",181,488,"1200x900",1000,0,600,400,"True",129,687,720,33,33,1
"E12AS",182,99,"1200x900",600,1,600,400,"True",811,407,435,28,28,0
"E12AS",183,165,"1200x900",600,2,600,400,"True",912,554,543,-11,11,0
"E12AS",184,456,"1200x900",1000,0,600,400,"True",91,257,266,9,9,1
"E12AS",185,79,"1200x900",600,1,600,400,"False",731,289,372,83,83,0
"E12AS",186,585,"1200x900",1000,2,600,400,"True",698,688,608,-80,80,1
"E12AS",187,526,"1200x900",1000,1,600,400,"False",497,710,423,-287,287,0
"E12AS",188,378,"1200x900",800,2,600,400,"False",1018,708,582,-126,126,0
"E12AS",189,35,"1200x900",600,0,600,400,"True",366,555,585,30,30,1
"E12AS",190,406,"1200x900",800,2,600,400,"False",971,233,571,338,338,0
"E12AS",191,617,"1200x900",1000,2,600,400,"False",294,180,372,192,192,0
"E12AS",192,281,"1200x900",800,0,600,400,"True",112,611,629,18,18,1
"E12AS",193,502,"1200x900",1000,0,600,400,"True",111,639,705,66,66,1
"E12AS",194,580,"1200x900",1000,2,600,400,"False",651,267,458,191,191,0
"E12AS",195,363,"1200x900",800,2,600,400,"False",800,218,307,89,89,0
"E12AS",196,37,"1200x900",600,0,600,400,"True",258,403,414,11,11,1
"E12AS",197,162,"1200x900",600,2,600,400,"True",849,279,274,-5,5,0
"E12AS",198,613,"1200x900",1000,2,600,400,"False",690,374,203,-171,171,0
"E12AS",199,186,"1200x900",600,2,600,400,"True",997,197,243,46,46,0
"E12AS",200,395,"1200x900",800,2,600,400,"True",743,334,414,80,80,0
"E12AS",201,217,"1200x900",800,0,600,400,"True",85,573,541,-32,32,1
"E12AS",202,181,"1200x900",600,2,600,400,"False",1018,223,323,100,100,0
"E12AS",203,280,"1200x900",800,0,600,400,"False",104,302,192,-110,110,1
"E12AS",204,58,"1200x900",600,0,600,400,"True",353,655,611,-44,44,1
"E12AS",205,371,"1200x900",800,2,600,400,"True",730,560,514,-46,46,0
"E12AS",206,303,"1200x900",800,1,600,400,"True",241,431,379,-52,52,0
"E12AS",207,359,"1200x900",800,1,600,400,"False",653,241,355,114,114,0
"E12AS",208,95,"1200x900",600,1,600,400,"False",749,425,320,-105,105,1
"E12AS",209,534,"1200x900",1000,1,600,400,"True",328,504,411,-93,93,1
"E12AS",210,615,"1200x900",1000,2,600,400,"True",736,634,588,-46,46,0
"E12AS",211,556,"1200x900",1000,1,600,400,"True",415,420,491,71,71,0
"E12AS",212,490,"1200x900",1000,0,600,400,"False",114,183,251,68,68,1
"E12AS",213,438,"1200x900",1000,0,600,400,"True",77,713,724,11,11,1
"E12AS",214,344,"1200x900",800,1,600,400,"False",589,408,482,74,74,0
"E12AS",215,575,"1200x900",1000,1,600,400,"True",272,693,663,-30,30,0
"E12AS",216,225,"1200x900",800,0,600,400,"True",178,423,458,35,35,1
"E12AS",217,616,"1200x900",1000,2,600,400,"False",854,357,266,-91,91,1
"E12AS",218,354,"1200x900",800,1,600,400,"False",118,236,331,95,95,0
"E12AS",219,133,"1200x900",600,1,600,400,"False",345,551,655,104,104,0
"E12AS",220,304,"1200x900",800,1,600,400,"False",667,605,419,-186,186,0
"E12AS",221,65,"1200x900",600,0,600,400,"True",442,645,677,32,32,1
"E12AS",222,159,"1200x900",600,2,600,400,"True",992,309,306,-3,3,0
"E12AS",223,40,"1200x900",600,0,600,400,"True",143,513,535,22,22,0
"E12AS",224,77,"1200x900",600,1,600,400,"True",780,525,538,13,13,0
"E12AS",225,123,"1200x900",600,1,600,400,"True",761,365,330,-35,35,1
"E12AS",226,240,"1200x900",800,0,600,400,"True",330,656,654,-2,2,1
"E12AS",227,578,"1200x900",1000,2,600,400,"False",966,276,597,321,321,0
"E12AS",228,447,"1200x900",1000,0,600,400,"False",71,339,415,76,76,1
"E12AS",229,599,"1200x900",1000,2,600,400,"True",316,570,590,20,20,0
"E12AS",230,224,"1200x900",800,0,600,400,"True",161,474,524,50,50,1
"E12AS",231,204,"1200x900",600,2,600,400,"True",1053,432,381,-51,51,0
"E12AS",232,32,"1200x900",600,0,600,400,"True",152,563,564,1,1,1
"E12AS",233,627,"1200x900",1000,2,600,400,"False",760,510,583,73,73,0
"E12AS",234,340,"1200x900",800,1,600,400,"False",226,240,468,228,228,0
"E12AS",235,38,"1200x900",600,0,600,400,"True",120,628,665,37,37,1
"E12AS",236,216,"1200x900",600,2,600,400,"True",1029,286,353,67,67,0
"E12AS",237,167,"1200x900",600,2,600,400,"False",956,241,344,103,103,0
"E12AS",238,496,"1200x900",1000,0,600,400,"False",70,639,574,-65,65,1
"E12AS",239,439,"1200x900",1000,0,600,400,"False",110,229,333,104,104,1
"E12AS",240,114,"1200x900",600,1,600,400,"True",183,697,575,-122,122,0
"E12AS",241,127,"1200x900",600,1,600,400,"True",309,691,693,2,2,0
"E12AS",242,605,"1200x900",1000,2,600,400,"False",493,665,562,-103,103,0
"E12AS",243,318,"1200x900",800,1,600,400,"False",788,534,629,95,95,0
"E12AS",244,422,"1200x900",800,2,600,400,"True",712,558,534,-24,24,0
"E12AS",245,437,"1200x900",1000,0,600,400,"True",74,667,706,39,39,1
"E12AS",246,479,"1200x900",1000,0,600,400,"True",74,705,725,20,20,1
"E12AS",247,158,"1200x900",600,2,600,400,"False",939,300,243,-57,57,0
"E12AS",248,397,"1200x900",800,2,600,400,"False",817,692,590,-102,102,0
"E12AS",249,98,"1200x900",600,1,600,400,"True",625,530,568,38,38,0
"E12AS",250,62,"1200x900",600,0,600,400,"True",345,346,367,21,21,1
"E12AS",251,211,"1200x900",600,2,600,400,"True",986,407,356,-51,51,0
"E12AS",252,324,"1200x900",800,1,600,400,"False",719,712,323,-389,389,1
"E12AS",253,501,"1200x900",1000,0,600,400,"False",96,323,403,80,80,1
"E12AS",254,33,"1200x900",600,0,600,400,"True",198,533,514,-19,19,1
"E12AS",255,558,"1200x900",1000,1,600,400,"False",72,464,329,-135,135,1
"E12AS",256,510,"1200x900",1000,1,600,400,"True",486,338,305,-33,33,1
"E12AS",257,328,"1200x900",800,1,600,400,"True",104,649,614,-35,35,0
"E12AS",258,129,"1200x900",600,1,600,400,"False",859,482,302,-180,180,1
"E12AS",259,358,"1200x900",800,1,600,400,"False",263,635,440,-195,195,0
"E12AS",260,20,"1200x900",600,0,600,400,"True",204,545,575,30,30,1
"E12AS",261,431,"1200x900",800,2,600,400,"False",694,382,581,199,199,0
"E12AS",262,82,"1200x900",600,1,600,400,"False",108,213,369,156,156,0
"E12AS",263,508,"1200x900",1000,1,600,400,"True",596,485,450,-35,35,0
"E12AS",264,602,"1200x900",1000,2,600,400,"False",865,452,335,-117,117,0
"E12AS",265,565,"1200x900",1000,1,600,400,"True",451,562,603,41,41,0
"E12AS",266,71,"1200x900",600,0,600,400,"False",219,248,353,105,105,0
"E12AS",267,96,"1200x900",600,1,600,400,"False",433,458,577,119,119,0
"E12AS",268,643,"1200x900",1000,2,600,400,"True",740,325,326,1,1,0
"E12AS",269,70,"1200x900",600,0,600,400,"True",309,703,718,15,15,1
"E12AS",270,629,"1200x900",1000,2,600,400,"False",681,257,628,371,371,0
"E12AS",271,326,"1200x900",800,1,600,400,"False",103,482,716,234,234,0
"E12AS",272,317,"1200x900",800,1,600,400,"False",185,564,649,85,85,0
"E12AS",273,139,"1200x900",600,1,600,400,"False",192,695,597,-98,98,0
"E12AS",274,646,"1200x900",1000,2,600,400,"True",829,227,256,29,29,1
"E12AS",275,444,"1200x900",1000,0,600,400,"False",101,714,606,-108,108,1
"E12AS",276,164,"1200x900",600,2,600,400,"True",1051,268,345,77,77,0
"E12AS",277,320,"1200x900",800,1,600,400,"True",644,376,440,64,64,0
"E12AS",278,491,"1200x900",1000,0,600,400,"True",108,198,257,59,59,1
"E12AS",279,529,"1200x900",1000,1,600,400,"False",267,412,322,-90,90,1
"E12AS",280,273,"1200x900",800,0,600,400,"False",180,309,182,-127,127,1
"E12AS",281,380,"1200x900",800,2,600,400,"True",942,228,266,38,38,0
"E12AS",282,393,"1200x900",800,2,600,400,"True",657,620,597,-23,23,0
"E12AS",283,201,"1200x900",600,2,600,400,"False",1005,462,352,-110,110,0
"E12AS",284,598,"1200x900",1000,2,600,400,"False",706,559,390,-169,169,0
"E12AS",285,511,"1200x900",1000,1,600,400,"False",408,390,736,346,346,1
"E12AS",286,489,"1200x900",1000,0,600,400,"False",88,604,752,148,148,1
"E12AS",287,169,"1200x900",600,2,600,400,"False",924,290,445,155,155,0
"E12AS",288,132,"1200x900",600,1,600,400,"True",333,185,219,34,34,0
"E12AS",289,319,"1200x900",800,1,600,400,"False",494,587,424,-163,163,1
"E12AS",290,173,"1200x900",600,2,600,400,"True",948,693,670,-23,23,0
"E12AS",291,362,"1200x900",800,2,600,400,"False",819,338,474,136,136,0
"E12AS",292,152,"1200x900",600,2,600,400,"False",971,399,299,-100,100,0
"E12AS",293,588,"1200x900",1000,2,600,400,"True",585,350,376,26,26,0
"E12AS",294,88,"1200x900",600,1,600,400,"True",186,554,479,-75,75,0
"E12AS",295,433,"1200x900",1000,0,600,400,"True",76,222,242,20,20,1
"E12AS",296,632,"1200x900",1000,2,600,400,"False",984,227,589,362,362,0
"E12AS",297,539,"1200x900",1000,1,600,400,"False",510,383,309,-74,74,0
"E12AS",298,367,"1200x900",800,2,600,400,"False",613,464,226,-238,238,0
"E12AS",299,624,"1200x900",1000,2,600,400,"False",693,501,411,-90,90,0
"E12AS",300,399,"1200x900",800,2,600,400,"True",603,602,588,-14,14,0
"E12AS",301,593,"1200x900",1000,2,600,400,"False",246,719,641,-78,78,0
"E12AS",302,343,"1200x900",800,1,600,400,"False",407,557,402,-155,155,0
"E12AS",303,552,"1200x900",1000,1,600,400,"False",255,412,586,174,174,0
"E12AS",304,242,"1200x900",800,0,600,400,"True",117,448,451,3,3,1
"E12AS",305,573,"1200x900",1000,1,600,400,"True",486,615,571,-44,44,0
"E12AS",306,226,"1200x900",800,0,600,400,"True",187,229,229,0,0,1
"E12AS",307,286,"1200x900",800,0,600,400,"True",105,378,406,28,28,1
"E12AS",308,104,"1200x900",600,1,600,400,"False",448,584,391,-193,193,0
"E12AS",309,597,"1200x900",1000,2,600,400,"False",352,239,440,201,201,0
"E12AS",310,619,"1200x900",1000,2,600,400,"False",803,247,401,154,154,0
"E12AS",311,514,"1200x900",1000,1,600,400,"True",539,690,725,35,35,0
"E12AS",312,478,"1200x900",1000,0,600,400,"False",79,672,751,79,79,1
"E12AS",313,369,"1200x900",800,2,600,400,"True",903,594,542,-52,52,0
"E12AS",314,322,"1200x900",800,1,600,400,"True",703,206,236,30,30,1
"E12AS",315,203,"1200x900",600,2,600,400,"True",938,603,608,5,5,0
"E12AS",316,87,"1200x900",600,1,600,400,"False",231,604,500,-104,104,0
"E12AS",317,621,"1200x900",1000,2,600,400,"False",540,478,638,160,160,0
"E12AS",318,292,"1200x900",800,1,600,400,"True",88,565,530,-35,35,0
"E12AS",319,554,"1200x900",1000,1,600,400,"False",79,309,456,147,147,1
"E12AS",320,19,"1200x900",600,0,600,400,"False",286,686,593,-93,93,0
"E12AS",321,271,"1200x900",800,0,600,400,"False",74,360,444,84,84,1
"E12AS",322,468,"1200x900",1000,0,600,400,"False",121,219,302,83,83,1
"E12AS",323,459,"1200x900",1000,0,600,400,"False",70,645,557,-88,88,1
"E12AS",324,441,"1200x900",1000,0,600,400,"True",85,684,672,-12,12,1
"E12AS",325,591,"1200x900",1000,2,600,400,"True",698,336,285,-51,51,0
"E12AS",326,149,"1200x900",600,2,600,400,"True",890,289,267,-22,22,0
"E12AS",327,581,"1200x900",1000,2,600,400,"True",310,357,320,-37,37,0
"E12AS",328,457,"1200x900",1000,0,600,400,"True",97,630,569,-61,61,1
"E12AS",329,645,"1200x900",1000,2,600,400,"False",619,396,281,-115,115,0
"E12AS",330,215,"1200x900",600,2,600,400,"False",939,596,453,-143,143,0
"E12AS",331,209,"1200x900",600,2,600,400,"False",937,637,744,107,107,0
"E12AS",332,262,"1200x900",800,0,600,400,"True",196,481,440,-41,41,1
"E12AS",333,117,"1200x900",600,1,600,400,"False",711,456,282,-174,174,0
"E12AS",334,412,"1200x900",800,2,600,400,"True",842,280,280,0,0,0
"E12AS",335,410,"1200x900",800,2,600,400,"False",916,477,305,-172,172,0
"E12AS",336,568,"1200x900",1000,1,600,400,"True",286,475,526,51,51,1
"E12AS",337,89,"1200x900",600,1,600,400,"False",917,366,464,98,98,1
"E12AS",338,506,"1200x900",1000,1,600,400,"False",559,567,252,-315,315,1
"E12AS",339,499,"1200x900",1000,0,600,400,"True",93,271,234,-37,37,1
"E12AS",340,183,"1200x900",600,2,600,400,"False",927,289,444,155,155,0
"E12AS",341,426,"1200x900",800,2,600,400,"True",830,263,275,12,12,0
"E12AS",342,314,"1200x900",800,1,600,400,"True",277,616,647,31,31,1
"E12AS",343,146,"1200x900",600,2,600,400,"False",989,492,407,-85,85,0
"E12AS",344,302,"1200x900",800,1,600,400,"False",479,467,658,191,191,1
"E12AS",345,118,"1200x900",600,1,600,400,"True",190,588,606,18,18,0
"E12AS",346,417,"1200x900",800,2,600,400,"False",750,280,560,280,280,0
"E12AS",347,484,"1200x900",1000,0,600,400,"True",100,223,205,-18,18,1
"E12AS",348,29,"1200x900",600,0,600,400,"True",385,533,566,33,33,1
"E12AS",349,596,"1200x900",1000,2,600,400,"False",706,513,625,112,112,0
"E12AS",350,418,"1200x900",800,2,600,400,"False",754,507,368,-139,139,0
"E12AS",351,507,"1200x900",1000,1,600,400,"False",608,583,695,112,112,1
"E12AS",352,636,"1200x900",1000,2,600,400,"True",575,583,529,-54,54,0
"E12AS",353,601,"1200x900",1000,2,600,400,"False",735,697,293,-404,404,0
"E12AS",354,138,"1200x900",600,1,600,400,"True",844,580,606,26,26,1
"E12AS",355,559,"1200x900",1000,1,600,400,"True",641,244,249,5,5,0
"E12AS",356,124,"1200x900",600,1,600,400,"False",345,467,261,-206,206,0
"E12AS",357,460,"1200x900",1000,0,600,400,"True",155,189,156,-33,33,1
"E12AS",358,404,"1200x900",800,2,600,400,"True",842,396,354,-42,42,0
"E12AS",359,254,"1200x900",800,0,600,400,"True",136,583,566,-17,17,1
"E12AS",360,430,"1200x900",800,2,600,400,"True",922,254,317,63,63,0
"E12AS",361,356,"1200x900",800,1,600,400,"False",123,484,596,112,112,0
"E12AS",362,536,"1200x900",1000,1,600,400,"False",580,213,364,151,151,0
"E12AS",363,11,"1200x900",600,0,600,400,"True",372,670,650,-20,20,1
"E12AS",364,540,"1200x900",1000,1,600,400,"True",389,568,495,-73,73,1
"E12AS",365,296,"1200x900",800,1,600,400,"True",89,279,298,19,19,0
"E12AS",366,170,"1200x900",600,2,600,400,"True",996,468,426,-42,42,0
"E12AS",367,176,"1200x900",600,2,600,400,"True",1033,281,346,65,65,0
"E12AS",368,44,"1200x900",600,0,600,400,"True",305,554,495,-59,59,1
"E12AS",369,323,"1200x900",800,1,600,400,"False",388,348,440,92,92,0
"E12AS",370,495,"1200x900",1000,0,600,400,"True",93,692,677,-15,15,1
"E12AS",371,23,"1200x900",600,0,600,400,"True",308,463,510,47,47,1
"E12AS",372,97,"1200x900",600,1,600,400,"True",760,643,581,-62,62,1
"E12AS",373,234,"1200x900",800,0,600,400,"True",72,344,373,29,29,1
"E12AS",374,377,"1200x900",800,2,600,400,"True",683,388,358,-30,30,0
"E12AS",375,81,"1200x900",600,1,600,400,"False",696,225,303,78,78,0
"E12AS",376,91,"1200x900",600,1,600,400,"True",417,630,584,-46,46,1
"E12AS",377,610,"1200x900",1000,2,600,400,"True",702,293,285,-8,8,0
"E12AS",378,361,"1200x900",800,2,600,400,"False",931,328,257,-71,71,0
"E12AS",379,300,"1200x900",800,1,600,400,"False",620,693,597,-96,96,0
"E12AS",380,141,"1200x900",600,1,600,400,"True",671,582,571,-11,11,0
"E12AS",381,423,"1200x900",800,2,600,400,"True",1051,710,681,-29,29,1
"E12AS",382,386,"1200x900",800,2,600,400,"False",774,301,455,154,154,0
"E12AS",383,238,"1200x900",800,0,600,400,"True",162,283,244,-39,39,1
"E12AS",384,638,"1200x900",1000,2,600,400,"False",385,198,444,246,246,0
"E12AS",385,452,"1200x900",1000,0,600,400,"False",97,273,174,-99,99,1
"E12AS",386,413,"1200x900",800,2,600,400,"True",849,506,515,9,9,0
"E12AS",387,421,"1200x900",800,2,600,400,"False",898,394,260,-134,134,0
"E12AS",388,17,"1200x900",600,0,600,400,"True",402,496,433,-63,63,1
"E12AS",389,583,"1200x900",1000,2,600,400,"False",949,284,218,-66,66,1
"E12AS",390,178,"1200x900",600,2,600,400,"True",1041,510,492,-18,18,0
"E12AS",391,136,"1200x900",600,1,600,400,"True",264,205,250,45,45,0
"E12AS",392,467,"1200x900",1000,0,600,400,"True",74,712,656,-56,56,1
"E12AS",393,309,"1200x900",800,1,600,400,"False",186,225,536,311,311,0
"E12AS",394,382,"1200x900",800,2,600,400,"False",870,523,393,-130,130,0
"E12AS",395,61,"1200x900",600,0,600,400,"False",272,670,515,-155,155,1
"E12AS",396,414,"1200x900",800,2,600,400,"True",831,592,593,1,1,0
"E12AS",397,482,"1200x900",1000,0,600,400,"True",79,686,688,2,2,1
"E12AS",398,557,"1200x900",1000,1,600,400,"True",677,505,501,-4,4,1
"E12AS",399,161,"1200x900",600,2,600,400,"True",939,553,505,-48,48,0
"E12AS",400,126,"1200x900",600,1,600,400,"True",849,354,366,12,12,0
"E12AS",401,18,"1200x900",600,0,600,400,"True",400,318,333,15,15,1
"E12AS",402,634,"1200x900",1000,2,600,400,"False",735,313,421,108,108,0
"E12AS",403,194,"1200x900",600,2,600,400,"True",896,236,295,59,59,0
"E12AS",404,365,"1200x900",800,2,600,400,"False",1055,305,615,310,310,0
"E12AS",405,73,"1200x900",600,1,600,400,"True",94,665,577,-88,88,0
"E12AS",406,5,"1200x900",600,0,600,400,"True",228,587,588,1,1,0
"E12AS",407,24,"1200x900",600,0,600,400,"True",430,538,515,-23,23,1
"E12AS",408,623,"1200x900",1000,2,600,400,"False",636,527,328,-199,199,0
"E12AS",409,517,"1200x900",1000,1,600,400,"True",548,182,208,26,26,0
"E12AS",410,316,"1200x900",800,1,600,400,"False",362,319,395,76,76,0
"E12AS",411,60,"1200x900",600,0,600,400,"True",365,213,166,-47,47,1
"E12AS",412,355,"1200x900",800,1,600,400,"False",77,386,573,187,187,0
"E12AS",413,172,"1200x900",600,2,600,400,"False",912,444,354,-90,90,0
"E12AS",414,263,"1200x900",800,0,600,400,"True",82,396,414,18,18,1
"E12AS",415,545,"1200x900",1000,1,600,400,"True",358,562,521,-41,41,0
"E12AS",416,8,"1200x900",600,0,600,400,"True",156,679,637,-42,42,0
"E12AS",417,523,"1200x900",1000,1,600,400,"False",339,318,456,138,138,0
"E12AS",418,383,"1200x900",800,2,600,400,"False",855,407,514,107,107,0
"E12AS",419,389,"1200x900",800,2,600,400,"False",843,530,372,-158,158,0
"E12AS",420,360,"1200x900",800,1,600,400,"True",203,608,578,-30,30,0
"E12AS",421,45,"1200x900",600,0,600,400,"False",487,678,601,-77,77,1
"E12AS",422,257,"1200x900",800,0,600,400,"True",97,219,191,-28,28,1
"E12AS",423,337,"1200x900",800,1,600,400,"False",299,622,331,-291,291,0
"E12AS",424,353,"1200x900",800,1,600,400,"True",90,476,501,25,25,0
"E12AS",425,145,"1200x900",600,2,600,400,"True",1004,630,655,25,25,0
"E12AS",426,541,"1200x900",1000,1,600,400,"True",339,478,507,29,29,0
"E12AS",427,595,"1200x900",1000,2,600,400,"False",687,640,319,-321,321,0
"E12AS",428,261,"1200x900",800,0,600,400,"True",86,713,733,20,20,1
"E12AS",429,221,"1200x900",800,0,600,400,"True",132,520,540,20,20,1
"E12AS",430,435,"1200x900",1000,0,600,400,"False",119,200,265,65,65,1
"E12AS",431,339,"1200x900",800,1,600,400,"True",273,545,559,14,14,1
"E12AS",432,411,"1200x900",800,2,600,400,"True",805,361,394,33,33,0
"E12AS",433,248,"1200x900",800,0,600,400,"True",94,240,171,-69,69,1
"E12AS",434,39,"1200x900",600,0,600,400,"False",210,609,382,-227,227,0
"E12AS",435,266,"1200x900",800,0,600,400,"False",126,303,169,-134,134,1
"E12AS",436,381,"1200x900",800,2,600,400,"False",705,408,313,-95,95,0
"E12AS",437,206,"1200x900",600,2,600,400,"False",975,223,325,102,102,0
"E12AS",438,630,"1200x900",1000,2,600,400,"True",754,559,566,7,7,0
"E12AS",439,497,"1200x900",1000,0,600,400,"True",106,696,703,7,7,1
"E12AS",440,155,"1200x900",600,2,600,400,"True",940,269,326,57,57,0
"E12AS",441,509,"1200x900",1000,1,600,400,"True",509,434,443,9,9,0
"E12AS",442,26,"1200x900",600,0,600,400,"True",70,712,669,-43,43,0
"E12AS",443,469,"1200x900",1000,0,600,400,"False",73,227,299,72,72,1
"E12AS",444,1,"1200x900",600,0,600,400,"True",136,502,483,-19,19,0
"E12AS",445,515,"1200x900",1000,1,600,400,"False",307,217,410,193,193,0
"E12AS",446,128,"1200x900",600,1,600,400,"False",661,258,368,110,110,1
"E12AS",448,611,"1200x900",1000,2,600,400,"False",414,511,415,-96,96,0
"E12AS",449,247,"1200x900",800,0,600,400,"True",160,424,396,-28,28,1
"E12AS",450,449,"1200x900",1000,0,600,400,"True",105,683,633,-50,50,1
"E12AS",451,184,"1200x900",600,2,600,400,"False",1067,441,572,131,131,0
"E12AS",452,493,"1200x900",1000,0,600,400,"True",80,582,589,7,7,1
"E12AS",453,34,"1200x900",600,0,600,400,"True",361,242,214,-28,28,1
"E12AS",454,472,"1200x900",1000,0,600,400,"True",77,685,628,-57,57,1
"E12AS",455,454,"1200x900",1000,0,600,400,"True",78,687,649,-38,38,1
"E12AS",456,219,"1200x900",800,0,600,400,"True",202,502,458,-44,44,1
"E12AS",457,142,"1200x900",600,1,600,400,"False",286,474,566,92,92,0
"E12AS",458,182,"1200x900",600,2,600,400,"True",933,389,379,-10,10,0
"E12AS",459,432,"1200x900",800,2,600,400,"True",792,380,368,-12,12,0
"E12AS",460,46,"1200x900",600,0,600,400,"True",193,355,353,-2,2,1
"E12AS",461,453,"1200x900",1000,0,600,400,"False",71,393,308,-85,85,1
"E12AS",462,609,"1200x900",1000,2,600,400,"True",697,627,561,-66,66,0
"E12AS",463,301,"1200x900",800,1,600,400,"False",162,574,647,73,73,0
"E12AS",464,147,"1200x900",600,2,600,400,"True",942,418,364,-54,54,0
"E12AS",465,427,"1200x900",800,2,600,400,"True",812,380,381,1,1,0
"E12AS",466,332,"1200x900",800,1,600,400,"False",260,699,364,-335,335,0
"E12AS",467,307,"1200x900",800,1,600,400,"True",716,247,312,65,65,0
"E12AS",468,532,"1200x900",1000,1,600,400,"False",215,207,297,90,90,0
"E12AS",469,198,"1200x900",600,2,600,400,"False",976,500,353,-147,147,0
"E12AS",470,166,"1200x900",600,2,600,400,"False",896,274,381,107,107,0
"E12AS",471,25,"1200x900",600,0,600,400,"True",263,403,367,-36,36,1
"E12AS",472,465,"1200x900",1000,0,600,400,"True",85,203,198,-5,5,1
"E12AS",473,157,"1200x900",600,2,600,400,"False",1016,323,445,122,122,0
"E12AS",474,7,"1200x900",600,0,600,400,"True",431,654,627,-27,27,1
"E12AS",475,143,"1200x900",600,1,600,400,"True",479,284,354,70,70,1
"E12AS",476,115,"1200x900",600,1,600,400,"False",545,307,218,-89,89,0
"E12AS",477,570,"1200x900",1000,1,600,400,"False",315,352,552,200,200,0
"E12AS",478,190,"1200x900",600,2,600,400,"False",977,238,394,156,156,0
"E12AS",479,642,"1200x900",1000,2,600,400,"True",776,316,349,33,33,0
"E12AS",480,212,"1200x900",600,2,600,400,"False",841,206,387,181,181,0
"E12AS",481,396,"1200x900",800,2,600,400,"False",678,663,316,-347,347,0
"E12AS",482,171,"1200x900",600,2,600,400,"False",909,200,425,225,225,0
"E12AS",483,606,"1200x900",1000,2,600,400,"False",653,627,537,-90,90,0
"E12AS",484,424,"1200x900",800,2,600,400,"False",903,545,464,-81,81,0
"E12AS",485,368,"1200x900",800,2,600,400,"True",778,515,485,-30,30,0
"E12AS",486,589,"1200x900",1000,2,600,400,"False",856,418,559,141,141,0
"E12AS",487,620,"1200x900",1000,2,600,400,"False",832,649,225,-424,424,0
"E12AS",488,310,"1200x900",800,1,600,400,"False",559,592,436,-156,156,0
"E12AS",489,213,"1200x900",600,2,600,400,"True",822,275,243,-32,32,0
"E12AS",490,277,"1200x900",800,0,600,400,"True",140,310,297,-13,13,1
"E12AS",491,347,"1200x900",800,1,600,400,"False",757,295,491,196,196,1
"E12AS",492,43,"1200x900",600,0,600,400,"True",277,446,477,31,31,1
"E12AS",493,308,"1200x900",800,1,600,400,"True",437,425,420,-5,5,0
"E12AS",494,592,"1200x900",1000,2,600,400,"True",492,392,403,11,11,0
"E12AS",495,407,"1200x900",800,2,600,400,"True",989,340,321,-19,19,0
"E12AS",496,207,"1200x900",600,2,600,400,"False",838,235,370,135,135,0
"E12AS",497,110,"1200x900",600,1,600,400,"False",776,550,649,99,99,1
"E12AS",498,214,"1200x900",600,2,600,400,"False",1046,305,238,-67,67,0
"E12AS",499,278,"1200x900",800,0,600,400,"False",251,711,618,-93,93,1
"E12AS",500,401,"1200x900",800,2,600,400,"True",821,260,317,57,57,0
"E12AS",501,299,"1200x900",800,1,600,400,"False",779,274,514,240,240,0
"E12AS",502,168,"1200x900",600,2,600,400,"False",1001,439,334,-105,105,0
"E12AS",503,448,"1200x900",1000,0,600,400,"False",107,641,466,-175,175,1
"E12AS",504,269,"1200x900",800,0,600,400,"True",160,295,294,-1,1,1
"E12AS",505,287,"1200x900",800,0,600,400,"True",120,567,577,10,10,1
"E12AS",506,428,"1200x900",800,2,600,400,"False",732,665,540,-125,125,0
"E12AS",507,102,"1200x900",600,1,600,400,"True",861,603,597,-6,6,0
"E12AS",508,259,"1200x900",800,0,600,400,"False",156,180,318,138,138,1
"E12AS",509,153,"1200x900",600,2,600,400,"True",1037,601,627,26,26,0
"E12AS",510,409,"1200x900",800,2,600,400,"True",501,659,615,-44,44,0
"E12AS",511,571,"1200x900",1000,1,600,400,"True",239,522,577,55,55,1
"E12AS",512,275,"1200x900",800,0,600,400,"True",120,594,610,16,16,0
"E12AS",513,403,"1200x900",800,2,600,400,"False",625,704,569,-135,135,0
"E12AS",514,312,"1200x900",800,1,600,400,"True",238,683,664,-19,19,0
"E12AS",515,125,"1200x900",600,1,600,400,"True",750,531,542,11,11,0
"E12AS",516,455,"1200x900",1000,0,600,400,"False",107,718,627,-91,91,1
"E12AS",517,246,"1200x900",800,0,600,400,"True",196,418,457,39,39,1
"E12AS",518,622,"1200x900",1000,2,600,400,"False",307,683,506,-177,177,0
"E12AS",519,12,"1200x900",600,0,600,400,"True",365,336,377,41,41,1
"E12AS",520,628,"1200x900",1000,2,600,400,"True",768,410,442,32,32,0
"E12AS",521,47,"1200x900",600,0,600,400,"True",303,499,455,-44,44,1
"E12AS",522,450,"1200x900",1000,0,600,400,"False",130,204,331,127,127,1
"E12AS",523,644,"1200x900",1000,2,600,400,"True",495,486,525,39,39,0
"E12AS",524,274,"1200x900",800,0,600,400,"True",146,497,508,11,11,1
"E12AS",525,600,"1200x900",1000,2,600,400,"False",765,207,343,136,136,0
"E12AS",526,256,"1200x900",800,0,600,400,"True",192,656,650,-6,6,1
"E12AS",527,135,"1200x900",600,1,600,400,"True",759,569,619,50,50,0
"E12AS",528,512,"1200x900",1000,1,600,400,"False",139,261,511,250,250,0
"E12AS",529,494,"1200x900",1000,0,600,400,"True",127,692,697,5,5,1
"E12AS",530,350,"1200x900",800,1,600,400,"False",182,566,502,-64,64,0
"E12AS",531,641,"1200x900",1000,2,600,400,"True",897,272,198,-74,74,0
"E12AS",532,41,"1200x900",600,0,600,400,"True",370,452,479,27,27,1
"E12AS",533,522,"1200x900",1000,1,600,400,"False",223,379,180,-199,199,0
"E12AS",534,530,"1200x900",1000,1,600,400,"True",584,405,455,50,50,1
"E12AS",535,68,"1200x900",600,0,600,400,"True",165,367,409,42,42,0
"E12AS",536,106,"1200x900",600,1,600,400,"False",803,659,456,-203,203,1
"E12AS",537,21,"1200x900",600,0,600,400,"True",314,383,403,20,20,1
"E12AS",538,373,"1200x900",800,2,600,400,"True",694,326,386,60,60,0
"E12AS",539,53,"1200x900",600,0,600,400,"True",177,189,170,-19,19,0
"E12AS",540,388,"1200x900",800,2,600,400,"False",930,320,534,214,214,0
"E12AS",541,187,"1200x900",600,2,600,400,"False",857,639,415,-224,224,0
"E12AS",542,618,"1200x900",1000,2,600,400,"False",276,671,572,-99,99,0
"E12AS",543,241,"1200x900",800,0,600,400,"True",129,227,267,40,40,1
"E12AS",544,2,"1200x900",600,0,600,400,"True",159,323,335,12,12,0
"E12AS",545,63,"1200x900",600,0,600,400,"True",311,188,216,28,28,1
"E12AS",546,177,"1200x900",600,2,600,400,"False",912,236,395,159,159,0
"E12AS",547,306,"1200x900",800,1,600,400,"False",164,524,585,61,61,0
"E12AS",548,553,"1200x900",1000,1,600,400,"False",116,712,425,-287,287,0
"E12AS",549,107,"1200x900",600,1,600,400,"True",878,678,671,-7,7,0
"E12AS",550,563,"1200x900",1000,1,600,400,"True",201,696,693,-3,3,0
"E12AS",551,342,"1200x900",800,1,600,400,"False",677,204,330,126,126,0
"E12AS",552,231,"1200x900",800,0,600,400,"True",251,718,668,-50,50,1
"E12AS",553,150,"1200x900",600,2,600,400,"True",897,345,425,80,80,0
"E12AS",554,546,"1200x900",1000,1,600,400,"True",305,374,409,35,35,0
"E12AS",555,151,"1200x900",600,2,600,400,"False",828,680,540,-140,140,0
"E12AS",556,625,"1200x900",1000,2,600,400,"False",279,228,488,260,260,0
"E12AS",557,564,"1200x900",1000,1,600,400,"True",215,264,332,68,68,0
"E12AS",558,156,"1200x900",600,2,600,400,"False",913,197,341,144,144,0
"E12AS",559,387,"1200x900",800,2,600,400,"True",990,444,391,-53,53,0
"E12AS",560,513,"1200x900",1000,1,600,400,"False",235,602,540,-62,62,0
"E12AS",561,22,"1200x900",600,0,600,400,"True",398,591,594,3,3,1
"E12AS",562,614,"1200x900",1000,2,600,400,"True",823,563,565,2,2,0
"E12AS",563,294,"1200x900",800,1,600,400,"False",262,287,554,267,267,0
"E12AS",564,54,"1200x900",600,0,600,400,"False",474,564,659,95,95,1
"E12AS",565,521,"1200x900",1000,1,600,400,"True",111,303,357,54,54,1
"E12AS",566,405,"1200x900",800,2,600,400,"False",790,307,457,150,150,0
"E12AS",567,31,"1200x900",600,0,600,400,"True",365,338,374,36,36,1
"E12AS",568,345,"1200x900",800,1,600,400,"False",841,566,671,105,105,1
"E12AS",569,3,"1200x900",600,0,600,400,"True",298,443,411,-32,32,1
"E12AS",570,295,"1200x900",800,1,600,400,"True",471,334,347,13,13,0
"E12AS",571,112,"1200x900",600,1,600,400,"False",681,490,309,-181,181,0
"E12AS",572,245,"1200x900",800,0,600,400,"True",296,235,190,-45,45,1
"E12AS",573,576,"1200x900",1000,1,600,400,"True",376,713,694,-19,19,0
"E12AS",574,27,"1200x900",600,0,600,400,"True",373,309,266,-43,43,1
"E12AS",575,392,"1200x900",800,2,600,400,"True",1031,618,619,1,1,0
"E12AS",576,637,"1200x900",1000,2,600,400,"True",750,460,515,55,55,0
"E12AS",577,180,"1200x900",600,2,600,400,"False",929,270,366,96,96,0
"E12AS",578,251,"1200x900",800,0,600,400,"True",88,352,297,-55,55,1
"E12AS",579,78,"1200x900",600,1,600,400,"True",885,684,587,-97,97,0
"E12AS",580,264,"1200x900",800,0,600,400,"True",198,660,677,17,17,1
"E12AS",581,66,"1200x900",600,0,600,400,"True",155,673,628,-45,45,0
"E12AS",582,374,"1200x900",800,2,600,400,"False",755,450,650,200,200,0
"E12AS",583,587,"1200x900",1000,2,600,400,"False",741,686,439,-247,247,0
"E12AS",584,492,"1200x900",1000,0,600,400,"True",76,692,730,38,38,1
"E12AS",585,258,"1200x900",800,0,600,400,"False",126,664,600,-64,64,1
"E12AS",586,631,"1200x900",1000,2,600,400,"False",699,479,700,221,221,0
"E12AS",587,349,"1200x900",800,1,600,400,"True",402,665,687,22,22,0
"E12AS",588,505,"1200x900",1000,1,600,400,"False",191,484,411,-73,73,1
"E12AS",589,67,"1200x900",600,0,600,400,"True",289,308,323,15,15,1
"E12AS",590,384,"1200x900",800,2,600,400,"False",821,707,558,-149,149,0
"E12AS",591,385,"1200x900",800,2,600,400,"False",740,456,643,187,187,0
"E12AS",592,429,"1200x900",800,2,600,400,"True",682,692,618,-74,74,0
"E12AS",593,222,"1200x900",800,0,600,400,"True",152,206,183,-23,23,1
"E12AS",594,542,"1200x900",1000,1,600,400,"False",304,401,564,163,163,0
"E12AS",595,528,"1200x900",1000,1,600,400,"False",839,227,497,270,270,1
"E12AS",596,76,"1200x900",600,1,600,400,"False",647,614,418,-196,196,0
"E12AS",597,547,"1200x900",1000,1,600,400,"False",369,384,558,174,174,1
"E12AS",598,648,"1200x900",1000,2,600,400,"True",557,394,417,23,23,0
"E12AS",599,30,"1200x900",600,0,600,400,"True",107,353,358,5,5,0
"E12AS",600,366,"1200x900",800,2,600,400,"False",931,464,224,-240,240,0
"E12AS",601,586,"1200x900",1000,2,600,400,"False",802,262,453,191,191,0
"E12AS",602,462,"1200x900",1000,0,600,400,"True",102,672,612,-60,60,1
"E12AS",603,379,"1200x900",800,2,600,400,"False",994,325,479,154,154,0
"E12AS",604,321,"1200x900",800,1,600,400,"False",601,190,365,175,175,0
"E12AS",605,518,"1200x900",1000,1,600,400,"False",583,717,577,-140,140,0
"E12AS",606,574,"1200x900",1000,1,600,400,"False",614,194,384,190,190,0
"E12AS",607,205,"1200x900",600,2,600,400,"False",1021,504,613,109,109,0
"E12AS",608,228,"1200x900",800,0,600,400,"True",174,687,711,24,24,1
"E12AS",609,119,"1200x900",600,1,600,400,"False",168,563,637,74,74,0
"E12AS",610,103,"1200x900",600,1,600,400,"False",528,320,209,-111,111,1
"E12AS",611,15,"1200x900",600,0,600,400,"True",473,352,370,18,18,1
"E12AS",612,434,"1200x900",1000,0,600,400,"True",89,657,612,-45,45,1
"E12AS",613,188,"1200x900",600,2,600,400,"False",900,195,550,355,355,0
"E12AS",614,283,"1200x900",800,0,600,400,"True",90,264,321,57,57,1
"E12AS",615,402,"1200x900",800,2,600,400,"True",878,234,297,63,63,0
"E12AS",616,445,"1200x900",1000,0,600,400,"False",78,302,474,172,172,1
"E12AS",617,57,"1200x900",600,0,600,400,"True",354,508,493,-15,15,1
"E12AS",618,579,"1200x900",1000,2,600,400,"False",803,394,463,69,69,0
"E12AS",619,268,"1200x900",800,0,600,400,"True",148,400,431,31,31,1
"E12AS",620,193,"1200x900",600,2,600,400,"True",874,588,532,-56,56,0
"E12AS",621,305,"1200x900",800,1,600,400,"True",471,716,674,-42,42,0
"E12AS",622,516,"1200x900",1000,1,600,400,"False",440,559,647,88,88,0
"E12AS",623,249,"1200x900",800,0,600,400,"True",126,306,340,34,34,1
"E12AS",624,72,"1200x900",600,0,600,400,"True",158,537,537,0,0,0
"E12AS",625,284,"1200x900",800,0,600,400,"True",135,293,341,48,48,1
"E12AS",626,357,"1200x900",800,1,600,400,"True",109,594,548,-46,46,0
"E12AS",627,608,"1200x900",1000,2,600,400,"False",742,250,595,345,345,0
"E12AS",628,59,"1200x900",600,0,600,400,"True",391,692,699,7,7,1
"E12AS",629,500,"1200x900",1000,0,600,400,"True",105,700,652,-48,48,1
"E12AS",630,408,"1200x900",800,2,600,400,"True",758,567,600,33,33,0
"E12AS",631,50,"1200x900",600,0,600,400,"True",75,582,628,46,46,0
"E12AS",632,370,"1200x900",800,2,600,400,"True",874,336,349,13,13,0
"E12AS",633,109,"1200x900",600,1,600,400,"True",691,589,616,27,27,0
"E12AS",634,120,"1200x900",600,1,600,400,"True",690,655,605,-50,50,0
"E12AS",635,544,"1200x900",1000,1,600,400,"True",602,620,578,-42,42,0
"E12AS",636,200,"1200x900",600,2,600,400,"False",897,302,410,108,108,0
"E12AS",637,352,"1200x900",800,1,600,400,"True",235,717,694,-23,23,0
"E12AS",638,42,"1200x900",600,0,600,400,"True",233,479,500,21,21,0
"E12AS",639,282,"1200x900",800,0,600,400,"True",109,246,288,42,42,1
"E12AS",640,290,"1200x900",800,1,600,400,"True",789,603,548,-55,55,0
"E12AS",641,74,"1200x900",600,1,600,400,"False",115,358,257,-101,101,0
"E12AS",642,208,"1200x900",600,2,600,400,"False",946,399,569,170,170,0
"E12AS",643,338,"1200x900",800,1,600,400,"True",813,253,270,17,17,1
"E12AS",644,327,"1200x900",800,1,600,400,"True",152,339,425,86,86,0
"E12AS",645,346,"1200x900",800,1,600,400,"False",269,635,287,-348,348,0
"E12AS",646,436,"1200x900",1000,0,600,400,"True",82,617,674,57,57,1
"E12AS",647,520,"1200x900",1000,1,600,400,"False",564,260,386,126,126,0
"E12AS",648,364,"1200x900",800,2,600,400,"False",1018,204,508,304,304,0
"E13MH",1,130,"1200x900",600,1,600,400,"True",741,428,457,29,29,0
"E13MH",2,605,"1200x900",1000,2,600,400,"False",493,665,552,-113,113,0
"E13MH",3,238,"1200x900",800,0,600,400,"False",162,283,381,98,98,1
"E13MH",4,622,"1200x900",1000,2,600,400,"False",307,683,596,-87,87,0
"E13MH",5,321,"1200x900",800,1,600,400,"True",601,190,193,3,3,0
"E13MH",6,336,"1200x900",800,1,600,400,"False",251,587,674,87,87,0
"E13MH",7,627,"1200x900",1000,2,600,400,"True",760,510,541,31,31,0
"E13MH",8,149,"1200x900",600,2,600,400,"True",890,289,341,52,52,0
"E13MH",9,377,"1200x900",800,2,600,400,"True",683,388,367,-21,21,0
"E13MH",10,470,"1200x900",1000,0,600,400,"False",91,666,417,-249,249,1
"E13MH",11,480,"1200x900",1000,0,600,400,"False",100,231,433,202,202,1
"E13MH",12,69,"1200x900",600,0,600,400,"True",322,268,219,-49,49,0
"E13MH",13,252,"1200x900",800,0,600,400,"False",224,673,545,-128,128,1
"E13MH",14,41,"1200x900",600,0,600,400,"True",370,452,441,-11,11,1
"E13MH",15,66,"1200x900",600,0,600,400,"True",155,673,656,-17,17,0
"E13MH",16,590,"1200x900",1000,2,600,400,"False",636,278,494,216,216,0
"E13MH",17,370,"1200x900",800,2,600,400,"False",874,336,456,120,120,0
"E13MH",18,459,"1200x900",1000,0,600,400,"False",70,645,554,-91,91,1
"E13MH",19,8,"1200x900",600,0,600,400,"True",156,679,652,-27,27,0
"E13MH",20,518,"1200x900",1000,1,600,400,"True",583,717,695,-22,22,0
"E13MH",21,597,"1200x900",1000,2,600,400,"False",352,239,612,373,373,0
"E13MH",22,65,"1200x900",600,0,600,400,"False",442,645,536,-109,109,1
"E13MH",23,342,"1200x900",800,1,600,400,"True",677,204,240,36,36,0
"E13MH",24,42,"1200x900",600,0,600,400,"True",233,479,444,-35,35,0
"E13MH",25,526,"1200x900",1000,1,600,400,"False",497,710,505,-205,205,0
"E13MH",26,379,"1200x900",800,2,600,400,"False",994,325,570,245,245,0
"E13MH",27,360,"1200x900",800,1,600,400,"False",203,608,764,156,156,0
"E13MH",28,543,"1200x900",1000,1,600,400,"False",88,202,603,401,401,0
"E13MH",29,578,"1200x900",1000,2,600,400,"True",966,276,287,11,11,0
"E13MH",30,215,"1200x900",600,2,600,400,"False",939,596,480,-116,116,0
"E13MH",31,621,"1200x900",1000,2,600,400,"False",540,478,668,190,190,0
"E13MH",32,391,"1200x900",800,2,600,400,"True",895,521,552,31,31,0
"E13MH",33,100,"1200x900",600,1,600,400,"True",453,511,458,-53,53,0
"E13MH",34,547,"1200x900",1000,1,600,400,"True",369,384,425,41,41,1
"E13MH",35,395,"1200x900",800,2,600,400,"True",743,334,357,23,23,0
"E13MH",36,603,"1200x900",1000,2,600,400,"False",693,280,457,177,177,0
"E13MH",37,185,"1200x900",600,2,600,400,"True",907,212,291,79,79,0
"E13MH",38,500,"1200x900",1000,0,600,400,"False",105,700,407,-293,293,1
"E13MH",39,95,"1200x900",600,1,600,400,"False",749,425,288,-137,137,1
"E13MH",40,37,"1200x900",600,0,600,400,"True",258,403,386,-17,17,1
"E13MH",41,598,"1200x900",1000,2,600,400,"False",706,559,405,-154,154,0
"E13MH",42,374,"1200x900",800,2,600,400,"False",755,450,563,113,113,0
"E13MH",43,542,"1200x900",1000,1,600,400,"False",304,401,321,-80,80,0
"E13MH",44,347,"1200x900",800,1,600,400,"False",757,295,623,328,328,1
"E13MH",45,314,"1200x900",800,1,600,400,"False",277,616,749,133,133,1
"E13MH",46,382,"1200x900",800,2,600,400,"False",870,523,617,94,94,0
"E13MH",47,647,"1200x900",1000,2,600,400,"False",560,637,343,-294,294,0
"E13MH",48,371,"1200x900",800,2,600,400,"True",730,560,487,-73,73,0
"E13MH",49,433,"1200x900",1000,0,600,400,"False",76,222,396,174,174,1
"E13MH",50,524,"1200x900",1000,1,600,400,"False",534,470,601,131,131,0
"E13MH",51,600,"1200x900",1000,2,600,400,"True",765,207,197,-10,10,0
"E13MH",52,3,"1200x900",600,0,600,400,"False",298,443,337,-106,106,1
"E13MH",53,633,"1200x900",1000,2,600,400,"True",564,253,186,-67,67,0
"E13MH",54,19,"1200x900",600,0,600,400,"False",286,686,605,-81,81,0
"E13MH",55,501,"1200x900",1000,0,600,400,"False",96,323,523,200,200,1
"E13MH",56,126,"1200x900",600,1,600,400,"False",849,354,449,95,95,0
"E13MH",57,629,"1200x900",1000,2,600,400,"False",681,257,134,-123,123,0
"E13MH",58,266,"1200x900",800,0,600,400,"True",126,303,273,-30,30,1
"E13MH",59,367,"1200x900",800,2,600,400,"False",613,464,369,-95,95,0
"E13MH",60,313,"1200x900",800,1,600,400,"True",588,421,367,-54,54,0
"E13MH",61,323,"1200x900",800,1,600,400,"False",388,348,580,232,232,0
"E13MH",62,224,"1200x900",800,0,600,400,"True",161,474,504,30,30,1
"E13MH",63,33,"1200x900",600,0,600,400,"True",198,533,501,-32,32,1
"E13MH",64,331,"1200x900",800,1,600,400,"True",240,620,653,33,33,0
"E13MH",65,77,"1200x900",600,1,600,400,"False",780,525,383,-142,142,0
"E13MH",66,246,"1200x900",800,0,600,400,"True",196,418,427,9,9,1
"E13MH",67,577,"1200x900",1000,2,600,400,"False",455,420,582,162,162,0
"E13MH",68,567,"1200x900",1000,1,600,400,"True",655,297,358,61,61,1
"E13MH",69,606,"1200x900",1000,2,600,400,"False",653,627,367,-260,260,0
"E13MH",70,289,"1200x900",800,1,600,400,"True",421,703,691,-12,12,1
"E13MH",71,490,"1200x900",1000,0,600,400,"False",114,183,283,100,100,1
"E13MH",72,619,"1200x900",1000,2,600,400,"False",803,247,381,134,134,0
"E13MH",73,181,"1200x900",600,2,600,400,"False",1018,223,520,297,297,0
"E13MH",74,586,"1200x900",1000,2,600,400,"False",802,262,426,164,164,0
"E13MH",75,307,"1200x900",800,1,600,400,"True",716,247,227,-20,20,0
"E13MH",76,320,"1200x900",800,1,600,400,"True",644,376,340,-36,36,0
"E13MH",77,85,"1200x900",600,1,600,400,"False",434,347,660,313,313,0
"E13MH",78,475,"1200x900",1000,0,600,400,"False",101,715,623,-92,92,1
"E13MH",79,458,"1200x900",1000,0,600,400,"True",78,624,659,35,35,1
"E13MH",80,221,"1200x900",800,0,600,400,"True",132,520,459,-61,61,1
"E13MH",81,641,"1200x900",1000,2,600,400,"True",897,272,265,-7,7,0
"E13MH",82,188,"1200x900",600,2,600,400,"False",900,195,332,137,137,0
"E13MH",83,285,"1200x900",800,0,600,400,"False",237,396,202,-194,194,1
"E13MH",84,277,"1200x900",800,0,600,400,"True",140,310,275,-35,35,1
"E13MH",85,599,"1200x900",1000,2,600,400,"False",316,570,365,-205,205,0
"E13MH",86,328,"1200x900",800,1,600,400,"True",104,649,694,45,45,0
"E13MH",87,592,"1200x900",1000,2,600,400,"True",492,392,448,56,56,0
"E13MH",88,170,"1200x900",600,2,600,400,"True",996,468,547,79,79,0
"E13MH",89,153,"1200x900",600,2,600,400,"True",1037,601,524,-77,77,0
"E13MH",90,251,"1200x900",800,0,600,400,"True",88,352,413,61,61,1
"E13MH",91,190,"1200x900",600,2,600,400,"False",977,238,390,152,152,0
"E13MH",92,247,"1200x900",800,0,600,400,"False",160,424,512,88,88,1
"E13MH",93,48,"1200x900",600,0,600,400,"True",323,645,605,-40,40,1
"E13MH",94,386,"1200x900",800,2,600,400,"False",774,301,397,96,96,0
"E13MH",95,460,"1200x900",1000,0,600,400,"False",155,189,303,114,114,1
"E13MH",96,245,"1200x900",800,0,600,400,"True",296,235,260,25,25,1
"E13MH",97,306,"1200x900",800,1,600,400,"False",164,524,713,189,189,0
"E13MH",98,467,"1200x900",1000,0,600,400,"True",74,712,652,-60,60,1
"E13MH",99,288,"1200x900",800,0,600,400,"False",180,547,628,81,81,1
"E13MH",100,242,"1200x900",800,0,600,400,"True",117,448,446,-2,2,1
"E13MH",101,172,"1200x900",600,2,600,400,"True",912,444,439,-5,5,0
"E13MH",102,636,"1200x900",1000,2,600,400,"True",575,583,526,-57,57,0
"E13MH",103,21,"1200x900",600,0,600,400,"True",314,383,431,48,48,1
"E13MH",104,443,"1200x900",1000,0,600,400,"False",99,651,481,-170,170,1
"E13MH",105,147,"1200x900",600,2,600,400,"True",942,418,506,88,88,0
"E13MH",106,512,"1200x900",1000,1,600,400,"True",139,261,292,31,31,0
"E13MH",107,401,"1200x900",800,2,600,400,"True",821,260,343,83,83,0
"E13MH",108,212,"1200x900",600,2,600,400,"True",841,206,266,60,60,0
"E13MH",109,283,"1200x900",800,0,600,400,"False",90,264,193,-71,71,1
"E13MH",110,296,"1200x900",800,1,600,400,"False",89,279,155,-124,124,0
"E13MH",111,204,"1200x900",600,2,600,400,"False",1053,432,251,-181,181,0
"E13MH",112,155,"1200x900",600,2,600,400,"False",940,269,186,-83,83,0
"E13MH",113,483,"1200x900",1000,0,600,400,"True",93,191,184,-7,7,1
"E13MH",114,67,"1200x900",600,0,600,400,"True",289,308,325,17,17,1
"E13MH",115,2,"1200x900",600,0,600,400,"True",159,323,303,-20,20,0
"E13MH",116,38,"1200x900",600,0,600,400,"True",120,628,656,28,28,1
"E13MH",117,11,"1200x900",600,0,600,400,"True",372,670,622,-48,48,1
"E13MH",118,455,"1200x900",1000,0,600,400,"False",107,718,612,-106,106,1
"E13MH",119,640,"1200x900",1000,2,600,400,"False",361,334,483,149,149,0
"E13MH",120,59,"1200x900",600,0,600,400,"True",391,692,667,-25,25,1
"E13MH",121,624,"1200x900",1000,2,600,400,"True",693,501,454,-47,47,0
"E13MH",122,132,"1200x900",600,1,600,400,"False",333,185,58,-127,127,0
"E13MH",123,272,"1200x900",800,0,600,400,"True",200,181,232,51,51,1
"E13MH",124,124,"1200x900",600,1,600,400,"False",345,467,270,-197,197,0
"E13MH",125,264,"1200x900",800,0,600,400,"False",198,660,575,-85,85,1
"E13MH",126,195,"1200x900",600,2,600,400,"False",942,249,393,144,144,0
"E13MH",127,193,"1200x900",600,2,600,400,"True",874,588,615,27,27,0
"E13MH",128,207,"1200x900",600,2,600,400,"True",838,235,305,70,70,0
"E13MH",129,388,"1200x900",800,2,600,400,"False",930,320,444,124,124,0
"E13MH",130,355,"1200x900",800,1,600,400,"False",77,386,607,221,221,0
"E13MH",131,635,"1200x900",1000,2,600,400,"False",833,402,514,112,112,0
"E13MH",132,396,"1200x900",800,2,600,400,"True",678,663,636,-27,27,0
"E13MH",133,261,"1200x900",800,0,600,400,"True",86,713,722,9,9,1
"E13MH",134,259,"1200x900",800,0,600,400,"False",156,180,307,127,127,1
"E13MH",135,75,"1200x900",600,1,600,400,"True",635,558,537,-21,21,0
"E13MH",136,589,"1200x900",1000,2,600,400,"False",856,418,486,68,68,0
"E13MH",137,35,"1200x900",600,0,600,400,"True",366,555,524,-31,31,1
"E13MH",138,358,"1200x900",800,1,600,400,"False",263,635,346,-289,289,0
"E13MH",139,630,"1200x900",1000,2,600,400,"True",754,559,492,-67,67,0
"E13MH",140,551,"1200x900",1000,1,600,400,"False",146,445,245,-200,200,1
"E13MH",141,344,"1200x900",800,1,600,400,"True",589,408,385,-23,23,0
"E13MH",142,420,"1200x900",800,2,600,400,"True",519,223,267,44,44,0
"E13MH",143,338,"1200x900",800,1,600,400,"False",813,253,344,91,91,1
"E13MH",144,402,"1200x900",800,2,600,400,"True",878,234,294,60,60,0
"E13MH",145,200,"1200x900",600,2,600,400,"True",897,302,290,-12,12,0
"E13MH",146,324,"1200x900",800,1,600,400,"True",719,712,679,-33,33,1
"E13MH",147,353,"1200x900",800,1,600,400,"True",90,476,519,43,43,0
"E13MH",148,322,"1200x900",800,1,600,400,"False",703,206,399,193,193,1
"E13MH",149,557,"1200x900",1000,1,600,400,"False",677,505,672,167,167,1
"E13MH",150,410,"1200x900",800,2,600,400,"False",916,477,331,-146,146,0
"E13MH",151,536,"1200x900",1000,1,600,400,"True",580,213,227,14,14,0
"E13MH",152,403,"1200x900",800,2,600,400,"True",625,704,636,-68,68,0
"E13MH",153,81,"1200x900",600,1,600,400,"False",696,225,310,85,85,0
"E13MH",154,187,"1200x900",600,2,600,400,"False",857,639,477,-162,162,0
"E13MH",155,397,"1200x900",800,2,600,400,"True",817,692,632,-60,60,0
"E13MH",156,560,"1200x900",1000,1,600,400,"False",516,693,496,-197,197,0
"E13MH",157,220,"1200x900",800,0,600,400,"True",108,699,680,-19,19,1
"E13MH",158,40,"1200x900",600,0,600,400,"True",143,513,524,11,11,0
"E13MH",159,276,"1200x900",800,0,600,400,"False",281,217,281,64,64,1
"E13MH",160,615,"1200x900",1000,2,600,400,"False",736,634,519,-115,115,0
"E13MH",161,141,"1200x900",600,1,600,400,"True",671,582,665,83,83,0
"E13MH",162,258,"1200x900",800,0,600,400,"False",126,664,546,-118,118,1
"E13MH",163,28,"1200x900",600,0,600,400,"True",336,410,372,-38,38,1
"E13MH",164,364,"1200x900",800,2,600,400,"False",1018,204,406,202,202,0
"E13MH",165,231,"1200x900",800,0,600,400,"False",251,718,578,-140,140,1
"E13MH",166,416,"1200x900",800,2,600,400,"False",748,617,524,-93,93,0
"E13MH",167,128,"1200x900",600,1,600,400,"False",661,258,152,-106,106,1
"E13MH",168,123,"1200x900",600,1,600,400,"False",761,365,306,-59,59,1
"E13MH",169,107,"1200x900",600,1,600,400,"False",878,678,611,-67,67,0
"E13MH",170,84,"1200x900",600,1,600,400,"True",144,184,151,-33,33,0
"E13MH",171,89,"1200x900",600,1,600,400,"True",917,366,393,27,27,1
"E13MH",172,508,"1200x900",1000,1,600,400,"True",596,485,465,-20,20,0
"E13MH",173,45,"1200x900",600,0,600,400,"True",487,678,623,-55,55,1
"E13MH",174,378,"1200x900",800,2,600,400,"False",1018,708,513,-195,195,0
"E13MH",175,325,"1200x900",800,1,600,400,"False",105,394,246,-148,148,0
"E13MH",176,29,"1200x900",600,0,600,400,"True",385,533,491,-42,42,1
"E13MH",177,424,"1200x900",800,2,600,400,"True",903,545,548,3,3,0
"E13MH",178,482,"1200x900",1000,0,600,400,"False",79,686,526,-160,160,1
"E13MH",179,99,"1200x900",600,1,600,400,"True",811,407,432,25,25,0
"E13MH",180,417,"1200x900",800,2,600,400,"False",750,280,340,60,60,0
"E13MH",181,176,"1200x900",600,2,600,400,"False",1033,281,215,-66,66,0
"E13MH",182,274,"1200x900",800,0,600,400,"False",146,497,411,-86,86,1
"E13MH",183,428,"1200x900",800,2,600,400,"True",732,665,635,-30,30,0
"E13MH",184,489,"1200x900",1000,0,600,400,"False",88,604,466,-138,138,1
"E13MH",185,5,"1200x900",600,0,600,400,"True",228,587,539,-48,48,0
"E13MH",186,538,"1200x900",1000,1,600,400,"False",308,457,221,-236,236,1
"E13MH",187,357,"1200x900",800,1,600,400,"True",109,594,626,32,32,0
"E13MH",188,503,"1200x900",1000,0,600,400,"True",86,279,269,-10,10,1
"E13MH",189,556,"1200x900",1000,1,600,400,"False",415,420,590,170,170,0
"E13MH",190,86,"1200x900",600,1,600,400,"False",692,388,239,-149,149,1
"E13MH",191,525,"1200x900",1000,1,600,400,"False",123,690,408,-282,282,0
"E13MH",192,461,"1200x900",1000,0,600,400,"False",95,711,645,-66,66,1
"E13MH",193,626,"1200x900",1000,2,600,400,"True",329,449,436,-13,13,0
"E13MH",194,232,"1200x900",800,0,600,400,"False",84,511,431,-80,80,1
"E13MH",195,523,"1200x900",1000,1,600,400,"True",339,318,323,5,5,0
"E13MH",196,70,"1200x900",600,0,600,400,"False",309,703,624,-79,79,1
"E13MH",197,400,"1200x900",800,2,600,400,"True",733,297,343,46,46,0
"E13MH",198,213,"1200x900",600,2,600,400,"True",822,275,285,10,10,0
"E13MH",199,327,"1200x900",800,1,600,400,"False",152,339,199,-140,140,0
"E13MH",200,334,"1200x900",800,1,600,400,"False",481,665,575,-90,90,0
"E13MH",201,131,"1200x900",600,1,600,400,"False",531,367,647,280,280,0
"E13MH",202,237,"1200x900",800,0,600,400,"True",204,481,443,-38,38,1
"E13MH",203,409,"1200x900",800,2,600,400,"True",501,659,614,-45,45,0
"E13MH",204,333,"1200x900",800,1,600,400,"False",521,548,679,131,131,0
"E13MH",205,346,"1200x900",800,1,600,400,"True",269,635,650,15,15,0
"E13MH",206,175,"1200x900",600,2,600,400,"False",1028,432,233,-199,199,0
"E13MH",207,308,"1200x900",800,1,600,400,"True",437,425,354,-71,71,0
"E13MH",208,473,"1200x900",1000,0,600,400,"True",75,323,262,-61,61,1
"E13MH",209,594,"1200x900",1000,2,600,400,"False",537,637,417,-220,220,0
"E13MH",210,226,"1200x900",800,0,600,400,"True",187,229,197,-32,32,1
"E13MH",212,345,"1200x900",800,1,600,400,"False",841,566,703,137,137,1
"E13MH",213,373,"1200x900",800,2,600,400,"False",694,326,402,76,76,0
"E13MH",214,550,"1200x900",1000,1,600,400,"True",301,459,450,-9,9,0
"E13MH",215,426,"1200x900",800,2,600,400,"True",830,263,326,63,63,0
"E13MH",216,103,"1200x900",600,1,600,400,"True",528,320,259,-61,61,1
"E13MH",217,88,"1200x900",600,1,600,400,"True",186,554,532,-22,22,0
"E13MH",218,527,"1200x900",1000,1,600,400,"False",565,601,456,-145,145,0
"E13MH",219,535,"1200x900",1000,1,600,400,"False",372,410,481,71,71,0
"E13MH",220,290,"1200x900",800,1,600,400,"True",789,603,657,54,54,0
"E13MH",221,494,"1200x900",1000,0,600,400,"False",127,692,475,-217,217,1
"E13MH",222,447,"1200x900",1000,0,600,400,"True",71,339,358,19,19,1
"E13MH",223,271,"1200x900",800,0,600,400,"True",74,360,336,-24,24,1
"E13MH",224,639,"1200x900",1000,2,600,400,"False",504,456,593,137,137,0
"E13MH",225,183,"1200x900",600,2,600,400,"True",927,289,272,-17,17,0
"E13MH",226,144,"1200x900",600,1,600,400,"True",718,371,337,-34,34,0
"E13MH",227,541,"1200x900",1000,1,600,400,"True",339,478,472,-6,6,0
"E13MH",228,250,"1200x900",800,0,600,400,"False",290,248,315,67,67,1
"E13MH",229,517,"1200x900",1000,1,600,400,"True",548,182,197,15,15,0
"E13MH",230,254,"1200x900",800,0,600,400,"False",136,583,481,-102,102,1
"E13MH",231,530,"1200x900",1000,1,600,400,"True",584,405,389,-16,16,1
"E13MH",232,472,"1200x900",1000,0,600,400,"True",77,685,656,-29,29,1
"E13MH",233,260,"1200x900",800,0,600,400,"True",103,525,478,-47,47,1
"E13MH",234,479,"1200x900",1000,0,600,400,"False",74,705,548,-157,157,1
"E13MH",235,163,"1200x900",600,2,600,400,"False",1046,665,506,-159,159,0
"E13MH",236,528,"1200x900",1000,1,600,400,"False",839,227,477,250,250,1
"E13MH",237,356,"1200x900",800,1,600,400,"False",123,484,629,145,145,0
"E13MH",238,354,"1200x900",800,1,600,400,"True",118,236,221,-15,15,0
"E13MH",239,292,"1200x900",800,1,600,400,"False",88,565,639,74,74,0
"E13MH",240,112,"1200x900",600,1,600,400,"False",681,490,257,-233,233,0
"E13MH",241,49,"1200x900",600,0,600,400,"True",109,380,341,-39,39,0
"E13MH",242,437,"1200x900",1000,0,600,400,"False",74,667,450,-217,217,1
"E13MH",243,14,"1200x900",600,0,600,400,"True",399,224,277,53,53,1
"E13MH",244,249,"1200x900",800,0,600,400,"True",126,306,312,6,6,1
"E13MH",245,80,"1200x900",600,1,600,400,"False",616,423,531,108,108,1
"E13MH",246,632,"1200x900",1000,2,600,400,"False",984,227,523,296,296,0
"E13MH",247,110,"1200x900",600,1,600,400,"False",776,550,643,93,93,1
"E13MH",248,471,"1200x900",1000,0,600,400,"False",122,200,280,80,80,1
"E13MH",249,362,"1200x900",800,2,600,400,"False",819,338,518,180,180,0
"E13MH",250,381,"1200x900",800,2,600,400,"False",705,408,512,104,104,0
"E13MH",251,282,"1200x900",800,0,600,400,"True",109,246,232,-14,14,1
"E13MH",252,152,"1200x900",600,2,600,400,"False",971,399,488,89,89,0
"E13MH",253,58,"1200x900",600,0,600,400,"True",353,655,639,-16,16,1
"E13MH",254,248,"1200x900",800,0,600,400,"False",94,240,321,81,81,1
"E13MH",255,425,"1200x900",800,2,600,400,"False",621,438,317,-121,121,0
"E13MH",256,56,"1200x900",600,0,600,400,"True",148,491,431,-60,60,0
"E13MH",257,168,"1200x900",600,2,600,400,"False",1001,439,310,-129,129,0
"E13MH",258,548,"1200x900",1000,1,600,400,"False",103,278,522,244,244,0
"E13MH",259,452,"1200x900",1000,0,600,400,"False",97,273,363,90,90,1
"E13MH",260,302,"1200x900",800,1,600,400,"False",479,467,665,198,198,1
"E13MH",261,384,"1200x900",800,2,600,400,"True",821,707,679,-28,28,0
"E13MH",262,275,"1200x900",800,0,600,400,"False",120,594,527,-67,67,0
"E13MH",263,173,"1200x900",600,2,600,400,"True",948,693,648,-45,45,0
"E13MH",264,43,"1200x900",600,0,600,400,"False",277,446,376,-70,70,1
"E13MH",265,422,"1200x900",800,2,600,400,"False",712,558,428,-130,130,0
"E13MH",266,631,"1200x900",1000,2,600,400,"True",699,479,413,-66,66,0
"E13MH",267,608,"1200x900",1000,2,600,400,"True",742,250,312,62,62,0
"E13MH",268,419,"1200x900",800,2,600,400,"True",769,351,349,-2,2,0
"E13MH",269,64,"1200x900",600,0,600,400,"True",102,339,367,28,28,0
"E13MH",270,450,"1200x900",1000,0,600,400,"True",130,204,239,35,35,1
"E13MH",271,389,"1200x900",800,2,600,400,"False",843,530,431,-99,99,0
"E13MH",272,10,"1200x900",600,0,600,400,"False",400,499,429,-70,70,1
"E13MH",273,609,"1200x900",1000,2,600,400,"False",697,627,534,-93,93,0
"E13MH",274,476,"1200x900",1000,0,600,400,"True",76,359,416,57,57,1
"E13MH",275,72,"1200x900",600,0,600,400,"True",158,537,504,-33,33,0
"E13MH",276,142,"1200x900",600,1,600,400,"True",286,474,493,19,19,0
"E13MH",277,228,"1200x900",800,0,600,400,"False",174,687,759,72,72,1
"E13MH",278,106,"1200x900",600,1,600,400,"False",803,659,506,-153,153,1
"E13MH",279,407,"1200x900",800,2,600,400,"True",989,340,309,-31,31,0
"E13MH",280,244,"1200x900",800,0,600,400,"True",194,203,143,-60,60,1
"E13MH",281,497,"1200x900",1000,0,600,400,"False",106,696,430,-266,266,1
"E13MH",282,298,"1200x900",800,1,600,400,"False",311,457,273,-184,184,0
"E13MH",283,120,"1200x900",600,1,600,400,"True",690,655,588,-67,67,0
"E13MH",284,637,"1200x900",1000,2,600,400,"True",750,460,381,-79,79,0
"E13MH",285,71,"1200x900",600,0,600,400,"True",219,248,225,-23,23,0
"E13MH",286,414,"1200x900",800,2,600,400,"True",831,592,606,14,14,0
"E13MH",287,304,"1200x900",800,1,600,400,"False",667,605,296,-309,309,0
"E13MH",288,537,"1200x900",1000,1,600,400,"False",621,412,533,121,121,1
"E13MH",289,516,"1200x900",1000,1,600,400,"True",440,559,583,24,24,0
"E13MH",290,375,"1200x900",800,2,600,400,"False",716,384,287,-97,97,0
"E13MH",291,52,"1200x900",600,0,600,400,"True",171,188,186,-2,2,0
"E13MH",292,34,"1200x900",600,0,600,400,"True",361,242,230,-12,12,1
"E13MH",293,642,"1200x900",1000,2,600,400,"False",776,316,475,159,159,0
"E13MH",294,602,"1200x900",1000,2,600,400,"True",865,452,429,-23,23,0
"E13MH",295,280,"1200x900",800,0,600,400,"True",104,302,294,-8,8,1
"E13MH",296,493,"1200x900",1000,0,600,400,"False",80,582,426,-156,156,1
"E13MH",297,531,"1200x900",1000,1,600,400,"True",233,362,391,29,29,0
"E13MH",298,105,"1200x900",600,1,600,400,"True",527,440,483,43,43,0
"E13MH",299,158,"1200x900",600,2,600,400,"False",939,300,425,125,125,0
"E13MH",300,534,"1200x900",1000,1,600,400,"False",328,504,570,66,66,1
"E13MH",301,143,"1200x900",600,1,600,400,"True",479,284,263,-21,21,1
"E13MH",302,184,"1200x900",600,2,600,400,"False",1067,441,598,157,157,0
"E13MH",303,498,"1200x900",1000,0,600,400,"True",100,260,228,-32,32,1
"E13MH",304,563,"1200x900",1000,1,600,400,"True",201,696,626,-70,70,0
"E13MH",305,273,"1200x900",800,0,600,400,"False",180,309,440,131,131,1
"E13MH",306,368,"1200x900",800,2,600,400,"False",778,515,445,-70,70,0
"E13MH",307,55,"1200x900",600,0,600,400,"True",211,305,350,45,45,1
"E13MH",308,593,"1200x900",1000,2,600,400,"True",246,719,730,11,11,0
"E13MH",309,209,"1200x900",600,2,600,400,"False",937,637,194,-443,443,0
"E13MH",310,352,"1200x900",800,1,600,400,"True",235,717,732,15,15,0
"E13MH",311,442,"1200x900",1000,0,600,400,"True",87,183,229,46,46,1
"E13MH",312,178,"1200x900",600,2,600,400,"True",1041,510,427,-83,83,0
"E13MH",313,239,"1200x900",800,0,600,400,"True",114,231,293,62,62,1
"E13MH",314,117,"1200x900",600,1,600,400,"False",711,456,389,-67,67,0
"E13MH",315,20,"1200x900",600,0,600,400,"True",204,545,508,-37,37,1
"E13MH",316,474,"1200x900",1000,0,600,400,"True",85,339,386,47,47,1
"E13MH",317,585,"1200x900",1000,2,600,400,"False",698,688,370,-318,318,1
"E13MH",318,177,"1200x900",600,2,600,400,"True",912,236,192,-44,44,0
"E13MH",319,54,"1200x900",600,0,600,400,"False",474,564,403,-161,161,1
"E13MH",320,287,"1200x900",800,0,600,400,"True",120,567,612,45,45,1
"E13MH",321,222,"1200x900",800,0,600,400,"False",152,206,342,136,136,1
"E13MH",322,485,"1200x900",1000,0,600,400,"False",121,694,628,-66,66,1
"E13MH",323,197,"1200x900",600,2,600,400,"False",903,212,406,194,194,0
"E13MH",324,436,"1200x900",1000,0,600,400,"False",82,617,528,-89,89,1
"E13MH",325,192,"1200x900",600,2,600,400,"False",1064,320,505,185,185,0
"E13MH",326,263,"1200x900",800,0,600,400,"False",82,396,483,87,87,1
"E13MH",327,121,"1200x900",600,1,600,400,"True",884,364,397,33,33,0
"E13MH",328,453,"1200x900",1000,0,600,400,"True",71,393,445,52,52,1
"E13MH",329,565,"1200x900",1000,1,600,400,"True",451,562,520,-42,42,0
"E13MH",330,312,"1200x900",800,1,600,400,"False",238,683,747,64,64,0
"E13MH",331,466,"1200x900",1000,0,600,400,"False",82,205,361,156,156,1
"E13MH",332,477,"1200x900",1000,0,600,400,"False",88,640,481,-159,159,1
"E13MH",333,196,"1200x900",600,2,600,400,"True",1030,397,380,-17,17,0
"E13MH",334,576,"1200x900",1000,1,600,400,"False",376,713,537,-176,176,0
"E13MH",335,613,"1200x900",1000,2,600,400,"False",690,374,544,170,170,0
"E13MH",337,505,"1200x900",1000,1,600,400,"False",191,484,203,-281,281,1
"E13MH",338,540,"1200x900",1000,1,600,400,"True",389,568,580,12,12,1
"E13MH",339,115,"1200x900",600,1,600,400,"False",545,307,179,-128,128,0
"E13MH",340,92,"1200x900",600,1,600,400,"False",624,605,676,71,71,0
"E13MH",341,532,"1200x900",1000,1,600,400,"False",215,207,346,139,139,0
"E13MH",342,562,"1200x900",1000,1,600,400,"True",347,540,536,-4,4,0
"E13MH",343,214,"1200x900",600,2,600,400,"True",1046,305,383,78,78,0
"E13MH",344,7,"1200x900",600,0,600,400,"False",431,654,558,-96,96,1
"E13MH",345,134,"1200x900",600,1,600,400,"True",300,188,195,7,7,0
"E13MH",346,241,"1200x900",800,0,600,400,"True",129,227,184,-43,43,1
"E13MH",347,380,"1200x900",800,2,600,400,"False",942,228,440,212,212,0
"E13MH",348,30,"1200x900",600,0,600,400,"True",107,353,319,-34,34,0
"E13MH",349,418,"1200x900",800,2,600,400,"True",754,507,460,-47,47,0
"E13MH",350,235,"1200x900",800,0,600,400,"False",146,646,550,-96,96,1
"E13MH",351,179,"1200x900",600,2,600,400,"False",908,602,494,-108,108,0
"E13MH",352,198,"1200x900",600,2,600,400,"False",976,500,620,120,120,0
"E13MH",353,201,"1200x900",600,2,600,400,"False",1005,462,329,-133,133,0
"E13MH",354,569,"1200x900",1000,1,600,400,"False",494,720,409,-311,311,0
"E13MH",355,515,"1200x900",1000,1,600,400,"True",307,217,236,19,19,0
"E13MH",356,361,"1200x900",800,2,600,400,"False",931,328,459,131,131,0
"E13MH",357,643,"1200x900",1000,2,600,400,"False",740,325,531,206,206,0
"E13MH",358,57,"1200x900",600,0,600,400,"True",354,508,474,-34,34,1
"E13MH",359,230,"1200x900",800,0,600,400,"True",99,678,682,4,4,1
"E13MH",360,544,"1200x900",1000,1,600,400,"False",602,620,526,-94,94,0
"E13MH",361,449,"1200x900",1000,0,600,400,"True",105,683,632,-51,51,1
"E13MH",362,580,"1200x900",1000,2,600,400,"True",651,267,319,52,52,0
"E13MH",363,408,"1200x900",800,2,600,400,"True",758,567,543,-24,24,0
"E13MH",364,502,"1200x900",1000,0,600,400,"False",111,639,551,-88,88,1
"E13MH",365,366,"1200x900",800,2,600,400,"True",931,464,560,96,96,0
"E13MH",366,509,"1200x900",1000,1,600,400,"True",509,434,413,-21,21,0
"E13MH",367,618,"1200x900",1000,2,600,400,"True",276,671,696,25,25,0
"E13MH",368,278,"1200x900",800,0,600,400,"True",251,711,678,-33,33,1
"E13MH",369,519,"1200x900",1000,1,600,400,"False",319,565,695,130,130,1
"E13MH",370,194,"1200x900",600,2,600,400,"False",896,236,343,107,107,0
"E13MH",371,454,"1200x900",1000,0,600,400,"False",78,687,548,-139,139,1
"E13MH",372,125,"1200x900",600,1,600,400,"False",750,531,611,80,80,0
"E13MH",373,337,"1200x900",800,1,600,400,"True",299,622,670,48,48,0
"E13MH",374,286,"1200x900",800,0,600,400,"True",105,378,403,25,25,1
"E13MH",375,555,"1200x900",1000,1,600,400,"True",444,556,536,-20,20,0
"E13MH",376,265,"1200x900",800,0,600,400,"True",229,353,415,62,62,1
"E13MH",377,186,"1200x900",600,2,600,400,"False",997,197,394,197,197,0
"E13MH",378,506,"1200x900",1000,1,600,400,"False",559,567,402,-165,165,1
"E13MH",379,623,"1200x900",1000,2,600,400,"True",636,527,500,-27,27,0
"E13MH",380,169,"1200x900",600,2,600,400,"False",924,290,410,120,120,0
"E13MH",381,451,"1200x900",1000,0,600,400,"False",110,702,586,-116,116,1
"E13MH",382,98,"1200x900",600,1,600,400,"True",625,530,553,23,23,0
"E13MH",383,138,"1200x900",600,1,600,400,"False",844,580,455,-125,125,1
"E13MH",384,634,"1200x900",1000,2,600,400,"False",735,313,434,121,121,0
"E13MH",385,457,"1200x900",1000,0,600,400,"False",97,630,505,-125,125,1
"E13MH",386,47,"1200x900",600,0,600,400,"True",303,499,513,14,14,1
"E13MH",387,462,"1200x900",1000,0,600,400,"True",102,672,621,-51,51,1
"E13MH",388,329,"1200x900",800,1,600,400,"True",517,239,226,-13,13,0
"E13MH",389,468,"1200x900",1000,0,600,400,"False",121,219,306,87,87,1
"E13MH",390,430,"1200x900",800,2,600,400,"False",922,254,402,148,148,0
"E13MH",391,522,"1200x900",1000,1,600,400,"False",223,379,507,128,128,0
"E13MH",392,24,"1200x900",600,0,600,400,"True",430,538,542,4,4,1
"E13MH",393,309,"1200x900",800,1,600,400,"False",186,225,470,245,245,0
"E13MH",394,182,"1200x900",600,2,600,400,"True",933,389,440,51,51,0
"E13MH",395,270,"1200x900",800,0,600,400,"True",192,418,388,-30,30,1
"E13MH",396,552,"1200x900",1000,1,600,400,"False",255,412,531,119,119,0
"E13MH",397,150,"1200x900",600,2,600,400,"False",897,345,524,179,179,0
"E13MH",398,76,"1200x900",600,1,600,400,"True",647,614,557,-57,57,0
"E13MH",399,488,"1200x900",1000,0,600,400,"False",129,687,553,-134,134,1
"E13MH",400,348,"1200x900",800,1,600,400,"False",764,294,211,-83,83,0
"E13MH",401,50,"1200x900",600,0,600,400,"True",75,582,529,-53,53,0
"E13MH",402,116,"1200x900",600,1,600,400,"False",767,289,210,-79,79,0
"E13MH",403,102,"1200x900",600,1,600,400,"True",861,603,558,-45,45,0
"E13MH",404,26,"1200x900",600,0,600,400,"True",70,712,772,60,60,0
"E13MH",405,39,"1200x900",600,0,600,400,"False",210,609,516,-93,93,0
"E13MH",406,445,"1200x900",1000,0,600,400,"True",78,302,354,52,52,1
"E13MH",407,268,"1200x900",800,0,600,400,"True",148,400,377,-23,23,1
"E13MH",408,311,"1200x900",800,1,600,400,"False",710,261,629,368,368,0
"E13MH",409,74,"1200x900",600,1,600,400,"True",115,358,438,80,80,0
"E13MH",410,648,"1200x900",1000,2,600,400,"False",557,394,65,-329,329,0
"E13MH",411,295,"1200x900",800,1,600,400,"True",471,334,280,-54,54,0
"E13MH",412,558,"1200x900",1000,1,600,400,"False",72,464,563,99,99,1
"E13MH",414,78,"1200x900",600,1,600,400,"True",885,684,670,-14,14,0
"E13MH",415,135,"1200x900",600,1,600,400,"False",759,569,490,-79,79,0
"E13MH",416,114,"1200x900",600,1,600,400,"True",183,697,627,-70,70,0
"E13MH",417,225,"1200x900",800,0,600,400,"False",178,423,350,-73,73,1
"E13MH",418,372,"1200x900",800,2,600,400,"False",833,620,541,-79,79,0
"E13MH",419,199,"1200x900",600,2,600,400,"False",992,467,377,-90,90,0
"E13MH",420,299,"1200x900",800,1,600,400,"False",779,274,614,340,340,0
"E13MH",421,332,"1200x900",800,1,600,400,"True",260,699,726,27,27,0
"E13MH",422,521,"1200x900",1000,1,600,400,"False",111,303,161,-142,142,1
"E13MH",423,154,"1200x900",600,2,600,400,"False",941,454,261,-193,193,0
"E13MH",424,25,"1200x900",600,0,600,400,"True",263,403,366,-37,37,1
"E13MH",425,456,"1200x900",1000,0,600,400,"True",91,257,273,16,16,1
"E13MH",426,363,"1200x900",800,2,600,400,"True",800,218,267,49,49,0
"E13MH",427,17,"1200x900",600,0,600,400,"True",402,496,431,-65,65,1
"E13MH",428,233,"1200x900",800,0,600,400,"True",164,700,685,-15,15,1
"E13MH",429,159,"1200x900",600,2,600,400,"True",992,309,286,-23,23,0
"E13MH",430,591,"1200x900",1000,2,600,400,"True",698,336,323,-13,13,0
"E13MH",431,300,"1200x900",800,1,600,400,"True",620,693,751,58,58,0
"E13MH",432,63,"1200x900",600,0,600,400,"True",311,188,168,-20,20,1
"E13MH",433,160,"1200x900",600,2,600,400,"True",863,606,576,-30,30,0
"E13MH",434,156,"1200x900",600,2,600,400,"True",913,197,242,45,45,0
"E13MH",435,4,"1200x900",600,0,600,400,"True",602,200,195,-5,5,1
"E13MH",436,350,"1200x900",800,1,600,400,"False",182,566,503,-63,63,0
"E13MH",437,87,"1200x900",600,1,600,400,"True",231,604,616,12,12,0
"E13MH",438,165,"1200x900",600,2,600,400,"False",912,554,394,-160,160,0
"E13MH",439,572,"1200x900",1000,1,600,400,"True",302,260,267,7,7,0
"E13MH",440,162,"1200x900",600,2,600,400,"True",849,279,341,62,62,0
"E13MH",441,318,"1200x900",800,1,600,400,"False",788,534,683,149,149,0
"E13MH",442,151,"1200x900",600,2,600,400,"False",828,680,559,-121,121,0
"E13MH",443,439,"1200x900",1000,0,600,400,"True",110,229,276,47,47,1
"E13MH",444,189,"1200x900",600,2,600,400,"True",881,397,379,-18,18,0
"E13MH",445,104,"1200x900",600,1,600,400,"False",448,584,685,101,101,0
"E13MH",446,343,"1200x900",800,1,600,400,"False",407,557,343,-214,214,0
"E13MH",447,487,"1200x900",1000,0,600,400,"True",78,670,614,-56,56,1
"E13MH",448,486,"1200x900",1000,0,600,400,"False",102,676,598,-78,78,1
"E13MH",449,108,"1200x900",600,1,600,400,"False",830,239,319,80,80,0
"E13MH",450,575,"1200x900",1000,1,600,400,"False",272,693,523,-170,170,0
"E13MH",451,310,"1200x900",800,1,600,400,"True",559,592,655,63,63,0
"E13MH",452,202,"1200x900",600,2,600,400,"True",966,460,419,-41,41,0
"E13MH",453,554,"1200x900",1000,1,600,400,"False",79,309,144,-165,165,1
"E13MH",454,256,"1200x900",800,0,600,400,"False",192,656,581,-75,75,1
"E13MH",455,53,"1200x900",600,0,600,400,"False",177,189,277,88,88,0
"E13MH",456,217,"1200x900",800,0,600,400,"True",85,573,543,-30,30,1
"E13MH",457,145,"1200x900",600,2,600,400,"False",1004,630,701,71,71,0
"E13MH",458,369,"1200x900",800,2,600,400,"True",903,594,611,17,17,0
"E13MH",459,390,"1200x900",800,2,600,400,"True",982,674,623,-51,51,1
"E13MH",460,234,"1200x900",800,0,600,400,"True",72,344,339,-5,5,1
"E13MH",461,644,"1200x900",1000,2,600,400,"False",495,486,581,95,95,0
"E13MH",462,398,"1200x900",800,2,600,400,"True",944,698,611,-87,87,0
"E13MH",463,431,"1200x900",800,2,600,400,"True",694,382,392,10,10,0
"E13MH",464,411,"1200x900",800,2,600,400,"True",805,361,375,14,14,0
"E13MH",465,6,"1200x900",600,0,600,400,"False",217,689,600,-89,89,1
"E13MH",466,446,"1200x900",1000,0,600,400,"False",72,298,381,83,83,1
"E13MH",467,139,"1200x900",600,1,600,400,"False",192,695,557,-138,138,0
"E13MH",468,448,"1200x900",1000,0,600,400,"True",107,641,634,-7,7,1
"E13MH",469,281,"1200x900",800,0,600,400,"True",112,611,633,22,22,1
"E13MH",470,404,"1200x900",800,2,600,400,"True",842,396,402,6,6,0
"E13MH",471,399,"1200x900",800,2,600,400,"False",603,602,424,-178,178,0
"E13MH",472,136,"1200x900",600,1,600,400,"True",264,205,268,63,63,0
"E13MH",473,113,"1200x900",600,1,600,400,"True",897,657,653,-4,4,0
"E13MH",474,93,"1200x900",600,1,600,400,"False",139,540,678,138,138,0
"E13MH",475,429,"1200x900",800,2,600,400,"False",682,692,528,-164,164,0
"E13MH",476,469,"1200x900",1000,0,600,400,"True",73,227,177,-50,50,1
"E13MH",477,301,"1200x900",800,1,600,400,"False",162,574,757,183,183,0
"E13MH",478,465,"1200x900",1000,0,600,400,"True",85,203,270,67,67,1
"E13MH",479,595,"1200x900",1000,2,600,400,"True",687,640,593,-47,47,0
"E13MH",480,584,"1200x900",1000,2,600,400,"True",731,413,374,-39,39,0
"E13MH",481,223,"1200x900",800,0,600,400,"True",179,191,200,9,9,1
"E13MH",482,305,"1200x900",800,1,600,400,"True",471,716,720,4,4,0
"E13MH",483,628,"1200x900",1000,2,600,400,"False",768,410,292,-118,118,0
"E13MH",484,140,"1200x900",600,1,600,400,"False",700,523,390,-133,133,0
"E13MH",485,303,"1200x900",800,1,600,400,"False",241,431,193,-238,238,0
"E13MH",486,236,"1200x900",800,0,600,400,"True",162,350,379,29,29,1
"E13MH",487,146,"1200x900",600,2,600,400,"False",989,492,372,-120,120,0
"E13MH",488,36,"1200x900",600,0,600,400,"True",128,346,328,-18,18,1
"E13MH",489,529,"1200x900",1000,1,600,400,"True",267,412,353,-59,59,1
"E13MH",490,253,"1200x900",800,0,600,400,"True",177,424,362,-62,62,1
"E13MH",491,68,"1200x900",600,0,600,400,"True",165,367,408,41,41,0
"E13MH",492,161,"1200x900",600,2,600,400,"True",939,553,476,-77,77,0
"E13MH",493,335,"1200x900",800,1,600,400,"False",124,360,584,224,224,0
"E13MH",494,539,"1200x900",1000,1,600,400,"False",510,383,470,87,87,0
"E13MH",495,96,"1200x900",600,1,600,400,"False",433,458,562,104,104,0
"E13MH",496,330,"1200x900",800,1,600,400,"False",759,301,207,-94,94,1
"E13MH",497,415,"1200x900",800,2,600,400,"False",823,684,571,-113,113,0
"E13MH",498,269,"1200x900",800,0,600,400,"True",160,295,284,-11,11,1
"E13MH",499,262,"1200x900",800,0,600,400,"True",196,481,440,-41,41,1
"E13MH",500,444,"1200x900",1000,0,600,400,"True",101,714,650,-64,64,1
"E13MH",501,62,"1200x900",600,0,600,400,"True",345,346,381,35,35,1
"E13MH",502,434,"1200x900",1000,0,600,400,"True",89,657,591,-66,66,1
"E13MH",503,504,"1200x900",1000,0,600,400,"True",107,699,704,5,5,1
"E13MH",504,157,"1200x900",600,2,600,400,"False",1016,323,430,107,107,0
"E13MH",505,191,"1200x900",600,2,600,400,"True",962,396,332,-64,64,0
"E13MH",506,559,"1200x900",1000,1,600,400,"False",641,244,363,119,119,0
"E13MH",507,387,"1200x900",800,2,600,400,"False",990,444,362,-82,82,0
"E13MH",508,79,"1200x900",600,1,600,400,"False",731,289,202,-87,87,0
"E13MH",509,9,"1200x900",600,0,600,400,"False",509,654,552,-102,102,1
"E13MH",510,317,"1200x900",800,1,600,400,"False",185,564,679,115,115,0
"E13MH",511,203,"1200x900",600,2,600,400,"False",938,603,460,-143,143,0
"E13MH",512,646,"1200x900",1000,2,600,400,"True",829,227,198,-29,29,1
"E13MH",513,319,"1200x900",800,1,600,400,"False",494,587,696,109,109,1
"E13MH",514,174,"1200x900",600,2,600,400,"False",998,457,675,218,218,0
"E13MH",515,553,"1200x900",1000,1,600,400,"False",116,712,299,-413,413,0
"E13MH",516,51,"1200x900",600,0,600,400,"True",272,181,206,25,25,1
"E13MH",517,101,"1200x900",600,1,600,400,"False",541,656,741,85,85,0
"E13MH",518,27,"1200x900",600,0,600,400,"True",373,309,327,18,18,1
"E13MH",519,612,"1200x900",1000,2,600,400,"False",706,198,416,218,218,0
"E13MH",520,573,"1200x900",1000,1,600,400,"True",486,615,633,18,18,0
"E13MH",521,570,"1200x900",1000,1,600,400,"False",315,352,450,98,98,0
"E13MH",522,166,"1200x900",600,2,600,400,"False",896,274,361,87,87,0
"E13MH",523,83,"1200x900",600,1,600,400,"True",763,568,511,-57,57,1
"E13MH",524,617,"1200x900",1000,2,600,400,"False",294,180,387,207,207,0
"E13MH",525,167,"1200x900",600,2,600,400,"True",956,241,280,39,39,0
"E13MH",526,492,"1200x900",1000,0,600,400,"False",76,692,429,-263,263,1
"E13MH",527,620,"1200x900",1000,2,600,400,"False",832,649,501,-148,148,0
"E13MH",528,611,"1200x900",1000,2,600,400,"False",414,511,427,-84,84,0
"E13MH",529,219,"1200x900",800,0,600,400,"True",202,502,513,11,11,1
"E13MH",530,581,"1200x900",1000,2,600,400,"True",310,357,393,36,36,0
"E13MH",531,229,"1200x900",800,0,600,400,"True",117,697,703,6,6,1
"E13MH",532,587,"1200x900",1000,2,600,400,"True",741,686,705,19,19,0
"E13MH",533,495,"1200x900",1000,0,600,400,"True",93,692,706,14,14,1
"E13MH",534,148,"1200x900",600,2,600,400,"True",907,330,310,-20,20,0
"E13MH",535,614,"1200x900",1000,2,600,400,"False",823,563,333,-230,230,0
"E13MH",536,545,"1200x900",1000,1,600,400,"True",358,562,594,32,32,0
"E13MH",537,291,"1200x900",800,1,600,400,"True",522,694,705,11,11,0
"E13MH",538,607,"1200x900",1000,2,600,400,"True",900,573,502,-71,71,1
"E13MH",539,46,"1200x900",600,0,600,400,"True",193,355,382,27,27,1
"E13MH",540,359,"1200x900",800,1,600,400,"False",653,241,325,84,84,0
"E13MH",541,206,"1200x900",600,2,600,400,"True",975,223,267,44,44,0
"E13MH",542,118,"1200x900",600,1,600,400,"True",190,588,590,2,2,0
"E13MH",543,616,"1200x900",1000,2,600,400,"False",854,357,254,-103,103,1
"E13MH",544,164,"1200x900",600,2,600,400,"True",1051,268,308,40,40,0
"E13MH",545,463,"1200x900",1000,0,600,400,"False",115,693,523,-170,170,1
"E13MH",546,351,"1200x900",800,1,600,400,"False",122,581,674,93,93,0
"E13MH",547,406,"1200x900",800,2,600,400,"False",971,233,412,179,179,0
"E13MH",548,137,"1200x900",600,1,600,400,"False",789,577,460,-117,117,0
"E13MH",549,61,"1200x900",600,0,600,400,"False",272,670,529,-141,141,1
"E13MH",550,583,"1200x900",1000,2,600,400,"True",949,284,354,70,70,1
"E13MH",551,18,"1200x900",600,0,600,400,"True",400,318,312,-6,6,1
"E13MH",552,297,"1200x900",800,1,600,400,"True",625,244,225,-19,19,0
"E13MH",553,180,"1200x900",600,2,600,400,"True",929,270,257,-13,13,0
"E13MH",554,638,"1200x900",1000,2,600,400,"False",385,198,442,244,244,0
"E13MH",555,405,"1200x900",800,2,600,400,"True",790,307,306,-1,1,0
"E13MH",556,23,"1200x900",600,0,600,400,"True",308,463,450,-13,13,1
"E13MH",557,349,"1200x900",800,1,600,400,"True",402,665,597,-68,68,0
"E13MH",558,111,"1200x900",600,1,600,400,"True",922,552,526,-26,26,1
"E13MH",559,94,"1200x900",600,1,600,400,"False",729,482,278,-204,204,0
"E13MH",560,421,"1200x900",800,2,600,400,"False",898,394,777,383,383,0
"E13MH",561,513,"1200x900",1000,1,600,400,"False",235,602,364,-238,238,0
"E13MH",562,574,"1200x900",1000,1,600,400,"True",614,194,139,-55,55,0
"E13MH",563,1,"1200x900",600,0,600,400,"True",136,502,534,32,32,0
"E13MH",564,133,"1200x900",600,1,600,400,"False",345,551,619,68,68,0
"E13MH",565,326,"1200x900",800,1,600,400,"True",103,482,504,22,22,0
"E13MH",566,171,"1200x900",600,2,600,400,"False",909,200,351,151,151,0
"E13MH",567,394,"1200x900",800,2,600,400,"False",847,292,423,131,131,0
"E13MH",568,645,"1200x900",1000,2,600,400,"True",619,396,474,78,78,0
"E13MH",569,441,"1200x900",1000,0,600,400,"False",85,684,574,-110,110,1
"E13MH",570,82,"1200x900",600,1,600,400,"True",108,213,181,-32,32,0
"E13MH",571,582,"1200x900",1000,2,600,400,"True",554,347,317,-30,30,0
"E13MH",572,227,"1200x900",800,0,600,400,"True",196,551,573,22,22,1
"E13MH",573,625,"1200x900",1000,2,600,400,"True",279,228,166,-62,62,0
"E13MH",574,438,"1200x900",1000,0,600,400,"False",77,713,531,-182,182,1
"E13MH",575,129,"1200x900",600,1,600,400,"False",859,482,358,-124,124,1
"E13MH",576,392,"1200x900",800,2,600,400,"False",1031,618,714,96,96,0
"E13MH",577,604,"1200x900",1000,2,600,400,"False",459,593,421,-172,172,0
"E13MH",578,122,"1200x900",600,1,600,400,"True",817,709,724,15,15,0
"E13MH",579,507,"1200x900",1000,1,600,400,"True",608,583,570,-13,13,1
"E13MH",580,208,"1200x900",600,2,600,400,"True",946,399,346,-53,53,0
"E13MH",581,339,"1200x900",800,1,600,400,"False",273,545,646,101,101,1
"E13MH",582,91,"1200x900",600,1,600,400,"True",417,630,597,-33,33,1
"E13MH",583,412,"1200x900",800,2,600,400,"False",842,280,392,112,112,0
"E13MH",584,109,"1200x900",600,1,600,400,"False",691,589,499,-90,90,0
"E13MH",585,520,"1200x900",1000,1,600,400,"False",564,260,358,98,98,0
"E13MH",586,496,"1200x900",1000,0,600,400,"False",70,639,499,-140,140,1
"E13MH",587,549,"1200x900",1000,1,600,400,"True",657,366,369,3,3,0
"E13MH",588,210,"1200x900",600,2,600,400,"True",835,506,461,-45,45,0
"E13MH",589,491,"1200x900",1000,0,600,400,"True",108,198,221,23,23,1
"E13MH",590,255,"1200x900",800,0,600,400,"False",93,709,579,-130,130,1
"E13MH",591,340,"1200x900",800,1,600,400,"False",226,240,357,117,117,0
"E13MH",592,376,"1200x900",800,2,600,400,"False",788,275,374,99,99,0
"E13MH",593,13,"1200x900",600,0,600,400,"True",296,211,144,-67,67,1
"E13MH",594,514,"1200x900",1000,1,600,400,"False",539,690,563,-127,127,0
"E13MH",595,294,"1200x900",800,1,600,400,"False",262,287,438,151,151,0
"E13MH",596,564,"1200x900",1000,1,600,400,"True",215,264,303,39,39,0
"E13MH",597,571,"1200x900",1000,1,600,400,"True",239,522,540,18,18,1
"E13MH",598,16,"1200x900",600,0,600,400,"True",297,514,462,-52,52,1
"E13MH",599,44,"1200x900",600,0,600,400,"True",305,554,521,-33,33,1
"E13MH",600,243,"1200x900",800,0,600,400,"True",114,332,337,5,5,1
"E13MH",601,435,"1200x900",1000,0,600,400,"True",119,200,153,-47,47,1
"E13MH",602,240,"1200x900",800,0,600,400,"False",330,656,581,-75,75,1
"E13MH",603,22,"1200x900",600,0,600,400,"True",398,591,617,26,26,1
"E13MH",604,596,"1200x900",1000,2,600,400,"True",706,513,522,9,9,0
"E13MH",605,97,"1200x900",600,1,600,400,"True",760,643,678,35,35,1
"E13MH",606,211,"1200x900",600,2,600,400,"False",986,407,323,-84,84,0
"E13MH",607,511,"1200x900",1000,1,600,400,"False",408,390,524,134,134,1
"E13MH",608,510,"1200x900",1000,1,600,400,"True",486,338,411,73,73,1
"E13MH",609,15,"1200x900",600,0,600,400,"True",473,352,332,-20,20,1
"E13MH",610,293,"1200x900",800,1,600,400,"True",561,396,355,-41,41,0
"E13MH",611,267,"1200x900",800,0,600,400,"True",145,665,616,-49,49,1
"E13MH",612,423,"1200x900",800,2,600,400,"False",1051,710,605,-105,105,1
"E13MH",613,533,"1200x900",1000,1,600,400,"True",355,483,425,-58,58,0
"E13MH",614,127,"1200x900",600,1,600,400,"True",309,691,692,1,1,0
"E13MH",615,383,"1200x900",800,2,600,400,"False",855,407,486,79,79,0
"E13MH",616,12,"1200x900",600,0,600,400,"True",365,336,378,42,42,1
"E13MH",617,205,"1200x900",600,2,600,400,"True",1021,504,513,9,9,0
"E13MH",618,568,"1200x900",1000,1,600,400,"False",286,475,806,331,331,1
"E13MH",619,385,"1200x900",800,2,600,400,"False",740,456,366,-90,90,0
"E13MH",620,579,"1200x900",1000,2,600,400,"False",803,394,658,264,264,0
"E13MH",621,566,"1200x900",1000,1,600,400,"False",378,472,296,-176,176,1
"E13MH",622,588,"1200x900",1000,2,600,400,"False",585,350,598,248,248,0
"E13MH",623,499,"1200x900",1000,0,600,400,"True",93,271,316,45,45,1
"E13MH",624,427,"1200x900",800,2,600,400,"False",812,380,312,-68,68,0
"E13MH",625,393,"1200x900",800,2,600,400,"False",657,620,493,-127,127,0
"E13MH",626,601,"1200x900",1000,2,600,400,"False",735,697,627,-70,70,0
"E13MH",627,610,"1200x900",1000,2,600,400,"True",702,293,351,58,58,0
"E13MH",628,341,"1200x900",800,1,600,400,"True",735,632,611,-21,21,1
"E13MH",629,413,"1200x900",800,2,600,400,"True",849,506,444,-62,62,0
"E13MH",630,73,"1200x900",600,1,600,400,"False",94,665,850,185,185,0
"E13MH",631,546,"1200x900",1000,1,600,400,"True",305,374,365,-9,9,0
"E13MH",632,315,"1200x900",800,1,600,400,"True",105,211,182,-29,29,0
"E13MH",633,316,"1200x900",800,1,600,400,"False",362,319,557,238,238,0
"E13MH",634,119,"1200x900",600,1,600,400,"False",168,563,649,86,86,0
"E13MH",635,484,"1200x900",1000,0,600,400,"False",100,223,290,67,67,1
"E13MH",636,257,"1200x900",800,0,600,400,"True",97,219,212,-7,7,1
"E13MH",637,216,"1200x900",600,2,600,400,"True",1029,286,360,74,74,0
"E13MH",638,561,"1200x900",1000,1,600,400,"False",231,406,462,56,56,0
"E13MH",639,432,"1200x900",800,2,600,400,"False",792,380,281,-99,99,0
"E13MH",640,279,"1200x900",800,0,600,400,"True",252,202,212,10,10,1
"E13MH",641,32,"1200x900",600,0,600,400,"False",152,563,441,-122,122,1
"E13MH",642,365,"1200x900",800,2,600,400,"False",1055,305,521,216,216,0
"E13MH",643,60,"1200x900",600,0,600,400,"True",365,213,241,28,28,1
"E13MH",644,481,"1200x900",1000,0,600,400,"True",80,185,224,39,39,1
"E13MH",645,90,"1200x900",600,1,600,400,"False",560,474,385,-89,89,0
"E13MH",646,218,"1200x900",800,0,600,400,"True",106,397,451,54,54,1
"E13MH",647,464,"1200x900",1000,0,600,400,"True",82,222,228,6,6,1
"E13MH",648,284,"1200x900",800,0,600,400,"True",135,293,305,12,12,1
"E14AK",1,2,"1200x900",600,0,600,400,"True",159,323,349,26,26,0
"E14AK",2,216,"1200x900",600,2,600,400,"True",1029,286,326,40,40,0
"E14AK",3,455,"1200x900",1000,0,600,400,"False",107,718,521,-197,197,1
"E14AK",4,570,"1200x900",1000,1,600,400,"False",315,352,543,191,191,0
"E14AK",5,567,"1200x900",1000,1,600,400,"False",655,297,235,-62,62,1
"E14AK",6,23,"1200x900",600,0,600,400,"True",308,463,472,9,9,1
"E14AK",7,447,"1200x900",1000,0,600,400,"True",71,339,386,47,47,1
"E14AK",8,283,"1200x900",800,0,600,400,"True",90,264,292,28,28,1
"E14AK",10,396,"1200x900",800,2,600,400,"False",678,663,451,-212,212,0
"E14AK",11,470,"1200x900",1000,0,600,400,"False",91,666,522,-144,144,1
"E14AK",12,500,"1200x900",1000,0,600,400,"False",105,700,506,-194,194,1
"E14AK",13,49,"1200x900",600,0,600,400,"True",109,380,439,59,59,0
"E14AK",14,473,"1200x900",1000,0,600,400,"False",75,323,438,115,115,1
"E14AK",16,275,"1200x900",800,0,600,400,"False",120,594,499,-95,95,0
"E14AK",17,418,"1200x900",800,2,600,400,"False",754,507,436,-71,71,0
"E14AK",18,481,"1200x900",1000,0,600,400,"False",80,185,305,120,120,1
"E14AK",19,375,"1200x900",800,2,600,400,"False",716,384,545,161,161,0
"E14AK",20,5,"1200x900",600,0,600,400,"False",228,587,497,-90,90,0
"E14AK",21,388,"1200x900",800,2,600,400,"False",930,320,496,176,176,0
"E14AK",22,351,"1200x900",800,1,600,400,"True",122,581,562,-19,19,0
"E14AK",23,246,"1200x900",800,0,600,400,"False",196,418,499,81,81,1
"E14AK",24,313,"1200x900",800,1,600,400,"True",588,421,401,-20,20,0
"E14AK",25,227,"1200x900",800,0,600,400,"True",196,551,586,35,35,1
"E14AK",26,358,"1200x900",800,1,600,400,"False",263,635,306,-329,329,0
"E14AK",27,501,"1200x900",1000,0,600,400,"False",96,323,404,81,81,1
"E14AK",28,502,"1200x900",1000,0,600,400,"False",111,639,552,-87,87,1
"E14AK",29,493,"1200x900",1000,0,600,400,"False",80,582,460,-122,122,1
"E14AK",30,86,"1200x900",600,1,600,400,"False",692,388,316,-72,72,1
"E14AK",31,632,"1200x900",1000,2,600,400,"False",984,227,622,395,395,0
"E14AK",32,407,"1200x900",800,2,600,400,"False",989,340,250,-90,90,0
"E14AK",33,633,"1200x900",1000,2,600,400,"False",564,253,548,295,295,0
"E14AK",34,230,"1200x900",800,0,600,400,"True",99,678,629,-49,49,1
"E14AK",35,262,"1200x900",800,0,600,400,"True",196,481,419,-62,62,1
"E14AK",36,174,"1200x900",600,2,600,400,"True",998,457,420,-37,37,0
"E14AK",37,465,"1200x900",1000,0,600,400,"True",85,203,233,30,30,1
"E14AK",39,272,"1200x900",800,0,600,400,"False",200,181,417,236,236,1
"E14AK",40,249,"1200x900",800,0,600,400,"True",126,306,330,24,24,1
"E14AK",42,489,"1200x900",1000,0,600,400,"True",88,604,656,52,52,1
"E14AK",43,244,"1200x900",800,0,600,400,"True",194,203,248,45,45,1
"E14AK",44,91,"1200x900",600,1,600,400,"False",417,630,247,-383,383,1
"E14AK",45,79,"1200x900",600,1,600,400,"True",731,289,323,34,34,0
"E14AK",46,47,"1200x900",600,0,600,400,"False",303,499,401,-98,98,1
"E14AK",47,561,"1200x900",1000,1,600,400,"False",231,406,487,81,81,0
"E14AK",48,92,"1200x900",600,1,600,400,"True",624,605,539,-66,66,0
"E14AK",49,627,"1200x900",1000,2,600,400,"True",760,510,498,-12,12,0
"E14AK",50,197,"1200x900",600,2,600,400,"True",903,212,261,49,49,0
"E14AK",51,494,"1200x900",1000,0,600,400,"False",127,692,457,-235,235,1
"E14AK",52,54,"1200x900",600,0,600,400,"False",474,564,491,-73,73,1
"E14AK",53,376,"1200x900",800,2,600,400,"True",788,275,319,44,44,0
"E14AK",54,211,"1200x900",600,2,600,400,"False",986,407,295,-112,112,0
"E14AK",55,573,"1200x900",1000,1,600,400,"False",486,615,500,-115,115,0
"E14AK",56,560,"1200x900",1000,1,600,400,"False",516,693,496,-197,197,0
"E14AK",57,582,"1200x900",1000,2,600,400,"False",554,347,499,152,152,0
"E14AK",58,228,"1200x900",800,0,600,400,"False",174,687,574,-113,113,1
"E14AK",59,149,"1200x900",600,2,600,400,"False",890,289,425,136,136,0
"E14AK",60,234,"1200x900",800,0,600,400,"True",72,344,381,37,37,1
"E14AK",61,277,"1200x900",800,0,600,400,"True",140,310,321,11,11,1
"E14AK",62,628,"1200x900",1000,2,600,400,"False",768,410,295,-115,115,0
"E14AK",63,341,"1200x900",800,1,600,400,"False",735,632,451,-181,181,1
"E14AK",64,301,"1200x900",800,1,600,400,"True",162,574,544,-30,30,0
"E14AK",65,555,"1200x900",1000,1,600,400,"True",444,556,541,-15,15,0
"E14AK",66,640,"1200x900",1000,2,600,400,"False",361,334,669,335,335,0
"E14AK",67,552,"1200x900",1000,1,600,400,"True",255,412,388,-24,24,0
"E14AK",68,648,"1200x900",1000,2,600,400,"True",557,394,441,47,47,0
"E14AK",70,219,"1200x900",800,0,600,400,"True",202,502,528,26,26,1
"E14AK",71,164,"1200x900",600,2,600,400,"False",1051,268,526,258,258,0
"E14AK",72,326,"1200x900",800,1,600,400,"True",103,482,498,16,16,0
"E14AK",74,251,"1200x900",800,0,600,400,"True",88,352,387,35,35,1
"E14AK",75,116,"1200x900",600,1,600,400,"False",767,289,144,-145,145,0
"E14AK",76,620,"1200x900",1000,2,600,400,"False",832,649,401,-248,248,0
"E14AK",77,154,"1200x900",600,2,600,400,"False",941,454,333,-121,121,0
"E14AK",78,41,"1200x900",600,0,600,400,"True",370,452,387,-65,65,1
"E14AK",79,624,"1200x900",1000,2,600,400,"False",693,501,381,-120,120,0
"E14AK",80,243,"1200x900",800,0,600,400,"True",114,332,367,35,35,1
"E14AK",81,295,"1200x900",800,1,600,400,"False",471,334,147,-187,187,0
"E14AK",82,74,"1200x900",600,1,600,400,"True",115,358,321,-37,37,0
"E14AK",83,373,"1200x900",800,2,600,400,"True",694,326,320,-6,6,0
"E14AK",84,280,"1200x900",800,0,600,400,"False",104,302,184,-118,118,1
"E14AK",85,416,"1200x900",800,2,600,400,"False",748,617,560,-57,57,0
"E14AK",86,109,"1200x900",600,1,600,400,"True",691,589,637,48,48,0
"E14AK",87,22,"1200x900",600,0,600,400,"True",398,591,592,1,1,1
"E14AK",88,309,"1200x900",800,1,600,400,"False",186,225,360,135,135,0
"E14AK",89,453,"1200x900",1000,0,600,400,"True",71,393,422,29,29,1
"E14AK",90,118,"1200x900",600,1,600,400,"False",190,588,350,-238,238,0
"E14AK",91,180,"1200x900",600,2,600,400,"True",929,270,348,78,78,0
"E14AK",93,257,"1200x900",800,0,600,400,"False",97,219,284,65,65,1
"E14AK",94,101,"1200x900",600,1,600,400,"False",541,656,482,-174,174,0
"E14AK",95,539,"1200x900",1000,1,600,400,"True",510,383,273,-110,110,0
"E14AK",96,429,"1200x900",800,2,600,400,"True",682,692,691,-1,1,0
"E14AK",97,646,"1200x900",1000,2,600,400,"False",829,227,602,375,375,1
"E14AK",98,504,"1200x900",1000,0,600,400,"False",107,699,424,-275,275,1
"E14AK",99,507,"1200x900",1000,1,600,400,"False",608,583,451,-132,132,1
"E14AK",100,147,"1200x900",600,2,600,400,"True",942,418,484,66,66,0
"E14AK",101,452,"1200x900",1000,0,600,400,"False",97,273,337,64,64,1
"E14AK",102,139,"1200x900",600,1,600,400,"False",192,695,548,-147,147,0
"E14AK",103,409,"1200x900",800,2,600,400,"True",501,659,688,29,29,0
"E14AK",104,362,"1200x900",800,2,600,400,"False",819,338,518,180,180,0
"E14AK",105,261,"1200x900",800,0,600,400,"True",86,713,659,-54,54,1
"E14AK",106,291,"1200x900",800,1,600,400,"True",522,694,650,-44,44,0
"E14AK",107,368,"1200x900",800,2,600,400,"True",778,515,531,16,16,0
"E14AK",108,415,"1200x900",800,2,600,400,"False",823,684,557,-127,127,0
"E14AK",109,340,"1200x900",800,1,600,400,"False",226,240,564,324,324,0
"E14AK",110,232,"1200x900",800,0,600,400,"False",84,511,432,-79,79,1
"E14AK",111,442,"1200x900",1000,0,600,400,"False",87,183,345,162,162,1
"E14AK",112,597,"1200x900",1000,2,600,400,"False",352,239,332,93,93,0
"E14AK",113,215,"1200x900",600,2,600,400,"False",939,596,327,-269,269,0
"E14AK",114,522,"1200x900",1000,1,600,400,"False",223,379,451,72,72,0
"E14AK",115,58,"1200x900",600,0,600,400,"False",353,655,549,-106,106,1
"E14AK",116,100,"1200x900",600,1,600,400,"False",453,511,306,-205,205,0
"E14AK",117,16,"1200x900",600,0,600,400,"True",297,514,463,-51,51,1
"E14AK",118,634,"1200x900",1000,2,600,400,"False",735,313,469,156,156,0
"E14AK",120,477,"1200x900",1000,0,600,400,"False",88,640,560,-80,80,1
"E14AK",121,39,"1200x900",600,0,600,400,"True",210,609,546,-63,63,0
"E14AK",122,549,"1200x900",1000,1,600,400,"False",657,366,437,71,71,0
"E14AK",123,137,"1200x900",600,1,600,400,"True",789,577,633,56,56,0
"E14AK",124,90,"1200x900",600,1,600,400,"False",560,474,317,-157,157,0
"E14AK",125,398,"1200x900",800,2,600,400,"True",944,698,703,5,5,0
"E14AK",126,511,"1200x900",1000,1,600,400,"False",408,390,493,103,103,1
"E14AK",127,64,"1200x900",600,0,600,400,"True",102,339,390,51,51,0
"E14AK",128,110,"1200x900",600,1,600,400,"False",776,550,715,165,165,1
"E14AK",129,461,"1200x900",1000,0,600,400,"True",95,711,659,-52,52,1
"E14AK",130,612,"1200x900",1000,2,600,400,"False",706,198,463,265,265,0
"E14AK",131,156,"1200x900",600,2,600,400,"False",913,197,294,97,97,0
"E14AK",132,424,"1200x900",800,2,600,400,"False",903,545,287,-258,258,0
"E14AK",133,84,"1200x900",600,1,600,400,"False",144,184,407,223,223,0
"E14AK",134,329,"1200x900",800,1,600,400,"False",517,239,401,162,162,0
"E14AK",135,85,"1200x900",600,1,600,400,"False",434,347,617,270,270,0
"E14AK",136,288,"1200x900",800,0,600,400,"True",180,547,581,34,34,1
"E14AK",137,218,"1200x900",800,0,600,400,"True",106,397,446,49,49,1
"E14AK",138,185,"1200x900",600,2,600,400,"True",907,212,277,65,65,0
"E14AK",139,606,"1200x900",1000,2,600,400,"False",653,627,481,-146,146,0
"E14AK",140,357,"1200x900",800,1,600,400,"False",109,594,696,102,102,0
"E14AK",141,12,"1200x900",600,0,600,400,"False",365,336,470,134,134,1
"E14AK",142,233,"1200x900",800,0,600,400,"True",164,700,666,-34,34,1
"E14AK",143,420,"1200x900",800,2,600,400,"False",519,223,490,267,267,0
"E14AK",144,17,"1200x900",600,0,600,400,"True",402,496,454,-42,42,1
"E14AK",145,274,"1200x900",800,0,600,400,"True",146,497,464,-33,33,1
"E14AK",146,510,"1200x900",1000,1,600,400,"False",486,338,242,-96,96,1
"E14AK",147,172,"1200x900",600,2,600,400,"False",912,444,291,-153,153,0
"E14AK",148,81,"1200x900",600,1,600,400,"False",696,225,310,85,85,0
"E14AK",149,166,"1200x900",600,2,600,400,"True",896,274,315,41,41,0
"E14AK",150,334,"1200x900",800,1,600,400,"False",481,665,314,-351,351,0
"E14AK",151,21,"1200x900",600,0,600,400,"True",314,383,409,26,26,1
"E14AK",152,1,"1200x900",600,0,600,400,"False",136,502,422,-80,80,0
"E14AK",154,316,"1200x900",800,1,600,400,"False",362,319,420,101,101,0
"E14AK",155,631,"1200x900",1000,2,600,400,"True",699,479,419,-60,60,0
"E14AK",157,419,"1200x900",800,2,600,400,"True",769,351,416,65,65,0
"E14AK",158,296,"1200x900",800,1,600,400,"False",89,279,410,131,131,0
"E14AK",159,38,"1200x900",600,0,600,400,"True",120,628,571,-57,57,1
"E14AK",160,428,"1200x900",800,2,600,400,"False",732,665,524,-141,141,0
"E14AK",161,364,"1200x900",800,2,600,400,"False",1018,204,521,317,317,0
"E14AK",162,550,"1200x900",1000,1,600,400,"True",301,459,451,-8,8,0
"E14AK",163,505,"1200x900",1000,1,600,400,"False",191,484,384,-100,100,1
"E14AK",164,162,"1200x900",600,2,600,400,"True",849,279,344,65,65,0
"E14AK",165,598,"1200x900",1000,2,600,400,"False",706,559,342,-217,217,0
"E14AK",166,278,"1200x900",800,0,600,400,"False",251,711,523,-188,188,1
"E14AK",167,466,"1200x900",1000,0,600,400,"True",82,205,260,55,55,1
"E14AK",168,629,"1200x900",1000,2,600,400,"True",681,257,290,33,33,0
"E14AK",169,33,"1200x900",600,0,600,400,"False",198,533,291,-242,242,1
"E14AK",170,311,"1200x900",800,1,600,400,"True",710,261,295,34,34,0
"E14AK",171,222,"1200x900",800,0,600,400,"False",152,206,299,93,93,1
"E14AK",172,435,"1200x900",1000,0,600,400,"False",119,200,50,-150,150,1
"E14AK",173,610,"1200x900",1000,2,600,400,"True",702,293,259,-34,34,0
"E14AK",174,299,"1200x900",800,1,600,400,"True",779,274,271,-3,3,0
"E14AK",175,111,"1200x900",600,1,600,400,"False",922,552,290,-262,262,1
"E14AK",176,96,"1200x900",600,1,600,400,"False",433,458,540,82,82,0
"E14AK",177,533,"1200x900",1000,1,600,400,"False",355,483,569,86,86,0
"E14AK",178,446,"1200x900",1000,0,600,400,"False",72,298,496,198,198,1
"E14AK",179,403,"1200x900",800,2,600,400,"False",625,704,495,-209,209,0
"E14AK",180,566,"1200x900",1000,1,600,400,"False",378,472,402,-70,70,1
"E14AK",181,367,"1200x900",800,2,600,400,"True",613,464,444,-20,20,0
"E14AK",182,593,"1200x900",1000,2,600,400,"False",246,719,407,-312,312,0
"E14AK",183,519,"1200x900",1000,1,600,400,"False",319,565,403,-162,162,1
"E14AK",185,200,"1200x900",600,2,600,400,"False",897,302,441,139,139,0
"E14AK",186,587,"1200x900",1000,2,600,400,"False",741,686,438,-248,248,0
"E14AK",187,604,"1200x900",1000,2,600,400,"False",459,593,435,-158,158,0
"E14AK",188,615,"1200x900",1000,2,600,400,"False",736,634,434,-200,200,0
"E14AK",190,9,"1200x900",600,0,600,400,"False",509,654,522,-132,132,1
"E14AK",191,135,"1200x900",600,1,600,400,"True",759,569,524,-45,45,0
"E14AK",192,391,"1200x900",800,2,600,400,"False",895,521,325,-196,196,0
"E14AK",193,623,"1200x900",1000,2,600,400,"False",636,527,458,-69,69,0
"E14AK",194,8,"1200x900",600,0,600,400,"False",156,679,607,-72,72,0
"E14AK",195,548,"1200x900",1000,1,600,400,"False",103,278,541,263,263,0
"E14AK",196,67,"1200x900",600,0,600,400,"False",289,308,413,105,105,1
"E14AK",198,158,"1200x900",600,2,600,400,"False",939,300,535,235,235,0
"E14AK",199,208,"1200x900",600,2,600,400,"False",946,399,528,129,129,0
"E14AK",200,247,"1200x900",800,0,600,400,"True",160,424,447,23,23,1
"E14AK",201,475,"1200x900",1000,0,600,400,"False",101,715,598,-117,117,1
"E14AK",203,80,"1200x900",600,1,600,400,"False",616,423,559,136,136,1
"E14AK",205,410,"1200x900",800,2,600,400,"False",916,477,328,-149,149,0
"E14AK",206,590,"1200x900",1000,2,600,400,"False",636,278,544,266,266,0
"E14AK",207,24,"1200x900",600,0,600,400,"True",430,538,498,-40,40,1
"E14AK",208,310,"1200x900",800,1,600,400,"True",559,592,621,29,29,0
"E14AK",209,617,"1200x900",1000,2,600,400,"False",294,180,493,313,313,0
"E14AK",210,564,"1200x900",1000,1,600,400,"True",215,264,331,67,67,0
"E14AK",211,526,"1200x900",1000,1,600,400,"False",497,710,586,-124,124,0
"E14AK",212,163,"1200x900",600,2,600,400,"False",1046,665,379,-286,286,0
"E14AK",213,490,"1200x900",1000,0,600,400,"False",114,183,367,184,184,1
"E14AK",214,430,"1200x900",800,2,600,400,"True",922,254,328,74,74,0
"E14AK",215,370,"1200x900",800,2,600,400,"True",874,336,330,-6,6,0
"E14AK",216,103,"1200x900",600,1,600,400,"False",528,320,460,140,140,1
"E14AK",217,131,"1200x900",600,1,600,400,"False",531,367,583,216,216,0
"E14AK",218,536,"1200x900",1000,1,600,400,"False",580,213,326,113,113,0
"E14AK",219,457,"1200x900",1000,0,600,400,"False",97,630,384,-246,246,1
"E14AK",220,345,"1200x900",800,1,600,400,"False",841,566,687,121,121,1
"E14AK",221,183,"1200x900",600,2,600,400,"True",927,289,266,-23,23,0
"E14AK",222,55,"1200x900",600,0,600,400,"True",211,305,304,-1,1,1
"E14AK",223,57,"1200x900",600,0,600,400,"True",354,508,468,-40,40,1
"E14AK",224,643,"1200x900",1000,2,600,400,"False",740,325,469,144,144,0
"E14AK",225,471,"1200x900",1000,0,600,400,"False",122,200,312,112,112,1
"E14AK",226,30,"1200x900",600,0,600,400,"False",107,353,449,96,96,0
"E14AK",227,229,"1200x900",800,0,600,400,"True",117,697,670,-27,27,1
"E14AK",230,441,"1200x900",1000,0,600,400,"False",85,684,492,-192,192,1
"E14AK",231,352,"1200x900",800,1,600,400,"False",235,717,605,-112,112,0
"E14AK",232,134,"1200x900",600,1,600,400,"True",300,188,282,94,94,0
"E14AK",233,380,"1200x900",800,2,600,400,"True",942,228,266,38,38,0
"E14AK",234,112,"1200x900",600,1,600,400,"False",681,490,351,-139,139,0
"E14AK",235,94,"1200x900",600,1,600,400,"True",729,482,482,0,0,0
"E14AK",236,267,"1200x900",800,0,600,400,"True",145,665,646,-19,19,1
"E14AK",237,438,"1200x900",1000,0,600,400,"False",77,713,645,-68,68,1
"E14AK",238,641,"1200x900",1000,2,600,400,"False",897,272,646,374,374,0
"E14AK",239,256,"1200x900",800,0,600,400,"True",192,656,618,-38,38,1
"E14AK",240,404,"1200x900",800,2,600,400,"False",842,396,504,108,108,0
"E14AK",241,239,"1200x900",800,0,600,400,"False",114,231,354,123,123,1
"E14AK",242,170,"1200x900",600,2,600,400,"True",996,468,403,-65,65,0
"E14AK",243,512,"1200x900",1000,1,600,400,"False",139,261,428,167,167,0
"E14AK",244,320,"1200x900",800,1,600,400,"True",644,376,311,-65,65,0
"E14AK",245,250,"1200x900",800,0,600,400,"True",290,248,217,-31,31,1
"E14AK",246,528,"1200x900",1000,1,600,400,"True",839,227,216,-11,11,1
"E14AK",247,46,"1200x900",600,0,600,400,"True",193,355,292,-63,63,1
"E14AK",248,350,"1200x900",800,1,600,400,"True",182,566,556,-10,10,0
"E14AK",249,456,"1200x900",1000,0,600,400,"False",91,257,388,131,131,1
"E14AK",251,140,"1200x900",600,1,600,400,"True",700,523,526,3,3,0
"E14AK",254,642,"1200x900",1000,2,600,400,"False",776,316,218,-98,98,0
"E14AK",255,392,"1200x900",800,2,600,400,"True",1031,618,574,-44,44,0
"E14AK",256,282,"1200x900",800,0,600,400,"False",109,246,424,178,178,1
"E14AK",257,347,"1200x900",800,1,600,400,"True",757,295,310,15,15,1
"E14AK",258,125,"1200x900",600,1,600,400,"False",750,531,447,-84,84,0
"E14AK",259,515,"1200x900",1000,1,600,400,"False",307,217,443,226,226,0
"E14AK",260,517,"1200x900",1000,1,600,400,"False",548,182,359,177,177,0
"E14AK",261,209,"1200x900",600,2,600,400,"False",937,637,272,-365,365,0
"E14AK",262,495,"1200x900",1000,0,600,400,"False",93,692,850,158,158,1
"E14AK",271,565,"1200x900",1000,1,600,400,"False",451,562,847,285,285,0
"E14AK",272,59,"1200x900",600,0,600,400,"True",391,692,700,8,8,1
"E14AK",274,193,"1200x900",600,2,600,400,"False",874,588,665,77,77,0
"E14AK",275,121,"1200x900",600,1,600,400,"True",884,364,324,-40,40,0
"E14AK",276,439,"1200x900",1000,0,600,400,"False",110,229,323,94,94,1
"E14AK",277,425,"1200x900",800,2,600,400,"True",621,438,516,78,78,0
"E14AK",278,303,"1200x900",800,1,600,400,"False",241,431,337,-94,94,0
"E14AK",279,338,"1200x900",800,1,600,400,"True",813,253,206,-47,47,1
"E14AK",280,10,"1200x900",600,0,600,400,"False",400,499,340,-159,159,1
"E14AK",281,393,"1200x900",800,2,600,400,"True",657,620,556,-64,64,0
"E14AK",282,104,"1200x900",600,1,600,400,"False",448,584,640,56,56,0
"E14AK",283,616,"1200x900",1000,2,600,400,"False",854,357,595,238,238,1
"E14AK",284,312,"1200x900",800,1,600,400,"True",238,683,616,-67,67,0
"E14AK",285,127,"1200x900",600,1,600,400,"False",309,691,529,-162,162,0
"E14AK",286,390,"1200x900",800,2,600,400,"True",982,674,647,-27,27,1
"E14AK",287,37,"1200x900",600,0,600,400,"True",258,403,458,55,55,1
"E14AK",288,124,"1200x900",600,1,600,400,"False",345,467,281,-186,186,0
"E14AK",289,458,"1200x900",1000,0,600,400,"False",78,624,390,-234,234,1
"E14AK",290,353,"1200x900",800,1,600,400,"False",90,476,621,145,145,0
"E14AK",291,53,"1200x900",600,0,600,400,"False",177,189,384,195,195,0
"E14AK",292,198,"1200x900",600,2,600,400,"False",976,500,391,-109,109,0
"E14AK",294,571,"1200x900",1000,1,600,400,"False",239,522,634,112,112,1
"E14AK",295,366,"1200x900",800,2,600,400,"False",931,464,312,-152,152,0
"E14AK",296,405,"1200x900",800,2,600,400,"False",790,307,454,147,147,0
"E14AK",297,568,"1200x900",1000,1,600,400,"False",286,475,586,111,111,1
"E14AK",298,99,"1200x900",600,1,600,400,"True",811,407,457,50,50,0
"E14AK",299,322,"1200x900",800,1,600,400,"False",703,206,394,188,188,1
"E14AK",300,497,"1200x900",1000,0,600,400,"True",106,696,638,-58,58,1
"E14AK",301,619,"1200x900",1000,2,600,400,"False",803,247,505,258,258,0
"E14AK",302,381,"1200x900",800,2,600,400,"True",705,408,391,-17,17,0
"E14AK",303,161,"1200x900",600,2,600,400,"False",939,553,691,138,138,0
"E14AK",304,583,"1200x900",1000,2,600,400,"False",949,284,178,-106,106,1
"E14AK",305,395,"1200x900",800,2,600,400,"False",743,334,595,261,261,0
"E14AK",306,569,"1200x900",1000,1,600,400,"False",494,720,462,-258,258,0
"E14AK",307,165,"1200x900",600,2,600,400,"False",912,554,664,110,110,0
"E14AK",308,235,"1200x900",800,0,600,400,"False",146,646,442,-204,204,1
"E14AK",309,327,"1200x900",800,1,600,400,"True",152,339,417,78,78,0
"E14AK",310,146,"1200x900",600,2,600,400,"False",989,492,416,-76,76,0
"E14AK",311,117,"1200x900",600,1,600,400,"True",711,456,422,-34,34,0
"E14AK",312,11,"1200x900",600,0,600,400,"False",372,670,542,-128,128,1
"E14AK",313,27,"1200x900",600,0,600,400,"False",373,309,470,161,161,1
"E14AK",314,423,"1200x900",800,2,600,400,"True",1051,710,607,-103,103,1
"E14AK",315,417,"1200x900",800,2,600,400,"False",750,280,386,106,106,0
"E14AK",316,71,"1200x900",600,0,600,400,"True",219,248,283,35,35,0
"E14AK",317,13,"1200x900",600,0,600,400,"False",296,211,282,71,71,1
"E14AK",319,516,"1200x900",1000,1,600,400,"False",440,559,391,-168,168,0
"E14AK",320,449,"1200x900",1000,0,600,400,"True",105,683,626,-57,57,1
"E14AK",321,594,"1200x900",1000,2,600,400,"False",537,637,530,-107,107,0
"E14AK",322,487,"1200x900",1000,0,600,400,"False",78,670,547,-123,123,1
"E14AK",323,236,"1200x900",800,0,600,400,"True",162,350,342,-8,8,1
"E14AK",325,178,"1200x900",600,2,600,400,"False",1041,510,691,181,181,0
"E14AK",326,556,"1200x900",1000,1,600,400,"True",415,420,495,75,75,0
"E14AK",327,371,"1200x900",800,2,600,400,"False",730,560,474,-86,86,0
"E14AK",328,578,"1200x900",1000,2,600,400,"False",966,276,571,295,295,0
"E14AK",329,535,"1200x900",1000,1,600,400,"True",372,410,381,-29,29,0
"E14AK",330,499,"1200x900",1000,0,600,400,"False",93,271,342,71,71,1
"E14AK",331,541,"1200x900",1000,1,600,400,"False",339,478,688,210,210,0
"E14AK",332,608,"1200x900",1000,2,600,400,"False",742,250,583,333,333,0
"E14AK",333,454,"1200x900",1000,0,600,400,"False",78,687,487,-200,200,1
"E14AK",334,284,"1200x900",800,0,600,400,"True",135,293,332,39,39,1
"E14AK",335,339,"1200x900",800,1,600,400,"True",273,545,557,12,12,1
"E14AK",337,553,"1200x900",1000,1,600,400,"False",116,712,290,-422,422,0
"E14AK",338,189,"1200x900",600,2,600,400,"True",881,397,408,11,11,0
"E14AK",341,95,"1200x900",600,1,600,400,"True",749,425,418,-7,7,1
"E14AK",342,538,"1200x900",1000,1,600,400,"False",308,457,303,-154,154,1
"E14AK",343,551,"1200x900",1000,1,600,400,"False",146,445,608,163,163,1
"E14AK",344,509,"1200x900",1000,1,600,400,"True",509,434,501,67,67,0
"E14AK",345,609,"1200x900",1000,2,600,400,"False",697,627,500,-127,127,0
"E14AK",347,581,"1200x900",1000,2,600,400,"False",310,357,498,141,141,0
"E14AK",348,192,"1200x900",600,2,600,400,"False",1064,320,643,323,323,0
"E14AK",349,463,"1200x900",1000,0,600,400,"True",115,693,642,-51,51,1
"E14AK",350,611,"1200x900",1000,2,600,400,"True",414,511,543,32,32,0
"E14AK",352,26,"1200x900",600,0,600,400,"False",70,712,626,-86,86,0
"E14AK",353,402,"1200x900",800,2,600,400,"False",878,234,428,194,194,0
"E14AK",354,354,"1200x900",800,1,600,400,"False",118,236,426,190,190,0
"E14AK",355,361,"1200x900",800,2,600,400,"False",931,328,425,97,97,0
"E14AK",359,160,"1200x900",600,2,600,400,"False",863,606,384,-222,222,0
"E14AK",360,145,"1200x900",600,2,600,400,"True",1004,630,614,-16,16,0
"E14AK",361,537,"1200x900",1000,1,600,400,"False",621,412,568,156,156,1
"E14AK",362,576,"1200x900",1000,1,600,400,"False",376,713,514,-199,199,0
"E14AK",363,129,"1200x900",600,1,600,400,"False",859,482,259,-223,223,1
"E14AK",364,433,"1200x900",1000,0,600,400,"False",76,222,392,170,170,1
"E14AK",365,355,"1200x900",800,1,600,400,"True",77,386,390,4,4,0
"E14AK",366,399,"1200x900",800,2,600,400,"True",603,602,566,-36,36,0
"E14AK",367,321,"1200x900",800,1,600,400,"False",601,190,307,117,117,0
"E14AK",368,518,"1200x900",1000,1,600,400,"True",583,717,670,-47,47,0
"E14AK",369,434,"1200x900",1000,0,600,400,"False",89,657,526,-131,131,1
"E14AK",370,336,"1200x900",800,1,600,400,"True",251,587,534,-53,53,0
"E14AK",371,132,"1200x900",600,1,600,400,"False",333,185,314,129,129,0
"E14AK",372,142,"1200x900",600,1,600,400,"True",286,474,430,-44,44,0
"E14AK",373,529,"1200x900",1000,1,600,400,"True",267,412,431,19,19,1
"E14AK",375,61,"1200x900",600,0,600,400,"False",272,670,498,-172,172,1
"E14AK",376,386,"1200x900",800,2,600,400,"False",774,301,499,198,198,0
"E14AK",377,14,"1200x900",600,0,600,400,"False",399,224,285,61,61,1
"E14AK",378,540,"1200x900",1000,1,600,400,"True",389,568,515,-53,53,1
"E14AK",379,525,"1200x900",1000,1,600,400,"False",123,690,486,-204,204,0
"E14AK",380,114,"1200x900",600,1,600,400,"False",183,697,406,-291,291,0
"E14AK",381,369,"1200x900",800,2,600,400,"False",903,594,407,-187,187,0
"E14AK",382,542,"1200x900",1000,1,600,400,"False",304,401,150,-251,251,0
"E14AK",383,102,"1200x900",600,1,600,400,"False",861,603,290,-313,313,0
"E14AK",385,574,"1200x900",1000,1,600,400,"False",614,194,405,211,211,0
"E14AK",386,397,"1200x900",800,2,600,400,"False",817,692,458,-234,234,0
"E14AK",387,319,"1200x900",800,1,600,400,"True",494,587,439,-148,148,1
"E14AK",388,203,"1200x900",600,2,600,400,"True",938,603,645,42,42,0
"E14AK",391,184,"1200x900",600,2,600,400,"False",1067,441,623,182,182,0
"E14AK",392,76,"1200x900",600,1,600,400,"True",647,614,635,21,21,0
"E14AK",393,199,"1200x900",600,2,600,400,"False",992,467,338,-129,129,0
"E14AK",394,378,"1200x900",800,2,600,400,"True",1018,708,696,-12,12,0
"E14AK",395,93,"1200x900",600,1,600,400,"True",139,540,499,-41,41,0
"E14AK",398,286,"1200x900",800,0,600,400,"True",105,378,385,7,7,1
"E14AK",399,488,"1200x900",1000,0,600,400,"False",129,687,575,-112,112,1
"E14AK",400,413,"1200x900",800,2,600,400,"False",849,506,409,-97,97,0
"E14AK",402,68,"1200x900",600,0,600,400,"True",165,367,388,21,21,0
"E14AK",403,431,"1200x900",800,2,600,400,"True",694,382,387,5,5,0
"E14AK",404,530,"1200x900",1000,1,600,400,"False",584,405,542,137,137,1
"E14AK",405,432,"1200x900",800,2,600,400,"True",792,380,330,-50,50,0
"E14AK",406,82,"1200x900",600,1,600,400,"True",108,213,248,35,35,0
"E14AK",407,625,"1200x900",1000,2,600,400,"False",279,228,329,101,101,0
"E14AK",408,287,"1200x900",800,0,600,400,"False",120,567,499,-68,68,1
"E14AK",409,547,"1200x900",1000,1,600,400,"True",369,384,353,-31,31,1
"E14AK",410,133,"1200x900",600,1,600,400,"False",345,551,354,-197,197,0
"E14AK",411,204,"1200x900",600,2,600,400,"False",1053,432,309,-123,123,0
"E14AK",412,36,"1200x900",600,0,600,400,"True",128,346,308,-38,38,1
"E14AK",413,559,"1200x900",1000,1,600,400,"True",641,244,274,30,30,0
"E14AK",414,636,"1200x900",1000,2,600,400,"False",575,583,273,-310,310,0
"E14AK",415,603,"1200x900",1000,2,600,400,"False",693,280,386,106,106,0
"E14AK",416,513,"1200x900",1000,1,600,400,"False",235,602,301,-301,301,0
"E14AK",417,73,"1200x900",600,1,600,400,"False",94,665,553,-112,112,0
"E14AK",418,325,"1200x900",800,1,600,400,"True",105,394,429,35,35,0
"E14AK",419,248,"1200x900",800,0,600,400,"False",94,240,320,80,80,1
"E14AK",420,372,"1200x900",800,2,600,400,"False",833,620,324,-296,296,0
"E14AK",421,293,"1200x900",800,1,600,400,"False",561,396,496,100,100,0
"E14AK",422,318,"1200x900",800,1,600,400,"True",788,534,501,-33,33,0
"E14AK",423,289,"1200x900",800,1,600,400,"True",421,703,679,-24,24,1
"E14AK",424,105,"1200x900",600,1,600,400,"False",527,440,643,203,203,0
"E14AK",425,377,"1200x900",800,2,600,400,"True",683,388,470,82,82,0
"E14AK",426,467,"1200x900",1000,0,600,400,"False",74,712,532,-180,180,1
"E14AK",427,589,"1200x900",1000,2,600,400,"True",856,418,388,-30,30,0
"E14AK",428,450,"1200x900",1000,0,600,400,"False",130,204,282,78,78,1
"E14AK",429,42,"1200x900",600,0,600,400,"True",233,479,435,-44,44,0
"E14AK",430,437,"1200x900",1000,0,600,400,"False",74,667,593,-74,74,1
"E14AK",431,4,"1200x900",600,0,600,400,"False",602,200,330,130,130,1
"E14AK",432,153,"1200x900",600,2,600,400,"True",1037,601,644,43,43,0
"E14AK",433,421,"1200x900",800,2,600,400,"False",898,394,506,112,112,0
"E14AK",434,491,"1200x900",1000,0,600,400,"False",108,198,357,159,159,1
"E14AK",435,545,"1200x900",1000,1,600,400,"False",358,562,641,79,79,0
"E14AK",437,514,"1200x900",1000,1,600,400,"False",539,690,559,-131,131,0
"E14AK",438,242,"1200x900",800,0,600,400,"True",117,448,426,-22,22,1
"E14AK",439,44,"1200x900",600,0,600,400,"False",305,554,486,-68,68,1
"E14AK",440,647,"1200x900",1000,2,600,400,"False",560,637,503,-134,134,0
"E14AK",441,297,"1200x900",800,1,600,400,"False",625,244,394,150,150,0
"E14AK",443,436,"1200x900",1000,0,600,400,"False",82,617,470,-147,147,1
"E14AK",444,157,"1200x900",600,2,600,400,"False",1016,323,468,145,145,0
"E14AK",446,479,"1200x900",1000,0,600,400,"False",74,705,566,-139,139,1
"E14AK",447,595,"1200x900",1000,2,600,400,"False",687,640,371,-269,269,0
"E14AK",448,88,"1200x900",600,1,600,400,"True",186,554,470,-84,84,0
"E14AK",449,181,"1200x900",600,2,600,400,"False",1018,223,386,163,163,0
"E14AK",450,365,"1200x900",800,2,600,400,"False",1055,305,600,295,295,0
"E14AK",451,558,"1200x900",1000,1,600,400,"False",72,464,373,-91,91,1
"E14AK",452,237,"1200x900",800,0,600,400,"True",204,481,453,-28,28,1
"E14AK",453,605,"1200x900",1000,2,600,400,"False",493,665,528,-137,137,0
"E14AK",454,107,"1200x900",600,1,600,400,"True",878,678,653,-25,25,0
"E14AK",455,89,"1200x900",600,1,600,400,"False",917,366,554,188,188,1
"E14AK",456,444,"1200x900",1000,0,600,400,"False",101,714,493,-221,221,1
"E14AK",457,45,"1200x900",600,0,600,400,"False",487,678,594,-84,84,1
"E14AK",458,635,"1200x900",1000,2,600,400,"True",833,402,380,-22,22,0
"E14AK",459,29,"1200x900",600,0,600,400,"True",385,533,518,-15,15,1
"E14AK",460,220,"1200x900",800,0,600,400,"False",108,699,600,-99,99,1
"E14AK",461,613,"1200x900",1000,2,600,400,"False",690,374,467,93,93,0
"E14AK",462,65,"1200x900",600,0,600,400,"True",442,645,609,-36,36,1
"E14AK",464,264,"1200x900",800,0,600,400,"True",198,660,606,-54,54,1
"E14AK",466,285,"1200x900",800,0,600,400,"False",237,396,495,99,99,1
"E14AK",467,78,"1200x900",600,1,600,400,"True",885,684,615,-69,69,0
"E14AK",468,359,"1200x900",800,1,600,400,"False",653,241,611,370,370,0
"E14AK",469,478,"1200x900",1000,0,600,400,"False",79,672,483,-189,189,1
"E14AK",470,639,"1200x900",1000,2,600,400,"True",504,456,429,-27,27,0
"E14AK",471,534,"1200x900",1000,1,600,400,"False",328,504,312,-192,192,1
"E14AK",472,143,"1200x900",600,1,600,400,"False",479,284,372,88,88,1
"E14AK",473,148,"1200x900",600,2,600,400,"True",907,330,289,-41,41,0
"E14AK",474,225,"1200x900",800,0,600,400,"True",178,423,363,-60,60,1
"E14AK",475,253,"1200x900",800,0,600,400,"True",177,424,434,10,10,1
"E14AK",476,268,"1200x900",800,0,600,400,"True",148,400,407,7,7,1
"E14AK",477,523,"1200x900",1000,1,600,400,"False",339,318,534,216,216,0
"E14AK",478,150,"1200x900",600,2,600,400,"False",897,345,441,96,96,0
"E14AK",479,332,"1200x900",800,1,600,400,"False",260,699,527,-172,172,0
"E14AK",480,50,"1200x900",600,0,600,400,"True",75,582,545,-37,37,0
"E14AK",481,7,"1200x900",600,0,600,400,"False",431,654,580,-74,74,1
"E14AK",482,480,"1200x900",1000,0,600,400,"False",100,231,403,172,172,1
"E14AK",483,259,"1200x900",800,0,600,400,"False",156,180,290,110,110,1
"E14AK",484,337,"1200x900",800,1,600,400,"False",299,622,477,-145,145,0
"E14AK",485,238,"1200x900",800,0,600,400,"False",162,283,386,103,103,1
"E14AK",486,577,"1200x900",1000,2,600,400,"False",455,420,520,100,100,0
"E14AK",487,531,"1200x900",1000,1,600,400,"False",233,362,469,107,107,0
"E14AK",488,382,"1200x900",800,2,600,400,"False",870,523,397,-126,126,0
"E14AK",489,621,"1200x900",1000,2,600,400,"False",540,478,396,-82,82,0
"E14AK",490,138,"1200x900",600,1,600,400,"True",844,580,619,39,39,1
"E14AK",491,188,"1200x900",600,2,600,400,"False",900,195,304,109,109,0
"E14AK",492,214,"1200x900",600,2,600,400,"False",1046,305,93,-212,212,0
"E14AK",493,468,"1200x900",1000,0,600,400,"False",121,219,369,150,150,1
"E14AK",494,384,"1200x900",800,2,600,400,"False",821,707,412,-295,295,0
"E14AK",495,406,"1200x900",800,2,600,400,"False",971,233,482,249,249,0
"E14AK",496,66,"1200x900",600,0,600,400,"False",155,673,558,-115,115,0
"E14AK",499,51,"1200x900",600,0,600,400,"True",272,181,214,33,33,1
"E14AK",501,496,"1200x900",1000,0,600,400,"False",70,639,500,-139,139,1
"E14AK",502,363,"1200x900",800,2,600,400,"True",800,218,266,48,48,0
"E14AK",503,580,"1200x900",1000,2,600,400,"False",651,267,533,266,266,0
"E14AK",504,294,"1200x900",800,1,600,400,"False",262,287,434,147,147,0
"E14AK",505,638,"1200x900",1000,2,600,400,"False",385,198,435,237,237,0
"E14AK",506,300,"1200x900",800,1,600,400,"False",620,693,499,-194,194,0
"E14AK",507,521,"1200x900",1000,1,600,400,"True",111,303,299,-4,4,1
"E14AK",510,544,"1200x900",1000,1,600,400,"True",602,620,631,11,11,0
"E14AK",511,190,"1200x900",600,2,600,400,"True",977,238,267,29,29,0
"E14AK",512,572,"1200x900",1000,1,600,400,"False",302,260,181,-79,79,0
"E14AK",513,630,"1200x900",1000,2,600,400,"False",754,559,452,-107,107,0
"E14AK",514,28,"1200x900",600,0,600,400,"True",336,410,409,-1,1,1
"E14AK",515,305,"1200x900",800,1,600,400,"False",471,716,637,-79,79,0
"E14AK",516,77,"1200x900",600,1,600,400,"False",780,525,350,-175,175,0
"E14AK",517,400,"1200x900",800,2,600,400,"False",733,297,458,161,161,0
"E14AK",518,486,"1200x900",1000,0,600,400,"True",102,676,636,-40,40,1
"E14AK",519,506,"1200x900",1000,1,600,400,"False",559,567,394,-173,173,1
"E14AK",520,290,"1200x900",800,1,600,400,"True",789,603,622,19,19,0
"E14AK",521,40,"1200x900",600,0,600,400,"True",143,513,530,17,17,0
"E14AK",522,562,"1200x900",1000,1,600,400,"True",347,540,497,-43,43,0
"E14AK",523,644,"1200x900",1000,2,600,400,"False",495,486,374,-112,112,0
"E14AK",524,6,"1200x900",600,0,600,400,"False",217,689,618,-71,71,1
"E14AK",525,306,"1200x900",800,1,600,400,"True",164,524,522,-2,2,0
"E14AK",526,330,"1200x900",800,1,600,400,"True",759,301,290,-11,11,1
"E14AK",527,426,"1200x900",800,2,600,400,"False",830,263,440,177,177,0
"E14AK",528,360,"1200x900",800,1,600,400,"False",203,608,444,-164,164,0
"E14AK",529,308,"1200x900",800,1,600,400,"True",437,425,424,-1,1,0
"E14AK",531,273,"1200x900",800,0,600,400,"True",180,309,315,6,6,1
"E14AK",532,314,"1200x900",800,1,600,400,"True",277,616,582,-34,34,1
"E14AK",533,483,"1200x900",1000,0,600,400,"False",93,191,461,270,270,1
"E14AK",534,258,"1200x900",800,0,600,400,"True",126,664,641,-23,23,1
"E14AK",535,34,"1200x900",600,0,600,400,"True",361,242,292,50,50,1
"E14AK",536,205,"1200x900",600,2,600,400,"True",1021,504,518,14,14,0
"E14AK",537,443,"1200x900",1000,0,600,400,"False",99,651,560,-91,91,1
"E14AK",538,618,"1200x900",1000,2,600,400,"False",276,671,559,-112,112,0
"E14AK",540,343,"1200x900",800,1,600,400,"False",407,557,425,-132,132,0
"E14AK",541,389,"1200x900",800,2,600,400,"True",843,530,609,79,79,0
"E14AK",542,527,"1200x900",1000,1,600,400,"True",565,601,541,-60,60,0
"E14AK",543,342,"1200x900",800,1,600,400,"False",677,204,369,165,165,0
"E14AK",544,317,"1200x900",800,1,600,400,"False",185,564,670,106,106,0
"E14AK",545,182,"1200x900",600,2,600,400,"True",933,389,352,-37,37,0
"E14AK",546,601,"1200x900",1000,2,600,400,"False",735,697,580,-117,117,0
"E14AK",548,346,"1200x900",800,1,600,400,"True",269,635,550,-85,85,0
"E14AK",549,177,"1200x900",600,2,600,400,"False",912,236,379,143,143,0
"E14AK",550,35,"1200x900",600,0,600,400,"True",366,555,494,-61,61,1
"E14AK",551,414,"1200x900",800,2,600,400,"False",831,592,357,-235,235,0
"E14AK",552,543,"1200x900",1000,1,600,400,"False",88,202,445,243,243,0
"E14AK",553,141,"1200x900",600,1,600,400,"True",671,582,630,48,48,0
"E14AK",554,524,"1200x900",1000,1,600,400,"True",534,470,430,-40,40,0
"E14AK",555,302,"1200x900",800,1,600,400,"True",479,467,429,-38,38,1
"E14AK",556,241,"1200x900",800,0,600,400,"False",129,227,365,138,138,1
"E14AK",559,179,"1200x900",600,2,600,400,"False",908,602,468,-134,134,0
"E14AK",560,191,"1200x900",600,2,600,400,"False",962,396,324,-72,72,0
"E14AK",561,108,"1200x900",600,1,600,400,"True",830,239,243,4,4,0
"E14AK",562,187,"1200x900",600,2,600,400,"False",857,639,539,-100,100,0
"E14AK",563,600,"1200x900",1000,2,600,400,"False",765,207,406,199,199,0
"E14AK",565,276,"1200x900",800,0,600,400,"False",281,217,346,129,129,1
"E14AK",566,508,"1200x900",1000,1,600,400,"True",596,485,498,13,13,0
"E14AK",567,136,"1200x900",600,1,600,400,"True",264,205,223,18,18,0
"E14AK",568,69,"1200x900",600,0,600,400,"True",322,268,302,34,34,0
"E14AK",569,586,"1200x900",1000,2,600,400,"False",802,262,401,139,139,0
"E14AK",570,387,"1200x900",800,2,600,400,"False",990,444,234,-210,210,0
"E14AK",571,231,"1200x900",800,0,600,400,"False",251,718,513,-205,205,1
"E14AK",572,464,"1200x900",1000,0,600,400,"False",82,222,324,102,102,1
"E14AK",573,252,"1200x900",800,0,600,400,"False",224,673,600,-73,73,1
"E14AK",574,383,"1200x900",800,2,600,400,"False",855,407,485,78,78,0
"E14AK",575,374,"1200x900",800,2,600,400,"True",755,450,484,34,34,0
"E14AK",576,445,"1200x900",1000,0,600,400,"True",78,302,362,60,60,1
"E14AK",577,279,"1200x900",800,0,600,400,"False",252,202,335,133,133,1
"E14AK",578,126,"1200x900",600,1,600,400,"False",849,354,502,148,148,0
"E14AK",579,476,"1200x900",1000,0,600,400,"True",76,359,372,13,13,1
"E14AK",581,52,"1200x900",600,0,600,400,"False",171,188,288,100,100,0
"E14AK",582,591,"1200x900",1000,2,600,400,"True",698,336,287,-49,49,0
"E14AK",583,331,"1200x900",800,1,600,400,"True",240,620,574,-46,46,0
"E14AK",584,269,"1200x900",800,0,600,400,"True",160,295,335,40,40,1
"E14AK",585,123,"1200x900",600,1,600,400,"False",761,365,271,-94,94,1
"E14AK",586,324,"1200x900",800,1,600,400,"False",719,712,358,-354,354,1
"E14AK",587,152,"1200x900",600,2,600,400,"False",971,399,323,-76,76,0
"E14AK",588,307,"1200x900",800,1,600,400,"True",716,247,291,44,44,0
"E14AK",589,492,"1200x900",1000,0,600,400,"False",76,692,530,-162,162,1
"E14AK",590,459,"1200x900",1000,0,600,400,"False",70,645,487,-158,158,1
"E14AK",591,217,"1200x900",800,0,600,400,"True",85,573,525,-48,48,1
"E14AK",592,18,"1200x900",600,0,600,400,"False",400,318,419,101,101,1
"E14AK",593,557,"1200x900",1000,1,600,400,"True",677,505,392,-113,113,1
"E14AK",594,43,"1200x900",600,0,600,400,"True",277,446,443,-3,3,1
"E14AK",595,637,"1200x900",1000,2,600,400,"True",750,460,444,-16,16,0
"E14AK",596,155,"1200x900",600,2,600,400,"True",940,269,317,48,48,0
"E14AK",598,563,"1200x900",1000,1,600,400,"True",201,696,634,-62,62,0
"E14AK",599,485,"1200x900",1000,0,600,400,"False",121,694,519,-175,175,1
"E14AK",600,206,"1200x900",600,2,600,400,"True",975,223,256,33,33,0
"E14AK",601,130,"1200x900",600,1,600,400,"True",741,428,402,-26,26,0
"E14AK",602,240,"1200x900",800,0,600,400,"False",330,656,499,-157,157,1
"E14AK",603,411,"1200x900",800,2,600,400,"False",805,361,541,180,180,0
"E14AK",604,194,"1200x900",600,2,600,400,"True",896,236,308,72,72,0
"E14AK",605,394,"1200x900",800,2,600,400,"False",847,292,485,193,193,0
"E14AK",606,223,"1200x900",800,0,600,400,"True",179,191,208,17,17,1
"E14AK",607,120,"1200x900",600,1,600,400,"True",690,655,636,-19,19,0
"E14AK",608,226,"1200x900",800,0,600,400,"False",187,229,330,101,101,1
"E14AK",609,607,"1200x900",1000,2,600,400,"False",900,573,742,169,169,1
"E14AK",610,575,"1200x900",1000,1,600,400,"True",272,693,633,-60,60,0
"E14AK",611,645,"1200x900",1000,2,600,400,"True",619,396,422,26,26,0
"E14AK",612,213,"1200x900",600,2,600,400,"False",822,275,485,210,210,0
"E14AK",613,588,"1200x900",1000,2,600,400,"False",585,350,494,144,144,0
"E14AK",614,440,"1200x900",1000,0,600,400,"False",71,237,320,83,83,1
"E14AK",615,482,"1200x900",1000,0,600,400,"False",79,686,407,-279,279,1
"E14AK",616,266,"1200x900",800,0,600,400,"True",126,303,364,61,61,1
"E14AK",617,19,"1200x900",600,0,600,400,"False",286,686,570,-116,116,0
"E14AK",618,298,"1200x900",800,1,600,400,"False",311,457,366,-91,91,0
"E14AK",619,63,"1200x900",600,0,600,400,"True",311,188,244,56,56,1
"E14AK",620,271,"1200x900",800,0,600,400,"True",74,360,327,-33,33,1
"E14AK",621,626,"1200x900",1000,2,600,400,"False",329,449,322,-127,127,0
"E14AK",622,579,"1200x900",1000,2,600,400,"False",803,394,509,115,115,0
"E14AK",623,472,"1200x900",1000,0,600,400,"False",77,685,508,-177,177,1
"E14AK",624,31,"1200x900",600,0,600,400,"True",365,338,381,43,43,1
"E14AK",625,255,"1200x900",800,0,600,400,"False",93,709,611,-98,98,1
"E14AK",626,292,"1200x900",800,1,600,400,"True",88,565,517,-48,48,0
"E14AK",627,451,"1200x900",1000,0,600,400,"False",110,702,562,-140,140,1
"E14AK",628,348,"1200x900",800,1,600,400,"True",764,294,293,-1,1,0
"E14AK",629,207,"1200x900",600,2,600,400,"True",838,235,294,59,59,0
"E14AK",630,25,"1200x900",600,0,600,400,"True",263,403,361,-42,42,1
"E14AK",631,281,"1200x900",800,0,600,400,"False",112,611,527,-84,84,1
"E14AK",633,335,"1200x900",800,1,600,400,"True",124,360,403,43,43,0
"E14AK",634,151,"1200x900",600,2,600,400,"False",828,680,399,-281,281,0
"E14AK",636,315,"1200x900",800,1,600,400,"False",105,211,457,246,246,0
"E14AK",637,408,"1200x900",800,2,600,400,"False",758,567,410,-157,157,0
"E14AK",638,245,"1200x900",800,0,600,400,"False",296,235,327,92,92,1
"E14AK",639,48,"1200x900",600,0,600,400,"False",323,645,542,-103,103,1
"E14AK",640,113,"1200x900",600,1,600,400,"True",897,657,687,30,30,0
"E14AK",641,195,"1200x900",600,2,600,400,"False",942,249,347,98,98,0
"E14AK",642,70,"1200x900",600,0,600,400,"True",309,703,660,-43,43,1
"E14AK",643,484,"1200x900",1000,0,600,400,"False",100,223,455,232,232,1
"E14AK",644,115,"1200x900",600,1,600,400,"False",545,307,195,-112,112,0
"E14AK",645,144,"1200x900",600,1,600,400,"True",718,371,410,39,39,0
"E14AK",646,328,"1200x900",800,1,600,400,"True",104,649,601,-48,48,0
"E14AK",647,106,"1200x900",600,1,600,400,"False",803,659,550,-109,109,1
"E14AK",648,469,"1200x900",1000,0,600,400,"False",73,227,446,219,219,1
"E15MS",1,446,"1200x900",1000,0,600,400,"False",72,298,176,-122,122,1
"E15MS",2,348,"1200x900",800,1,600,400,"False",764,294,126,-168,168,0
"E15MS",3,57,"1200x900",600,0,600,400,"True",354,508,491,-17,17,1
"E15MS",4,315,"1200x900",800,1,600,400,"False",105,211,366,155,155,0
"E15MS",5,173,"1200x900",600,2,600,400,"False",948,693,559,-134,134,0
"E15MS",6,59,"1200x900",600,0,600,400,"True",391,692,712,20,20,1
"E15MS",7,582,"1200x900",1000,2,600,400,"False",554,347,496,149,149,0
"E15MS",8,632,"1200x900",1000,2,600,400,"False",984,227,563,336,336,0
"E15MS",9,299,"1200x900",800,1,600,400,"False",779,274,595,321,321,0
"E15MS",10,429,"1200x900",800,2,600,400,"False",682,692,596,-96,96,0
"E15MS",11,321,"1200x900",800,1,600,400,"True",601,190,162,-28,28,0
"E15MS",12,488,"1200x900",1000,0,600,400,"False",129,687,429,-258,258,1
"E15MS",13,449,"1200x900",1000,0,600,400,"False",105,683,542,-141,141,1
"E15MS",14,46,"1200x900",600,0,600,400,"True",193,355,381,26,26,1
"E15MS",15,205,"1200x900",600,2,600,400,"False",1021,504,599,95,95,0
"E15MS",16,164,"1200x900",600,2,600,400,"False",1051,268,174,-94,94,0
"E15MS",17,579,"1200x900",1000,2,600,400,"False",803,394,453,59,59,0
"E15MS",18,466,"1200x900",1000,0,600,400,"True",82,205,237,32,32,1
"E15MS",19,444,"1200x900",1000,0,600,400,"False",101,714,515,-199,199,1
"E15MS",20,453,"1200x900",1000,0,600,400,"True",71,393,431,38,38,1
"E15MS",21,153,"1200x900",600,2,600,400,"True",1037,601,558,-43,43,0
"E15MS",22,125,"1200x900",600,1,600,400,"True",750,531,529,-2,2,0
"E15MS",23,75,"1200x900",600,1,600,400,"True",635,558,530,-28,28,0
"E15MS",24,533,"1200x900",1000,1,600,400,"False",355,483,319,-164,164,0
"E15MS",25,393,"1200x900",800,2,600,400,"False",657,620,387,-233,233,0
"E15MS",26,65,"1200x900",600,0,600,400,"True",442,645,645,0,0,1
"E15MS",27,648,"1200x900",1000,2,600,400,"False",557,394,569,175,175,0
"E15MS",28,296,"1200x900",800,1,600,400,"False",89,279,407,128,128,0
"E15MS",29,149,"1200x900",600,2,600,400,"True",890,289,301,12,12,0
"E15MS",30,272,"1200x900",800,0,600,400,"True",200,181,146,-35,35,1
"E15MS",31,570,"1200x900",1000,1,600,400,"True",315,352,311,-41,41,0
"E15MS",32,576,"1200x900",1000,1,600,400,"False",376,713,641,-72,72,0
"E15MS",33,236,"1200x900",800,0,600,400,"True",162,350,349,-1,1,1
"E15MS",34,498,"1200x900",1000,0,600,400,"True",100,260,237,-23,23,1
"E15MS",35,503,"1200x900",1000,0,600,400,"True",86,279,303,24,24,1
"E15MS",36,133,"1200x900",600,1,600,400,"False",345,551,619,68,68,0
"E15MS",37,586,"1200x900",1000,2,600,400,"False",802,262,543,281,281,0
"E15MS",38,1,"1200x900",600,0,600,400,"True",136,502,519,17,17,0
"E15MS",40,335,"1200x900",800,1,600,400,"True",124,360,377,17,17,0
"E15MS",41,69,"1200x900",600,0,600,400,"True",322,268,281,13,13,0
"E15MS",42,373,"1200x900",800,2,600,400,"False",694,326,461,135,135,0
"E15MS",43,295,"1200x900",800,1,600,400,"False",471,334,464,130,130,0
"E15MS",44,14,"1200x900",600,0,600,400,"False",399,224,305,81,81,1
"E15MS",45,555,"1200x900",1000,1,600,400,"True",444,556,524,-32,32,0
"E15MS",46,467,"1200x900",1000,0,600,400,"True",74,712,679,-33,33,1
"E15MS",47,538,"1200x900",1000,1,600,400,"False",308,457,567,110,110,1
"E15MS",48,89,"1200x900",600,1,600,400,"False",917,366,467,101,101,1
"E15MS",49,381,"1200x900",800,2,600,400,"True",705,408,473,65,65,0
"E15MS",50,549,"1200x900",1000,1,600,400,"True",657,366,355,-11,11,0
"E15MS",51,238,"1200x900",800,0,600,400,"True",162,283,346,63,63,1
"E15MS",52,40,"1200x900",600,0,600,400,"True",143,513,536,23,23,0
"E15MS",53,330,"1200x900",800,1,600,400,"True",759,301,373,72,72,1
"E15MS",54,510,"1200x900",1000,1,600,400,"True",486,338,386,48,48,1
"E15MS",55,85,"1200x900",600,1,600,400,"False",434,347,594,247,247,0
"E15MS",56,250,"1200x900",800,0,600,400,"False",290,248,354,106,106,1
"E15MS",57,147,"1200x900",600,2,600,400,"False",942,418,541,123,123,0
"E15MS",58,137,"1200x900",600,1,600,400,"True",789,577,612,35,35,0
"E15MS",59,86,"1200x900",600,1,600,400,"True",692,388,418,30,30,1
"E15MS",60,99,"1200x900",600,1,600,400,"False",811,407,498,91,91,0
"E15MS",61,13,"1200x900",600,0,600,400,"False",296,211,277,66,66,1
"E15MS",62,116,"1200x900",600,1,600,400,"True",767,289,310,21,21,0
"E15MS",63,371,"1200x900",800,2,600,400,"False",730,560,480,-80,80,0
"E15MS",64,128,"1200x900",600,1,600,400,"True",661,258,234,-24,24,1
"E15MS",65,121,"1200x900",600,1,600,400,"True",884,364,347,-17,17,0
"E15MS",66,410,"1200x900",800,2,600,400,"False",916,477,314,-163,163,0
"E15MS",67,340,"1200x900",800,1,600,400,"True",226,240,289,49,49,0
"E15MS",68,303,"1200x900",800,1,600,400,"False",241,431,517,86,86,0
"E15MS",69,600,"1200x900",1000,2,600,400,"False",765,207,269,62,62,0
"E15MS",70,136,"1200x900",600,1,600,400,"True",264,205,270,65,65,0
"E15MS",71,401,"1200x900",800,2,600,400,"True",821,260,254,-6,6,0
"E15MS",72,541,"1200x900",1000,1,600,400,"False",339,478,388,-90,90,0
"E15MS",73,402,"1200x900",800,2,600,400,"False",878,234,463,229,229,0
"E15MS",74,298,"1200x900",800,1,600,400,"True",311,457,496,39,39,0
"E15MS",75,176,"1200x900",600,2,600,400,"True",1033,281,318,37,37,0
"E15MS",76,564,"1200x900",1000,1,600,400,"True",215,264,317,53,53,0
"E15MS",77,48,"1200x900",600,0,600,400,"True",323,645,604,-41,41,1
"E15MS",78,583,"1200x900",1000,2,600,400,"False",949,284,141,-143,143,1
"E15MS",79,577,"1200x900",1000,2,600,400,"True",455,420,442,22,22,0
"E15MS",80,36,"1200x900",600,0,600,400,"True",128,346,319,-27,27,1
"E15MS",81,276,"1200x900",800,0,600,400,"False",281,217,335,118,118,1
"E15MS",82,324,"1200x900",800,1,600,400,"False",719,712,543,-169,169,1
"E15MS",83,539,"1200x900",1000,1,600,400,"False",510,383,544,161,161,0
"E15MS",84,382,"1200x900",800,2,600,400,"True",870,523,478,-45,45,0
"E15MS",85,433,"1200x900",1000,0,600,400,"False",76,222,326,104,104,1
"E15MS",86,617,"1200x900",1000,2,600,400,"False",294,180,538,358,358,0
"E15MS",89,141,"1200x900",600,1,600,400,"True",671,582,574,-8,8,0
"E15MS",90,525,"1200x900",1000,1,600,400,"False",123,690,521,-169,169,0
"E15MS",91,93,"1200x900",600,1,600,400,"True",139,540,458,-82,82,0
"E15MS",92,188,"1200x900",600,2,600,400,"False",900,195,334,139,139,0
"E15MS",93,232,"1200x900",800,0,600,400,"True",84,511,495,-16,16,1
"E15MS",94,297,"1200x900",800,1,600,400,"False",625,244,332,88,88,0
"E15MS",95,42,"1200x900",600,0,600,400,"True",233,479,487,8,8,0
"E15MS",97,502,"1200x900",1000,0,600,400,"False",111,639,409,-230,230,1
"E15MS",98,624,"1200x900",1000,2,600,400,"True",693,501,504,3,3,0
"E15MS",99,479,"1200x900",1000,0,600,400,"False",74,705,606,-99,99,1
"E15MS",100,551,"1200x900",1000,1,600,400,"True",146,445,420,-25,25,1
"E15MS",101,489,"1200x900",1000,0,600,400,"True",88,604,569,-35,35,1
"E15MS",102,114,"1200x900",600,1,600,400,"True",183,697,735,38,38,0
"E15MS",104,44,"1200x900",600,0,600,400,"True",305,554,596,42,42,1
"E15MS",105,239,"1200x900",800,0,600,400,"False",114,231,357,126,126,1
"E15MS",106,208,"1200x900",600,2,600,400,"False",946,399,476,77,77,0
"E15MS",107,61,"1200x900",600,0,600,400,"False",272,670,613,-57,57,1
"E15MS",108,6,"1200x900",600,0,600,400,"True",217,689,652,-37,37,1
"E15MS",109,342,"1200x900",800,1,600,400,"False",677,204,293,89,89,0
"E15MS",110,102,"1200x900",600,1,600,400,"True",861,603,552,-51,51,0
"E15MS",111,357,"1200x900",800,1,600,400,"False",109,594,432,-162,162,0
"E15MS",112,526,"1200x900",1000,1,600,400,"True",497,710,673,-37,37,0
"E15MS",114,518,"1200x900",1000,1,600,400,"False",583,717,606,-111,111,0
"E15MS",115,456,"1200x900",1000,0,600,400,"False",91,257,392,135,135,1
"E15MS",116,641,"1200x900",1000,2,600,400,"False",897,272,627,355,355,0
"E15MS",117,432,"1200x900",800,2,600,400,"True",792,380,358,-22,22,0
"E15MS",118,580,"1200x900",1000,2,600,400,"False",651,267,386,119,119,0
"E15MS",119,414,"1200x900",800,2,600,400,"False",831,592,469,-123,123,0
"E15MS",120,186,"1200x900",600,2,600,400,"False",997,197,322,125,125,0
"E15MS",121,305,"1200x900",800,1,600,400,"False",471,716,554,-162,162,0
"E15MS",122,575,"1200x900",1000,1,600,400,"True",272,693,700,7,7,0
"E15MS",123,495,"1200x900",1000,0,600,400,"True",93,692,660,-32,32,1
"E15MS",124,558,"1200x900",1000,1,600,400,"True",72,464,516,52,52,1
"E15MS",127,168,"1200x900",600,2,600,400,"False",1001,439,373,-66,66,0
"E15MS",128,509,"1200x900",1000,1,600,400,"True",509,434,401,-33,33,0
"E15MS",131,220,"1200x900",800,0,600,400,"True",108,699,665,-34,34,1
"E15MS",135,76,"1200x900",600,1,600,400,"True",647,614,637,23,23,0
"E15MS",136,41,"1200x900",600,0,600,400,"True",370,452,519,67,67,1
"E15MS",137,170,"1200x900",600,2,600,400,"True",996,468,518,50,50,0
"E15MS",138,268,"1200x900",800,0,600,400,"True",148,400,417,17,17,1
"E15MS",139,527,"1200x900",1000,1,600,400,"True",565,601,632,31,31,0
"E15MS",140,421,"1200x900",800,2,600,400,"True",898,394,375,-19,19,0
"E15MS",141,312,"1200x900",800,1,600,400,"False",238,683,550,-133,133,0
"E15MS",142,441,"1200x900",1000,0,600,400,"True",85,684,632,-52,52,1
"E15MS",143,404,"1200x900",800,2,600,400,"False",842,396,506,110,110,0
"E15MS",144,484,"1200x900",1000,0,600,400,"False",100,223,318,95,95,1
"E15MS",145,544,"1200x900",1000,1,600,400,"True",602,620,572,-48,48,0
"E15MS",146,294,"1200x900",800,1,600,400,"False",262,287,450,163,163,0
"E15MS",147,210,"1200x900",600,2,600,400,"True",835,506,449,-57,57,0
"E15MS",148,341,"1200x900",800,1,600,400,"True",735,632,613,-19,19,1
"E15MS",150,28,"1200x900",600,0,600,400,"False",336,410,487,77,77,1
"E15MS",151,646,"1200x900",1000,2,600,400,"True",829,227,304,77,77,1
"E15MS",152,199,"1200x900",600,2,600,400,"True",992,467,442,-25,25,0
"E15MS",153,451,"1200x900",1000,0,600,400,"False",110,702,620,-82,82,1
"E15MS",154,561,"1200x900",1000,1,600,400,"False",231,406,524,118,118,0
"E15MS",155,468,"1200x900",1000,0,600,400,"False",121,219,397,178,178,1
"E15MS",156,644,"1200x900",1000,2,600,400,"False",495,486,402,-84,84,0
"E15MS",157,333,"1200x900",800,1,600,400,"True",521,548,490,-58,58,0
"E15MS",158,385,"1200x900",800,2,600,400,"False",740,456,331,-125,125,0
"E15MS",160,291,"1200x900",800,1,600,400,"True",522,694,690,-4,4,0
"E15MS",161,597,"1200x900",1000,2,600,400,"False",352,239,433,194,194,0
"E15MS",162,328,"1200x900",800,1,600,400,"True",104,649,595,-54,54,0
"E15MS",163,596,"1200x900",1000,2,600,400,"True",706,513,533,20,20,0
"E15MS",167,207,"1200x900",600,2,600,400,"False",838,235,389,154,154,0
"E15MS",168,469,"1200x900",1000,0,600,400,"True",73,227,266,39,39,1
"E15MS",169,248,"1200x900",800,0,600,400,"True",94,240,261,21,21,1
"E15MS",170,631,"1200x900",1000,2,600,400,"False",699,479,250,-229,229,0
"E15MS",171,480,"1200x900",1000,0,600,400,"True",100,231,254,23,23,1
"E15MS",172,569,"1200x900",1000,1,600,400,"False",494,720,497,-223,223,0
"E15MS",173,50,"1200x900",600,0,600,400,"False",75,582,498,-84,84,0
"E15MS",174,258,"1200x900",800,0,600,400,"False",126,664,766,102,102,1
"E15MS",175,190,"1200x900",600,2,600,400,"False",977,238,123,-115,115,0
"E15MS",176,221,"1200x900",800,0,600,400,"False",132,520,377,-143,143,1
"E15MS",177,623,"1200x900",1000,2,600,400,"True",636,527,516,-11,11,0
"E15MS",178,267,"1200x900",800,0,600,400,"True",145,665,691,26,26,1
"E15MS",179,457,"1200x900",1000,0,600,400,"True",97,630,579,-51,51,1
"E15MS",180,485,"1200x900",1000,0,600,400,"False",121,694,617,-77,77,1
"E15MS",182,123,"1200x900",600,1,600,400,"False",761,365,178,-187,187,1
"E15MS",183,19,"1200x900",600,0,600,400,"True",286,686,661,-25,25,0
"E15MS",184,130,"1200x900",600,1,600,400,"True",741,428,492,64,64,0
"E15MS",185,391,"1200x900",800,2,600,400,"True",895,521,476,-45,45,0
"E15MS",188,358,"1200x900",800,1,600,400,"False",263,635,292,-343,343,0
"E15MS",189,18,"1200x900",600,0,600,400,"True",400,318,362,44,44,1
"E15MS",193,513,"1200x900",1000,1,600,400,"False",235,602,285,-317,317,0
"E15MS",194,375,"1200x900",800,2,600,400,"False",716,384,286,-98,98,0
"E15MS",195,52,"1200x900",600,0,600,400,"True",171,188,252,64,64,0
"E15MS",196,292,"1200x900",800,1,600,400,"False",88,565,455,-110,110,0
"E15MS",198,571,"1200x900",1000,1,600,400,"False",239,522,667,145,145,1
"E15MS",199,499,"1200x900",1000,0,600,400,"False",93,271,490,219,219,1
"E15MS",200,529,"1200x900",1000,1,600,400,"False",267,412,335,-77,77,1
"E15MS",202,356,"1200x900",800,1,600,400,"False",123,484,560,76,76,0
"E15MS",203,151,"1200x900",600,2,600,400,"True",828,680,646,-34,34,0
"E15MS",204,478,"1200x900",1000,0,600,400,"True",79,672,647,-25,25,1
"E15MS",205,345,"1200x900",800,1,600,400,"True",841,566,582,16,16,1
"E15MS",206,211,"1200x900",600,2,600,400,"True",986,407,446,39,39,0
"E15MS",207,45,"1200x900",600,0,600,400,"True",487,678,671,-7,7,1
"E15MS",208,79,"1200x900",600,1,600,400,"True",731,289,294,5,5,0
"E15MS",209,74,"1200x900",600,1,600,400,"False",115,358,204,-154,154,0
"E15MS",210,203,"1200x900",600,2,600,400,"False",938,603,448,-155,155,0
"E15MS",211,67,"1200x900",600,0,600,400,"True",289,308,363,55,55,1
"E15MS",212,523,"1200x900",1000,1,600,400,"True",339,318,362,44,44,0
"E15MS",213,562,"1200x900",1000,1,600,400,"False",347,540,427,-113,113,0
"E15MS",214,119,"1200x900",600,1,600,400,"False",168,563,428,-135,135,0
"E15MS",215,542,"1200x900",1000,1,600,400,"True",304,401,479,78,78,0
"E15MS",216,642,"1200x900",1000,2,600,400,"True",776,316,363,47,47,0
"E15MS",218,585,"1200x900",1000,2,600,400,"False",698,688,498,-190,190,1
"E15MS",219,138,"1200x900",600,1,600,400,"False",844,580,652,72,72,1
"E15MS",220,383,"1200x900",800,2,600,400,"True",855,407,366,-41,41,0
"E15MS",221,497,"1200x900",1000,0,600,400,"False",106,696,567,-129,129,1
"E15MS",222,283,"1200x900",800,0,600,400,"True",90,264,229,-35,35,1
"E15MS",223,334,"1200x900",800,1,600,400,"True",481,665,657,-8,8,0
"E15MS",224,60,"1200x900",600,0,600,400,"False",365,213,314,101,101,1
"E15MS",225,109,"1200x900",600,1,600,400,"False",691,589,504,-85,85,0
"E15MS",226,461,"1200x900",1000,0,600,400,"True",95,711,670,-41,41,1
"E15MS",227,202,"1200x900",600,2,600,400,"True",966,460,543,83,83,0
"E15MS",228,545,"1200x900",1000,1,600,400,"True",358,562,617,55,55,0
"E15MS",229,379,"1200x900",800,2,600,400,"True",994,325,367,42,42,0
"E15MS",230,49,"1200x900",600,0,600,400,"True",109,380,385,5,5,0
"E15MS",231,29,"1200x900",600,0,600,400,"True",385,533,555,22,22,1
"E15MS",232,475,"1200x900",1000,0,600,400,"False",101,715,610,-105,105,1
"E15MS",233,142,"1200x900",600,1,600,400,"True",286,474,496,22,22,0
"E15MS",234,317,"1200x900",800,1,600,400,"True",185,564,613,49,49,0
"E15MS",235,471,"1200x900",1000,0,600,400,"False",122,200,401,201,201,1
"E15MS",236,528,"1200x900",1000,1,600,400,"False",839,227,718,491,491,1
"E15MS",237,230,"1200x900",800,0,600,400,"True",99,678,635,-43,43,1
"E15MS",238,234,"1200x900",800,0,600,400,"False",72,344,435,91,91,1
"E15MS",239,108,"1200x900",600,1,600,400,"False",830,239,333,94,94,0
"E15MS",240,4,"1200x900",600,0,600,400,"True",602,200,175,-25,25,1
"E15MS",241,2,"1200x900",600,0,600,400,"True",159,323,344,21,21,0
"E15MS",242,280,"1200x900",800,0,600,400,"True",104,302,311,9,9,1
"E15MS",243,156,"1200x900",600,2,600,400,"False",913,197,367,170,170,0
"E15MS",244,486,"1200x900",1000,0,600,400,"False",102,676,568,-108,108,1
"E15MS",245,548,"1200x900",1000,1,600,400,"True",103,278,261,-17,17,0
"E15MS",246,279,"1200x900",800,0,600,400,"True",252,202,200,-2,2,1
"E15MS",247,643,"1200x900",1000,2,600,400,"True",740,325,345,20,20,0
"E15MS",248,184,"1200x900",600,2,600,400,"False",1067,441,496,55,55,0
"E15MS",249,155,"1200x900",600,2,600,400,"False",940,269,390,121,121,0
"E15MS",250,316,"1200x900",800,1,600,400,"True",362,319,245,-74,74,0
"E15MS",251,226,"1200x900",800,0,600,400,"True",187,229,285,56,56,1
"E15MS",252,459,"1200x900",1000,0,600,400,"False",70,645,445,-200,200,1
"E15MS",253,111,"1200x900",600,1,600,400,"False",922,552,666,114,114,1
"E15MS",254,92,"1200x900",600,1,600,400,"True",624,605,577,-28,28,0
"E15MS",255,105,"1200x900",600,1,600,400,"False",527,440,576,136,136,0
"E15MS",256,442,"1200x900",1000,0,600,400,"False",87,183,379,196,196,1
"E15MS",257,546,"1200x900",1000,1,600,400,"True",305,374,413,39,39,0
"E15MS",258,344,"1200x900",800,1,600,400,"True",589,408,414,6,6,0
"E15MS",260,160,"1200x900",600,2,600,400,"False",863,606,490,-116,116,0
"E15MS",261,614,"1200x900",1000,2,600,400,"True",823,563,513,-50,50,0
"E15MS",262,20,"1200x900",600,0,600,400,"True",204,545,514,-31,31,1
"E15MS",263,261,"1200x900",800,0,600,400,"True",86,713,697,-16,16,1
"E15MS",264,113,"1200x900",600,1,600,400,"True",897,657,723,66,66,0
"E15MS",265,157,"1200x900",600,2,600,400,"False",1016,323,429,106,106,0
"E15MS",266,62,"1200x900",600,0,600,400,"True",345,346,390,44,44,1
"E15MS",267,397,"1200x900",800,2,600,400,"False",817,692,482,-210,210,0
"E15MS",269,563,"1200x900",1000,1,600,400,"True",201,696,666,-30,30,0
"E15MS",271,639,"1200x900",1000,2,600,400,"True",504,456,438,-18,18,0
"E15MS",272,420,"1200x900",800,2,600,400,"False",519,223,418,195,195,0
"E15MS",273,244,"1200x900",800,0,600,400,"True",194,203,185,-18,18,1
"E15MS",274,192,"1200x900",600,2,600,400,"True",1064,320,293,-27,27,0
"E15MS",275,131,"1200x900",600,1,600,400,"False",531,367,477,110,110,0
"E15MS",277,204,"1200x900",600,2,600,400,"True",1053,432,432,0,0,0
"E15MS",279,634,"1200x900",1000,2,600,400,"True",735,313,272,-41,41,0
"E15MS",280,500,"1200x900",1000,0,600,400,"False",105,700,543,-157,157,1
"E15MS",281,3,"1200x900",600,0,600,400,"True",298,443,501,58,58,1
"E15MS",283,512,"1200x900",1000,1,600,400,"False",139,261,341,80,80,0
"E15MS",284,603,"1200x900",1000,2,600,400,"False",693,280,353,73,73,0
"E15MS",285,260,"1200x900",800,0,600,400,"True",103,525,470,-55,55,1
"E15MS",286,30,"1200x900",600,0,600,400,"True",107,353,380,27,27,0
"E15MS",287,73,"1200x900",600,1,600,400,"True",94,665,566,-99,99,0
"E15MS",288,470,"1200x900",1000,0,600,400,"False",91,666,591,-75,75,1
"E15MS",290,246,"1200x900",800,0,600,400,"False",196,418,518,100,100,1
"E15MS",291,259,"1200x900",800,0,600,400,"False",156,180,328,148,148,1
"E15MS",292,209,"1200x900",600,2,600,400,"False",937,637,400,-237,237,0
"E15MS",294,198,"1200x900",600,2,600,400,"True",976,500,518,18,18,0
"E15MS",295,269,"1200x900",800,0,600,400,"False",160,295,368,73,73,1
"E15MS",296,148,"1200x900",600,2,600,400,"False",907,330,450,120,120,0
"E15MS",297,90,"1200x900",600,1,600,400,"False",560,474,350,-124,124,0
"E15MS",298,245,"1200x900",800,0,600,400,"False",296,235,353,118,118,1
"E15MS",299,68,"1200x900",600,0,600,400,"True",165,367,371,4,4,0
"E15MS",300,553,"1200x900",1000,1,600,400,"False",116,712,328,-384,384,0
"E15MS",301,38,"1200x900",600,0,600,400,"True",120,628,638,10,10,1
"E15MS",302,536,"1200x900",1000,1,600,400,"True",580,213,226,13,13,0
"E15MS",303,169,"1200x900",600,2,600,400,"True",924,290,369,79,79,0
"E15MS",304,228,"1200x900",800,0,600,400,"True",174,687,684,-3,3,1
"E15MS",305,395,"1200x900",800,2,600,400,"False",743,334,616,282,282,0
"E15MS",306,531,"1200x900",1000,1,600,400,"False",233,362,613,251,251,0
"E15MS",307,437,"1200x900",1000,0,600,400,"False",74,667,566,-101,101,1
"E15MS",308,472,"1200x900",1000,0,600,400,"False",77,685,574,-111,111,1
"E15MS",309,363,"1200x900",800,2,600,400,"False",800,218,293,75,75,0
"E15MS",310,243,"1200x900",800,0,600,400,"True",114,332,317,-15,15,1
"E15MS",311,43,"1200x900",600,0,600,400,"True",277,446,426,-20,20,1
"E15MS",312,332,"1200x900",800,1,600,400,"True",260,699,612,-87,87,0
"E15MS",313,618,"1200x900",1000,2,600,400,"True",276,671,613,-58,58,0
"E15MS",314,70,"1200x900",600,0,600,400,"True",309,703,665,-38,38,1
"E15MS",315,352,"1200x900",800,1,600,400,"False",235,717,625,-92,92,0
"E15MS",316,55,"1200x900",600,0,600,400,"True",211,305,263,-42,42,1
"E15MS",317,517,"1200x900",1000,1,600,400,"False",548,182,264,82,82,0
"E15MS",318,88,"1200x900",600,1,600,400,"False",186,554,397,-157,157,0
"E15MS",319,25,"1200x900",600,0,600,400,"True",263,403,414,11,11,1
"E15MS",320,163,"1200x900",600,2,600,400,"True",1046,665,542,-123,123,0
"E15MS",321,252,"1200x900",800,0,600,400,"False",224,673,571,-102,102,1
"E15MS",322,504,"1200x900",1000,0,600,400,"False",107,699,616,-83,83,1
"E15MS",323,537,"1200x900",1000,1,600,400,"False",621,412,513,101,101,1
"E15MS",324,388,"1200x900",800,2,600,400,"False",930,320,382,62,62,0
"E15MS",325,242,"1200x900",800,0,600,400,"True",117,448,405,-43,43,1
"E15MS",326,94,"1200x900",600,1,600,400,"False",729,482,402,-80,80,0
"E15MS",327,179,"1200x900",600,2,600,400,"False",908,602,470,-132,132,0
"E15MS",328,318,"1200x900",800,1,600,400,"False",788,534,588,54,54,0
"E15MS",329,174,"1200x900",600,2,600,400,"True",998,457,469,12,12,0
"E15MS",330,417,"1200x900",800,2,600,400,"False",750,280,366,86,86,0
"E15MS",331,403,"1200x900",800,2,600,400,"False",625,704,496,-208,208,0
"E15MS",332,313,"1200x900",800,1,600,400,"False",588,421,497,76,76,0
"E15MS",333,399,"1200x900",800,2,600,400,"False",603,602,496,-106,106,0
"E15MS",334,540,"1200x900",1000,1,600,400,"True",389,568,590,22,22,1
"E15MS",335,535,"1200x900",1000,1,600,400,"False",372,410,504,94,94,0
"E15MS",336,96,"1200x900",600,1,600,400,"False",433,458,536,78,78,0
"E15MS",337,91,"1200x900",600,1,600,400,"True",417,630,653,23,23,1
"E15MS",338,77,"1200x900",600,1,600,400,"True",780,525,500,-25,25,0
"E15MS",339,264,"1200x900",800,0,600,400,"True",198,660,659,-1,1,1
"E15MS",341,215,"1200x900",600,2,600,400,"True",939,596,575,-21,21,0
"E15MS",342,438,"1200x900",1000,0,600,400,"False",77,713,574,-139,139,1
"E15MS",343,354,"1200x900",800,1,600,400,"False",118,236,329,93,93,0
"E15MS",344,532,"1200x900",1000,1,600,400,"True",215,207,242,35,35,0
"E15MS",345,572,"1200x900",1000,1,600,400,"True",302,260,254,-6,6,0
"E15MS",346,331,"1200x900",800,1,600,400,"True",240,620,571,-49,49,0
"E15MS",347,72,"1200x900",600,0,600,400,"True",158,537,542,5,5,0
"E15MS",348,9,"1200x900",600,0,600,400,"True",509,654,651,-3,3,1
"E15MS",349,104,"1200x900",600,1,600,400,"False",448,584,652,68,68,0
"E15MS",350,34,"1200x900",600,0,600,400,"True",361,242,269,27,27,1
"E15MS",351,31,"1200x900",600,0,600,400,"True",365,338,334,-4,4,1
"E15MS",352,212,"1200x900",600,2,600,400,"False",841,206,333,127,127,0
"E15MS",353,361,"1200x900",800,2,600,400,"False",931,328,225,-103,103,0
"E15MS",354,187,"1200x900",600,2,600,400,"False",857,639,549,-90,90,0
"E15MS",355,645,"1200x900",1000,2,600,400,"False",619,396,550,154,154,0
"E15MS",356,32,"1200x900",600,0,600,400,"True",152,563,561,-2,2,1
"E15MS",357,619,"1200x900",1000,2,600,400,"False",803,247,399,152,152,0
"E15MS",358,601,"1200x900",1000,2,600,400,"False",735,697,520,-177,177,0
"E15MS",359,508,"1200x900",1000,1,600,400,"False",596,485,578,93,93,0
"E15MS",360,589,"1200x900",1000,2,600,400,"True",856,418,423,5,5,0
"E15MS",361,435,"1200x900",1000,0,600,400,"False",119,200,305,105,105,1
"E15MS",362,496,"1200x900",1000,0,600,400,"False",70,639,461,-178,178,1
"E15MS",363,144,"1200x900",600,1,600,400,"False",718,371,527,156,156,0
"E15MS",364,265,"1200x900",800,0,600,400,"False",229,353,453,100,100,1
"E15MS",365,5,"1200x900",600,0,600,400,"True",228,587,542,-45,45,0
"E15MS",366,126,"1200x900",600,1,600,400,"False",849,354,468,114,114,0
"E15MS",367,448,"1200x900",1000,0,600,400,"False",107,641,507,-134,134,1
"E15MS",368,15,"1200x900",600,0,600,400,"False",473,352,457,105,105,1
"E15MS",369,263,"1200x900",800,0,600,400,"True",82,396,430,34,34,1
"E15MS",370,350,"1200x900",800,1,600,400,"False",182,566,469,-97,97,0
"E15MS",371,327,"1200x900",800,1,600,400,"True",152,339,393,54,54,0
"E15MS",372,568,"1200x900",1000,1,600,400,"False",286,475,561,86,86,1
"E15MS",373,337,"1200x900",800,1,600,400,"True",299,622,562,-60,60,0
"E15MS",374,407,"1200x900",800,2,600,400,"False",989,340,264,-76,76,0
"E15MS",375,287,"1200x900",800,0,600,400,"False",120,567,402,-165,165,1
"E15MS",381,254,"1200x900",800,0,600,400,"False",136,583,493,-90,90,1
"E15MS",382,200,"1200x900",600,2,600,400,"False",897,302,189,-113,113,0
"E15MS",383,26,"1200x900",600,0,600,400,"False",70,712,606,-106,106,0
"E15MS",384,615,"1200x900",1000,2,600,400,"False",736,634,455,-179,179,0
"E15MS",385,81,"1200x900",600,1,600,400,"False",696,225,301,76,76,0
"E15MS",386,71,"1200x900",600,0,600,400,"False",219,248,151,-97,97,0
"E15MS",387,593,"1200x900",1000,2,600,400,"False",246,719,347,-372,372,0
"E15MS",388,372,"1200x900",800,2,600,400,"False",833,620,439,-181,181,0
"E15MS",389,647,"1200x900",1000,2,600,400,"False",560,637,392,-245,245,0
"E15MS",390,460,"1200x900",1000,0,600,400,"False",155,189,341,152,152,1
"E15MS",391,304,"1200x900",800,1,600,400,"False",667,605,340,-265,265,0
"E15MS",393,224,"1200x900",800,0,600,400,"True",161,474,492,18,18,1
"E15MS",394,476,"1200x900",1000,0,600,400,"False",76,359,491,132,132,1
"E15MS",395,445,"1200x900",1000,0,600,400,"False",78,302,378,76,76,1
"E15MS",396,566,"1200x900",1000,1,600,400,"True",378,472,527,55,55,1
"E15MS",397,359,"1200x900",800,1,600,400,"False",653,241,390,149,149,0
"E15MS",398,120,"1200x900",600,1,600,400,"False",690,655,538,-117,117,0
"E15MS",399,214,"1200x900",600,2,600,400,"False",1046,305,215,-90,90,0
"E15MS",400,431,"1200x900",800,2,600,400,"False",694,382,254,-128,128,0
"E15MS",401,288,"1200x900",800,0,600,400,"False",180,547,620,73,73,1
"E15MS",402,598,"1200x900",1000,2,600,400,"True",706,559,530,-29,29,0
"E15MS",403,633,"1200x900",1000,2,600,400,"False",564,253,373,120,120,0
"E15MS",404,161,"1200x900",600,2,600,400,"False",939,553,391,-162,162,0
"E15MS",405,320,"1200x900",800,1,600,400,"True",644,376,372,-4,4,0
"E15MS",406,134,"1200x900",600,1,600,400,"False",300,188,121,-67,67,0
"E15MS",407,559,"1200x900",1000,1,600,400,"True",641,244,245,1,1,0
"E15MS",408,227,"1200x900",800,0,600,400,"False",196,551,646,95,95,1
"E15MS",411,521,"1200x900",1000,1,600,400,"True",111,303,307,4,4,1
"E15MS",412,222,"1200x900",800,0,600,400,"False",152,206,293,87,87,1
"E15MS",413,218,"1200x900",800,0,600,400,"False",106,397,503,106,106,1
"E15MS",416,567,"1200x900",1000,1,600,400,"False",655,297,445,148,148,1
"E15MS",417,574,"1200x900",1000,1,600,400,"True",614,194,148,-46,46,0
"E15MS",418,140,"1200x900",600,1,600,400,"True",700,523,494,-29,29,0
"E15MS",419,394,"1200x900",800,2,600,400,"False",847,292,384,92,92,0
"E15MS",420,284,"1200x900",800,0,600,400,"True",135,293,295,2,2,1
"E15MS",421,249,"1200x900",800,0,600,400,"True",126,306,351,45,45,1
"E15MS",422,636,"1200x900",1000,2,600,400,"False",575,583,424,-159,159,0
"E15MS",423,440,"1200x900",1000,0,600,400,"False",71,237,359,122,122,1
"E15MS",424,336,"1200x900",800,1,600,400,"True",251,587,574,-13,13,0
"E15MS",425,473,"1200x900",1000,0,600,400,"False",75,323,485,162,162,1
"E15MS",426,353,"1200x900",800,1,600,400,"True",90,476,484,8,8,0
"E15MS",429,66,"1200x900",600,0,600,400,"True",155,673,670,-3,3,0
"E15MS",430,17,"1200x900",600,0,600,400,"True",402,496,474,-22,22,1
"E15MS",431,162,"1200x900",600,2,600,400,"True",849,279,372,93,93,0
"E15MS",432,378,"1200x900",800,2,600,400,"False",1018,708,407,-301,301,0
"E15MS",433,80,"1200x900",600,1,600,400,"False",616,423,610,187,187,1
"E15MS",434,115,"1200x900",600,1,600,400,"True",545,307,300,-7,7,0
"E15MS",435,599,"1200x900",1000,2,600,400,"False",316,570,304,-266,266,0
"E15MS",436,281,"1200x900",800,0,600,400,"True",112,611,566,-45,45,1
"E15MS",437,129,"1200x900",600,1,600,400,"False",859,482,323,-159,159,1
"E15MS",438,514,"1200x900",1000,1,600,400,"False",539,690,574,-116,116,0
"E15MS",439,273,"1200x900",800,0,600,400,"False",180,309,399,90,90,1
"E15MS",440,588,"1200x900",1000,2,600,400,"True",585,350,398,48,48,0
"E15MS",441,626,"1200x900",1000,2,600,400,"True",329,449,498,49,49,0
"E15MS",445,83,"1200x900",600,1,600,400,"True",763,568,600,32,32,1
"E15MS",446,172,"1200x900",600,2,600,400,"False",912,444,595,151,151,0
"E15MS",447,581,"1200x900",1000,2,600,400,"False",310,357,508,151,151,0
"E15MS",449,338,"1200x900",800,1,600,400,"True",813,253,198,-55,55,1
"E15MS",450,58,"1200x900",600,0,600,400,"False",353,655,594,-61,61,1
"E15MS",451,282,"1200x900",800,0,600,400,"False",109,246,397,151,151,1
"E15MS",452,605,"1200x900",1000,2,600,400,"False",493,665,531,-134,134,0
"E15MS",453,487,"1200x900",1000,0,600,400,"False",78,670,592,-78,78,1
"E15MS",454,408,"1200x900",800,2,600,400,"False",758,567,342,-225,225,0
"E15MS",455,380,"1200x900",800,2,600,400,"False",942,228,391,163,163,0
"E15MS",456,103,"1200x900",600,1,600,400,"True",528,320,301,-19,19,1
"E15MS",457,308,"1200x900",800,1,600,400,"False",437,425,507,82,82,0
"E15MS",458,436,"1200x900",1000,0,600,400,"False",82,617,508,-109,109,1
"E15MS",459,117,"1200x900",600,1,600,400,"False",711,456,256,-200,200,0
"E15MS",460,411,"1200x900",800,2,600,400,"True",805,361,390,29,29,0
"E15MS",461,63,"1200x900",600,0,600,400,"True",311,188,250,62,62,1
"E15MS",462,240,"1200x900",800,0,600,400,"True",330,656,596,-60,60,1
"E15MS",463,629,"1200x900",1000,2,600,400,"False",681,257,358,101,101,0
"E15MS",464,377,"1200x900",800,2,600,400,"False",683,388,486,98,98,0
"E15MS",465,424,"1200x900",800,2,600,400,"False",903,545,433,-112,112,0
"E15MS",466,95,"1200x900",600,1,600,400,"False",749,425,264,-161,161,1
"E15MS",467,519,"1200x900",1000,1,600,400,"False",319,565,395,-170,170,1
"E15MS",468,419,"1200x900",800,2,600,400,"True",769,351,396,45,45,0
"E15MS",469,319,"1200x900",800,1,600,400,"True",494,587,533,-54,54,1
"E15MS",470,266,"1200x900",800,0,600,400,"True",126,303,321,18,18,1
"E15MS",471,100,"1200x900",600,1,600,400,"False",453,511,320,-191,191,0
"E15MS",472,300,"1200x900",800,1,600,400,"True",620,693,742,49,49,0
"E15MS",473,640,"1200x900",1000,2,600,400,"False",361,334,438,104,104,0
"E15MS",474,325,"1200x900",800,1,600,400,"False",105,394,295,-99,99,0
"E15MS",475,556,"1200x900",1000,1,600,400,"True",415,420,486,66,66,0
"E15MS",476,286,"1200x900",800,0,600,400,"True",105,378,419,41,41,1
"E15MS",477,51,"1200x900",600,0,600,400,"True",272,181,162,-19,19,1
"E15MS",478,452,"1200x900",1000,0,600,400,"False",97,273,428,155,155,1
"E15MS",479,185,"1200x900",600,2,600,400,"True",907,212,290,78,78,0
"E15MS",480,278,"1200x900",800,0,600,400,"True",251,711,696,-15,15,1
"E15MS",481,637,"1200x900",1000,2,600,400,"True",750,460,510,50,50,0
"E15MS",482,323,"1200x900",800,1,600,400,"False",388,348,465,117,117,0
"E15MS",483,516,"1200x900",1000,1,600,400,"True",440,559,571,12,12,0
"E15MS",484,11,"1200x900",600,0,600,400,"True",372,670,639,-31,31,1
"E15MS",485,511,"1200x900",1000,1,600,400,"False",408,390,311,-79,79,1
"E15MS",486,135,"1200x900",600,1,600,400,"True",759,569,533,-36,36,0
"E15MS",487,16,"1200x900",600,0,600,400,"True",297,514,474,-40,40,1
"E15MS",488,306,"1200x900",800,1,600,400,"False",164,524,625,101,101,0
"E15MS",489,182,"1200x900",600,2,600,400,"True",933,389,334,-55,55,0
"E15MS",490,365,"1200x900",800,2,600,400,"False",1055,305,562,257,257,0
"E15MS",491,554,"1200x900",1000,1,600,400,"False",79,309,137,-172,172,1
"E15MS",492,145,"1200x900",600,2,600,400,"False",1004,630,436,-194,194,0
"E15MS",493,492,"1200x900",1000,0,600,400,"False",76,692,552,-140,140,1
"E15MS",494,455,"1200x900",1000,0,600,400,"False",107,718,593,-125,125,1
"E15MS",495,530,"1200x900",1000,1,600,400,"False",584,405,322,-83,83,1
"E15MS",496,520,"1200x900",1000,1,600,400,"False",564,260,176,-84,84,0
"E15MS",497,146,"1200x900",600,2,600,400,"True",989,492,450,-42,42,0
"E15MS",498,322,"1200x900",800,1,600,400,"False",703,206,81,-125,125,1
"E15MS",499,412,"1200x900",800,2,600,400,"False",842,280,449,169,169,0
"E15MS",500,367,"1200x900",800,2,600,400,"True",613,464,461,-3,3,0
"E15MS",501,422,"1200x900",800,2,600,400,"False",712,558,422,-136,136,0
"E15MS",502,384,"1200x900",800,2,600,400,"False",821,707,586,-121,121,0
"E15MS",503,217,"1200x900",800,0,600,400,"True",85,573,587,14,14,1
"E15MS",504,464,"1200x900",1000,0,600,400,"False",82,222,360,138,138,1
"E15MS",505,616,"1200x900",1000,2,600,400,"False",854,357,501,144,144,1
"E15MS",506,491,"1200x900",1000,0,600,400,"False",108,198,412,214,214,1
"E15MS",507,439,"1200x900",1000,0,600,400,"False",110,229,407,178,178,1
"E15MS",508,53,"1200x900",600,0,600,400,"True",177,189,229,40,40,0
"E15MS",509,329,"1200x900",800,1,600,400,"True",517,239,185,-54,54,0
"E15MS",510,611,"1200x900",1000,2,600,400,"False",414,511,372,-139,139,0
"E15MS",511,434,"1200x900",1000,0,600,400,"False",89,657,560,-97,97,1
"E15MS",512,251,"1200x900",800,0,600,400,"False",88,352,472,120,120,1
"E15MS",515,560,"1200x900",1000,1,600,400,"True",516,693,649,-44,44,0
"E15MS",516,183,"1200x900",600,2,600,400,"True",927,289,372,83,83,0
"E15MS",517,229,"1200x900",800,0,600,400,"True",117,697,719,22,22,1
"E15MS",518,255,"1200x900",800,0,600,400,"True",93,709,718,9,9,1
"E15MS",519,454,"1200x900",1000,0,600,400,"True",78,687,631,-56,56,1
"E15MS",520,386,"1200x900",800,2,600,400,"False",774,301,539,238,238,0
"E15MS",521,150,"1200x900",600,2,600,400,"False",897,345,165,-180,180,0
"E15MS",522,482,"1200x900",1000,0,600,400,"False",79,686,522,-164,164,1
"E15MS",523,132,"1200x900",600,1,600,400,"False",333,185,130,-55,55,0
"E15MS",524,506,"1200x900",1000,1,600,400,"False",559,567,299,-268,268,1
"E15MS",525,584,"1200x900",1000,2,600,400,"False",731,413,555,142,142,0
"E15MS",526,627,"1200x900",1000,2,600,400,"True",760,510,481,-29,29,0
"E15MS",527,573,"1200x900",1000,1,600,400,"True",486,615,605,-10,10,0
"E15MS",528,447,"1200x900",1000,0,600,400,"False",71,339,504,165,165,1
"E15MS",529,82,"1200x900",600,1,600,400,"False",108,213,320,107,107,0
"E15MS",530,256,"1200x900",800,0,600,400,"False",192,656,743,87,87,1
"E15MS",531,400,"1200x900",800,2,600,400,"True",733,297,372,75,75,0
"E15MS",533,180,"1200x900",600,2,600,400,"False",929,270,158,-112,112,0
"E15MS",534,465,"1200x900",1000,0,600,400,"False",85,203,392,189,189,1
"E15MS",535,35,"1200x900",600,0,600,400,"True",366,555,549,-6,6,1
"E15MS",536,107,"1200x900",600,1,600,400,"True",878,678,711,33,33,0
"E15MS",537,522,"1200x900",1000,1,600,400,"False",223,379,538,159,159,0
"E15MS",538,578,"1200x900",1000,2,600,400,"False",966,276,342,66,66,0
"E15MS",539,416,"1200x900",800,2,600,400,"False",748,617,496,-121,121,0
"E15MS",540,166,"1200x900",600,2,600,400,"False",896,274,364,90,90,0
"E15MS",541,450,"1200x900",1000,0,600,400,"False",130,204,296,92,92,1
"E15MS",542,374,"1200x900",800,2,600,400,"True",755,450,480,30,30,0
"E15MS",543,620,"1200x900",1000,2,600,400,"False",832,649,487,-162,162,0
"E15MS",544,196,"1200x900",600,2,600,400,"True",1030,397,488,91,91,0
"E15MS",545,110,"1200x900",600,1,600,400,"False",776,550,647,97,97,1
"E15MS",546,406,"1200x900",800,2,600,400,"True",971,233,253,20,20,0
"E15MS",547,112,"1200x900",600,1,600,400,"False",681,490,401,-89,89,0
"E15MS",548,360,"1200x900",800,1,600,400,"True",203,608,597,-11,11,0
"E15MS",549,197,"1200x900",600,2,600,400,"True",903,212,231,19,19,0
"E15MS",550,370,"1200x900",800,2,600,400,"False",874,336,263,-73,73,0
"E15MS",551,362,"1200x900",800,2,600,400,"False",819,338,427,89,89,0
"E15MS",552,274,"1200x900",800,0,600,400,"False",146,497,426,-71,71,1
"E15MS",554,423,"1200x900",800,2,600,400,"False",1051,710,577,-133,133,1
"E15MS",555,64,"1200x900",600,0,600,400,"True",102,339,377,38,38,0
"E15MS",556,223,"1200x900",800,0,600,400,"True",179,191,213,22,22,1
"E15MS",557,124,"1200x900",600,1,600,400,"False",345,467,295,-172,172,0
"E15MS",558,24,"1200x900",600,0,600,400,"False",430,538,464,-74,74,1
"E15MS",559,507,"1200x900",1000,1,600,400,"True",608,583,632,49,49,1
"E15MS",560,22,"1200x900",600,0,600,400,"True",398,591,621,30,30,1
"E15MS",561,233,"1200x900",800,0,600,400,"True",164,700,744,44,44,1
"E15MS",562,54,"1200x900",600,0,600,400,"True",474,564,508,-56,56,1
"E15MS",563,12,"1200x900",600,0,600,400,"True",365,336,346,10,10,1
"E15MS",564,369,"1200x900",800,2,600,400,"True",903,594,613,19,19,0
"E15MS",565,231,"1200x900",800,0,600,400,"False",251,718,628,-90,90,1
"E15MS",566,262,"1200x900",800,0,600,400,"True",196,481,443,-38,38,1
"E15MS",567,301,"1200x900",800,1,600,400,"False",162,574,457,-117,117,0
"E15MS",568,590,"1200x900",1000,2,600,400,"False",636,278,458,180,180,0
"E15MS",569,409,"1200x900",800,2,600,400,"True",501,659,617,-42,42,0
"E15MS",570,98,"1200x900",600,1,600,400,"False",625,530,649,119,119,0
"E15MS",571,501,"1200x900",1000,0,600,400,"False",96,323,492,169,169,1
"E15MS",572,524,"1200x900",1000,1,600,400,"True",534,470,491,21,21,0
"E15MS",573,314,"1200x900",800,1,600,400,"False",277,616,690,74,74,1
"E15MS",574,33,"1200x900",600,0,600,400,"True",198,533,543,10,10,1
"E15MS",575,405,"1200x900",800,2,600,400,"True",790,307,324,17,17,0
"E15MS",576,23,"1200x900",600,0,600,400,"True",308,463,467,4,4,1
"E15MS",577,625,"1200x900",1000,2,600,400,"False",279,228,430,202,202,0
"E15MS",578,481,"1200x900",1000,0,600,400,"True",80,185,192,7,7,1
"E15MS",579,396,"1200x900",800,2,600,400,"False",678,663,445,-218,218,0
"E15MS",580,275,"1200x900",800,0,600,400,"True",120,594,586,-8,8,0
"E15MS",581,610,"1200x900",1000,2,600,400,"False",702,293,394,101,101,0
"E15MS",582,178,"1200x900",600,2,600,400,"False",1041,510,360,-150,150,0
"E15MS",583,413,"1200x900",800,2,600,400,"False",849,506,352,-154,154,0
"E15MS",584,426,"1200x900",800,2,600,400,"False",830,263,391,128,128,0
"E15MS",591,565,"1200x900",1000,1,600,400,"True",451,562,515,-47,47,0
"E15MS",592,194,"1200x900",600,2,600,400,"False",896,236,327,91,91,0
"E15MS",593,638,"1200x900",1000,2,600,400,"False",385,198,116,-82,82,0
"E15MS",594,225,"1200x900",800,0,600,400,"False",178,423,267,-156,156,1
"E15MS",595,458,"1200x900",1000,0,600,400,"False",78,624,479,-145,145,1
"E15MS",596,515,"1200x900",1000,1,600,400,"True",307,217,248,31,31,0
"E15MS",598,193,"1200x900",600,2,600,400,"False",874,588,462,-126,126,0
"E15MS",599,490,"1200x900",1000,0,600,400,"False",114,183,313,130,130,1
"E15MS",600,191,"1200x900",600,2,600,400,"True",962,396,469,73,73,0
"E15MS",601,343,"1200x900",800,1,600,400,"False",407,557,440,-117,117,0
"E15MS",602,118,"1200x900",600,1,600,400,"True",190,588,575,-13,13,0
"E15MS",603,364,"1200x900",800,2,600,400,"True",1018,204,253,49,49,0
"E15MS",604,612,"1200x900",1000,2,600,400,"False",706,198,371,173,173,0
"E15MS",605,165,"1200x900",600,2,600,400,"False",912,554,372,-182,182,0
"E15MS",606,390,"1200x900",800,2,600,400,"False",982,674,356,-318,318,1
"E15MS",607,84,"1200x900",600,1,600,400,"False",144,184,324,140,140,0
"E15MS",608,181,"1200x900",600,2,600,400,"True",1018,223,235,12,12,0
"E15MS",609,477,"1200x900",1000,0,600,400,"False",88,640,423,-217,217,1
"E15MS",610,87,"1200x900",600,1,600,400,"True",231,604,561,-43,43,0
"E15MS",611,171,"1200x900",600,2,600,400,"True",909,200,146,-54,54,0
"E15MS",612,8,"1200x900",600,0,600,400,"True",156,679,731,52,52,0
"E15MS",613,101,"1200x900",600,1,600,400,"False",541,656,723,67,67,0
"E15MS",614,127,"1200x900",600,1,600,400,"True",309,691,672,-19,19,0
"E15MS",615,139,"1200x900",600,1,600,400,"True",192,695,742,47,47,0
"E15MS",616,389,"1200x900",800,2,600,400,"True",843,530,486,-44,44,0
"E15MS",617,557,"1200x900",1000,1,600,400,"True",677,505,403,-102,102,1
"E15MS",618,607,"1200x900",1000,2,600,400,"True",900,573,528,-45,45,1
"E15MS",619,307,"1200x900",800,1,600,400,"True",716,247,252,5,5,0
"E15MS",620,398,"1200x900",800,2,600,400,"False",944,698,517,-181,181,0
"E15MS",621,56,"1200x900",600,0,600,400,"True",148,491,474,-17,17,0
"E15MS",622,241,"1200x900",800,0,600,400,"False",129,227,334,107,107,1
"E15MS",623,368,"1200x900",800,2,600,400,"False",778,515,432,-83,83,0
"E15MS",625,483,"1200x900",1000,0,600,400,"False",93,191,360,169,169,1
"E15MS",629,351,"1200x900",800,1,600,400,"False",122,581,498,-83,83,0
"E15MS",630,427,"1200x900",800,2,600,400,"True",812,380,382,2,2,0
"E15MS",631,219,"1200x900",800,0,600,400,"False",202,502,594,92,92,1
"E15MS",632,376,"1200x900",800,2,600,400,"False",788,275,379,104,104,0
"E15MS",633,237,"1200x900",800,0,600,400,"True",204,481,543,62,62,1
"E15MS",634,27,"1200x900",600,0,600,400,"True",373,309,343,34,34,1
"E15MS",636,609,"1200x900",1000,2,600,400,"False",697,627,529,-98,98,0
"E15MS",637,216,"1200x900",600,2,600,400,"False",1029,286,525,239,239,0
"E15MS",638,177,"1200x900",600,2,600,400,"False",912,236,388,152,152,0
"E15MS",639,415,"1200x900",800,2,600,400,"False",823,684,549,-135,135,0
"E15MS",640,206,"1200x900",600,2,600,400,"False",975,223,366,143,143,0
"E15MS",641,37,"1200x900",600,0,600,400,"True",258,403,410,7,7,1
"E15MS",642,257,"1200x900",800,0,600,400,"True",97,219,243,24,24,1
"E15MS",643,78,"1200x900",600,1,600,400,"True",885,684,722,38,38,0
"E15MS",644,339,"1200x900",800,1,600,400,"False",273,545,643,98,98,1
"E15MS",645,247,"1200x900",800,0,600,400,"False",160,424,547,123,123,1
"E15MS",646,122,"1200x900",600,1,600,400,"True",817,709,715,6,6,0
"E15MS",647,270,"1200x900",800,0,600,400,"False",192,418,541,123,123,1
"E15MS",648,290,"1200x900",800,1,600,400,"True",789,603,673,70,70,0
